County_UD,TOTPOP,MALE,FEMALE,POPDENKM,AGE014T,AGE1524T,AGE2544T,AGE4564,AEG65P
Carlow,382,198,184,31,110,42,114,92,24
Carlow,328,174,154,33.27,67,39,82,87,53
Carlow,385,187,198,138.09,85,56,135,86,23
Carlow,292,150,142,80.54,50,41,60,93,48
Carlow,236,123,113,15.12,61,31,65,58,21
Carlow,323,155,168,25.38,71,32,86,87,47
Carlow,308,164,144,1408.93,105,22,131,37,13
Carlow,250,126,124,29.39,52,23,69,58,48
Carlow,152,77,75,144.3,19,25,45,46,17
Carlow,223,115,108,31.38,57,35,56,51,24
Carlow,204,105,99,23.54,36,26,52,61,29
Carlow,329,172,157,23.37,68,38,106,82,35
Carlow,279,144,135,15.49,66,22,83,66,42
Carlow,190,90,100,24.11,32,17,37,67,37
Carlow,271,139,132,35.5,66,34,67,70,34
Carlow,189,93,96,482.14,17,11,55,55,51
Carlow,391,188,203,2457.59,72,43,104,91,81
Carlow,225,114,111,43.7,44,34,80,57,10
Carlow,240,120,120,254.57,78,11,91,41,19
Carlow,228,111,117,99.28,29,45,54,70,30
Carlow,235,123,112,2181.56,17,57,52,47,62
Carlow,301,144,157,39.03,40,38,57,106,60
Carlow,323,163,160,217.45,46,45,53,114,65
Carlow,316,170,146,999.05,25,194,47,42,8
Carlow,251,130,121,3119.72,50,47,79,56,19
Carlow,193,105,88,810.22,38,73,50,23,9
Carlow,458,209,249,6100.65,193,39,196,27,3
Carlow,360,183,177,5919.01,115,66,134,34,11
Carlow,382,182,200,4875.62,93,43,147,40,59
Carlow,388,186,202,3456.69,120,41,152,66,9
Carlow,244,115,129,1036.08,49,22,85,62,26
Carlow,361,180,181,2010.5,83,51,85,117,25
Carlow,224,118,106,4150.53,64,30,92,32,6
Carlow,208,101,107,94.05,32,16,56,53,51
Carlow,234,102,132,1125.53,33,18,45,59,79
Carlow,362,161,201,5628.81,136,30,136,48,12
Carlow,289,154,135,4229.04,64,46,91,72,16
Carlow,212,103,109,3011.24,45,31,86,39,11
Carlow,232,111,121,7337.13,69,24,100,32,7
Carlow,191,98,93,1559.62,68,13,89,20,1
Carlow,298,163,135,4072.6,60,55,78,94,11
Carlow,228,103,125,5542.46,40,38,72,65,13
Carlow,166,86,80,980.9,22,25,27,43,49
Carlow,181,97,84,3400.47,43,24,82,23,9
Carlow,309,150,159,4698.98,86,40,162,15,6
Carlow,308,176,132,4574.96,88,56,129,33,2
Carlow,469,213,256,4073.9,149,64,150,89,17
Carlow,292,137,155,1112.22,67,28,137,42,18
Carlow,182,85,97,3714.82,45,10,106,15,6
Carlow,248,129,119,6284.21,62,32,133,17,4
Carlow,218,99,119,1161.01,43,30,82,41,22
Carlow,406,203,203,2757.76,108,55,113,89,41
Carlow,355,151,204,3019.35,87,26,209,27,6
Carlow,322,153,169,2389.81,46,34,89,67,86
Carlow,272,138,134,644.97,72,38,89,68,5
Carlow,280,146,134,1339.42,42,32,89,81,36
Carlow,255,127,128,209.06,38,34,68,77,38
Carlow,280,138,142,151.6,38,32,70,89,51
Carlow,350,177,173,5336.5,62,56,86,111,35
Carlow,400,185,215,1427.22,117,61,149,64,9
Carlow,465,236,229,6614.6,155,75,154,72,9
Carlow,318,142,176,4473.58,66,40,75,108,29
Carlow,245,119,126,2421.95,25,30,54,92,44
Carlow,217,104,113,3892.17,38,33,78,50,18
Carlow,201,94,107,833.69,55,23,57,36,30
Carlow,323,158,165,7121.44,133,27,146,17,0
Carlow,192,105,87,1575.81,57,27,80,22,6
Carlow,175,79,96,6329.57,56,18,85,14,2
Carlow,101,50,51,2504.03,4,55,27,6,9
Carlow,200,98,102,1634.19,24,35,64,52,25
Carlow,77,41,36,1492.28,7,15,37,10,8
Carlow,80,42,38,4718.65,7,23,35,12,3
Carlow,115,74,41,3944.57,8,20,56,16,15
Carlow,123,63,60,1811.22,13,24,54,22,10
Carlow,218,105,113,2616.86,50,37,69,46,16
Carlow,80,41,39,792.43,4,11,27,14,24
Carlow,283,153,130,1163.47,10,13,57,65,138
Carlow,112,64,48,2512.84,10,30,45,19,8
Carlow,159,84,75,820.34,7,33,82,23,14
Carlow,300,143,157,1107.92,28,25,81,61,105
Carlow,118,57,61,3050.59,12,18,45,29,14
Carlow,182,92,90,1964.23,27,43,77,29,6
Carlow,126,60,66,6276.15,17,12,40,31,26
Carlow,153,74,79,3812.04,17,18,39,50,29
Carlow,299,147,152,8156.25,57,43,85,76,38
Carlow,208,103,105,6592.08,42,34,61,48,23
Carlow,227,110,117,5303.99,29,54,66,30,48
Carlow,253,123,130,2583.08,38,63,61,46,45
Carlow,85,41,44,1778.69,13,48,16,5,3
Carlow,223,119,104,6034.04,24,30,54,71,44
Carlow,302,159,143,5534.78,52,49,76,77,48
Carlow,157,87,70,3798.97,16,17,42,43,39
Carlow,339,183,156,41.12,65,45,89,94,46
Carlow,417,219,198,226.54,146,25,172,55,19
Carlow,247,124,123,32.45,60,26,81,63,17
Carlow,310,141,169,85.53,68,41,91,75,35
Carlow,215,102,113,20.85,53,27,50,68,17
Carlow,206,105,101,111.89,38,17,64,50,37
Carlow,243,120,123,18.83,57,31,61,65,29
Carlow,317,160,157,20.83,69,35,93,88,32
Carlow,206,110,96,13.54,32,28,56,65,25
Carlow,254,128,126,27.42,58,27,73,57,39
Carlow,278,147,131,33.2,51,41,77,72,37
Carlow,206,112,94,10.39,42,24,63,50,27
Carlow,275,140,135,97.52,73,40,109,34,19
Carlow,316,166,150,23.47,71,30,89,95,31
Carlow,270,125,145,646.59,56,26,73,67,48
Carlow,186,91,95,32.98,44,20,68,37,17
Carlow,293,143,150,22.18,67,25,95,67,39
Carlow,257,118,139,2303.47,82,29,113,25,8
Carlow,303,156,147,21.8,57,47,78,87,34
Carlow,286,145,141,28.64,71,32,74,80,29
Carlow,365,187,178,16.14,75,35,98,102,55
Carlow,240,122,118,21.06,39,32,65,76,28
Carlow,184,95,89,66.23,39,16,81,34,14
Carlow,212,117,95,23.23,56,17,52,52,35
Carlow,267,145,122,23.77,63,29,80,56,39
Carlow,356,182,174,385.38,80,46,103,89,38
Carlow,256,135,121,324.28,62,33,74,66,21
Carlow,259,128,131,22.46,63,26,66,63,41
Carlow,263,123,140,30.05,61,30,60,70,42
Carlow,306,158,148,44.68,71,35,75,84,41
Carlow,407,207,200,184.36,92,62,113,115,25
Carlow,246,130,116,24.08,71,22,77,57,19
Carlow,348,179,169,45.94,74,50,73,119,32
Carlow,232,123,109,38.71,50,31,52,76,23
Carlow,217,113,104,24.97,38,24,73,66,16
Carlow,197,102,95,18.4,46,21,62,52,16
Carlow,227,118,109,27.99,48,28,71,50,30
Carlow,359,178,181,32.33,85,41,99,96,38
Carlow,327,154,173,18.16,68,45,91,84,39
Carlow,341,165,176,20.24,87,35,81,80,58
Carlow,305,150,155,24.71,73,40,76,90,26
Carlow,236,116,120,29.89,52,26,72,58,28
Carlow,319,177,142,115.09,42,44,81,94,58
Carlow,223,112,111,705.5,43,30,83,39,28
Carlow,312,156,156,301.34,89,28,105,58,32
Carlow,163,81,82,376.16,35,21,59,32,16
Carlow,367,194,173,23.91,96,43,95,83,50
Carlow,406,201,205,58.25,72,54,92,123,65
Carlow,240,127,113,30.41,53,32,76,50,29
Carlow,237,108,129,238.44,37,29,45,52,74
Carlow,258,142,116,3650.2,51,25,87,76,19
Carlow,343,174,169,4381.76,53,78,88,105,19
Carlow,308,150,158,6127.04,136,22,124,21,5
Carlow,268,132,136,1313.24,85,25,136,21,1
Carlow,348,182,166,4008.71,43,37,79,126,63
Carlow,207,103,104,1300.33,54,23,57,55,18
Carlow,232,118,114,1333.82,34,39,55,63,41
Carlow,241,130,111,1234.62,38,40,53,70,40
Carlow,201,111,90,913.82,22,29,36,58,56
Carlow,132,69,63,152.44,21,13,35,43,20
Carlow,203,105,98,15.21,58,18,58,46,23
Carlow,403,196,207,102.76,110,43,130,78,42
Carlow,299,161,138,49.94,54,45,71,91,38
Carlow,290,145,145,20.69,77,37,74,70,32
Carlow,278,148,130,70.23,68,57,69,60,24
Carlow,336,166,170,21.73,98,42,107,68,21
Carlow,233,121,112,59.57,68,18,72,46,29
Carlow,200,101,99,80.23,43,21,61,48,27
Carlow,268,128,140,173.46,71,23,83,61,30
Carlow,194,105,89,15.64,39,21,60,51,23
Carlow,114,65,49,4.87,16,7,32,38,21
Carlow,415,205,210,45.23,140,38,115,87,35
Carlow,298,158,140,28.6,74,27,101,70,26
Carlow,388,180,208,100.05,146,23,146,50,23
Carlow,160,74,86,399.35,35,19,54,35,17
Carlow,215,114,101,40.82,58,30,62,51,14
Carlow,155,83,72,22.3,22,18,49,45,21
Carlow,308,152,156,3396.6,91,33,105,55,24
Carlow,273,131,142,15.84,78,31,92,39,33
Carlow,269,134,135,27.22,58,36,73,74,28
Carlow,256,142,114,25.21,72,29,80,52,23
Carlow,267,140,127,64.94,63,48,79,55,22
Carlow,260,130,130,23.75,44,35,54,97,30
Carlow,438,230,208,26,111,43,130,107,47
Carlow,233,118,115,23.05,60,22,65,55,31
Carlow,201,101,100,40.43,41,17,62,56,25
Carlow,338,176,162,31.41,93,27,102,78,38
Carlow,362,186,176,29.14,82,59,93,98,30
Carlow,150,75,75,1630.12,24,18,37,40,31
Carlow,165,84,81,126.04,31,18,36,51,29
Carlow,165,65,100,291.56,22,8,32,25,78
Carlow,222,117,105,35.42,43,37,57,63,22
Carlow,114,55,59,181.33,30,3,54,18,9
Carlow,201,110,91,31.12,27,32,38,78,26
Carlow,238,112,126,410.61,64,23,98,31,22
Carlow,230,110,120,2106.63,26,27,75,46,56
Carlow,268,129,139,6132.58,32,35,75,81,45
Carlow,289,147,142,2085.86,79,30,112,51,17
Carlow,172,85,87,1437.05,22,21,40,45,44
Carlow,197,91,106,477,38,11,66,53,29
Carlow,288,149,139,720.51,69,23,129,43,24
Carlow,320,166,154,629.26,72,31,92,89,36
Carlow,285,134,151,4916,65,62,81,70,7
Carlow,291,131,160,977.2,110,33,123,21,4
Carlow,182,87,95,1067.76,48,20,90,21,3
Carlow,308,145,163,5828.92,105,31,133,33,6
Carlow,253,126,127,185.97,59,31,96,47,20
Carlow,329,172,157,30.73,81,40,89,92,27
Carlow,297,156,141,19.12,58,34,89,75,41
Carlow,268,138,130,3638.49,53,24,85,64,42
Carlow,131,69,62,1289.43,18,23,36,23,31
Carlow,184,87,97,2222.22,30,21,49,32,52
Carlow,244,120,124,5389.05,39,23,52,73,57
Carlow,192,100,92,1610.54,21,22,50,58,41
Cavan,167,88,79,19.79,39,18,52,42,16
Cavan,187,99,88,37.58,47,20,51,55,14
Cavan,194,101,93,29.59,41,18,53,57,25
Cavan,186,98,88,33.39,49,23,54,41,19
Cavan,156,81,75,30.37,35,12,39,37,33
Cavan,193,93,100,16.64,32,31,52,56,22
Cavan,206,119,87,60.9,57,14,62,49,24
Cavan,154,77,77,18.46,38,9,40,36,31
Cavan,216,115,101,212.86,45,27,66,37,41
Cavan,183,97,86,13.44,47,17,52,41,26
Cavan,160,72,88,40.79,28,17,39,40,36
Cavan,217,104,113,124.6,64,25,54,57,17
Cavan,243,117,126,16.74,66,29,68,52,28
Cavan,320,154,166,55.54,76,56,73,86,29
Cavan,280,155,125,39.33,64,27,73,68,48
Cavan,277,145,132,44.24,66,31,78,68,34
Cavan,250,127,123,1827.14,76,25,115,24,10
Cavan,180,87,93,48.18,38,32,41,52,17
Cavan,157,79,78,593.13,33,25,41,35,23
Cavan,238,114,124,83.42,55,36,71,60,16
Cavan,215,106,109,1253.73,55,22,59,51,28
Cavan,216,105,111,488.89,66,21,91,26,12
Cavan,144,69,75,131.41,21,10,37,41,35
Cavan,199,88,111,546.66,43,31,57,54,14
Cavan,199,98,101,534.85,75,27,57,24,16
Cavan,232,110,122,458.86,49,29,69,30,55
Cavan,180,95,85,1845.96,29,23,77,33,18
Cavan,107,54,53,765.83,13,11,30,26,27
Cavan,208,105,103,333.86,43,24,63,48,30
Cavan,252,132,120,32.13,52,54,53,62,31
Cavan,208,104,104,23.28,47,29,52,58,22
Cavan,195,97,98,13.08,23,35,43,68,26
Cavan,181,92,89,33.34,32,16,55,44,34
Cavan,126,63,63,245.95,25,12,50,27,12
Cavan,172,81,91,409.18,14,13,39,51,55
Cavan,191,103,88,423.1,57,21,66,33,14
Cavan,164,73,91,37.88,42,14,77,21,10
Cavan,309,158,151,195.39,76,37,148,35,13
Cavan,174,102,72,413.64,36,19,70,33,16
Cavan,258,130,128,21.64,50,30,58,83,37
Cavan,266,134,132,53.74,77,24,81,56,28
Cavan,194,97,97,407.15,42,28,54,44,26
Cavan,257,118,139,782.14,75,31,71,57,23
Cavan,300,151,149,30.1,76,31,78,78,37
Cavan,210,100,110,967.57,61,17,98,26,8
Cavan,290,146,144,190.69,89,37,110,36,18
Cavan,237,127,110,2191.36,65,24,91,36,21
Cavan,224,97,127,1533.84,68,29,88,31,8
Cavan,204,100,104,704.28,42,26,74,35,27
Cavan,230,116,114,3441.98,41,41,94,32,22
Cavan,206,119,87,3898.05,40,29,102,31,4
Cavan,258,135,123,394.75,86,23,90,39,20
Cavan,304,148,156,40.97,79,30,69,83,43
Cavan,284,142,142,287.95,70,37,96,66,15
Cavan,387,193,194,2313,134,43,129,65,16
Cavan,171,93,78,22.48,40,19,39,49,24
Cavan,182,84,98,25.58,40,20,56,38,28
Cavan,205,107,98,14.89,53,16,48,44,44
Cavan,204,97,107,26.9,54,18,59,48,25
Cavan,251,129,122,15.77,54,26,57,76,38
Cavan,203,105,98,30.24,38,30,59,45,31
Cavan,208,111,97,23.56,48,24,48,53,35
Cavan,169,93,76,11.1,32,20,46,46,25
Cavan,216,110,106,53.72,41,31,50,67,27
Cavan,351,183,168,45.37,97,34,99,79,42
Cavan,215,94,121,1155.29,65,24,66,37,23
Cavan,201,96,105,547.72,42,25,71,36,27
Cavan,197,94,103,1337.15,54,20,92,22,9
Cavan,178,91,87,69.34,35,23,37,58,25
Cavan,217,95,122,819.46,65,33,81,26,12
Cavan,240,115,125,299.38,49,33,59,72,27
Cavan,209,113,96,95.97,30,32,60,70,17
Cavan,130,64,66,896.77,22,11,36,35,26
Cavan,90,43,47,837.53,9,6,21,33,21
Cavan,123,58,65,248.8,8,7,26,48,34
Cavan,84,47,37,193.56,10,10,31,16,17
Cavan,160,80,80,2637.91,28,22,55,37,18
Cavan,125,59,66,1272.87,32,10,42,24,17
Cavan,82,44,38,2.89,4,14,17,35,12
Cavan,179,96,83,14.86,45,16,50,42,26
Cavan,208,103,105,22.07,53,23,50,45,37
Cavan,333,155,178,59.59,87,38,95,79,34
Cavan,145,73,72,64.99,26,16,45,39,19
Cavan,260,147,113,20.47,41,39,52,74,54
Cavan,311,163,148,27.35,71,32,83,77,48
Cavan,229,120,109,19.64,50,28,57,69,25
Cavan,282,135,147,25.8,65,37,89,70,21
Cavan,341,183,158,31.96,72,59,85,79,46
Cavan,187,102,85,13.2,58,17,50,44,18
Cavan,230,124,106,23.68,47,28,57,67,31
Cavan,286,153,133,50.69,71,41,85,56,33
Cavan,196,102,94,27.51,45,13,61,49,28
Cavan,201,97,104,35.25,49,20,52,49,31
Cavan,228,117,111,22.37,62,26,52,59,29
Cavan,282,150,132,14.72,64,38,75,70,35
Cavan,193,94,99,2240.23,59,13,105,10,6
Cavan,329,162,167,1256.61,107,25,141,41,15
Cavan,255,124,131,889.29,89,22,115,27,2
Cavan,329,160,169,32.13,74,30,107,74,44
Cavan,257,137,120,5400.52,87,19,137,11,3
Cavan,207,101,106,889.08,56,19,96,31,5
Cavan,339,161,178,2369.9,124,35,158,22,0
Cavan,217,113,104,1557.62,76,19,104,15,3
Cavan,221,104,117,1617.02,68,18,85,39,11
Cavan,180,98,82,506.61,39,20,86,25,10
Cavan,323,157,166,940.65,104,37,150,25,7
Cavan,151,75,76,1332.97,27,15,45,38,26
Cavan,158,83,75,896.33,28,11,60,29,30
Cavan,164,76,88,34.39,17,20,44,52,31
Cavan,478,236,242,206.4,80,35,69,130,164
Cavan,274,136,138,204.14,45,32,86,58,53
Cavan,274,131,143,746.64,49,22,106,21,76
Cavan,182,84,98,1513.89,33,47,57,28,17
Cavan,351,148,203,623.23,49,36,59,101,106
Cavan,399,201,198,107.08,93,65,106,102,33
Cavan,227,118,109,421.72,58,26,110,25,8
Cavan,276,136,140,620.37,68,26,99,55,28
Cavan,205,94,111,142.24,13,12,23,56,101
Cavan,368,171,197,139.74,108,50,114,76,20
Cavan,192,93,99,214.68,55,21,88,21,7
Cavan,345,186,159,76.82,80,29,97,102,37
Cavan,158,67,91,2281.92,36,12,98,11,1
Cavan,151,74,77,1126.98,27,14,89,20,1
Cavan,222,104,118,6169.92,64,44,90,23,1
Cavan,108,50,58,1703.17,5,22,32,25,24
Cavan,315,148,167,4990.57,104,54,82,66,9
Cavan,202,83,119,1031.6,24,12,36,57,73
Cavan,263,131,132,6747.92,84,45,103,29,2
Cavan,187,101,86,4895.8,23,41,46,63,14
Cavan,248,127,121,1114.86,46,38,75,49,40
Cavan,194,92,102,5508.23,51,29,88,21,5
Cavan,114,52,62,5349.1,9,45,39,14,7
Cavan,266,125,141,4957.23,61,45,85,54,21
Cavan,382,177,205,2697.61,104,74,95,93,16
Cavan,171,85,86,3390.91,34,25,49,39,24
Cavan,99,59,40,433.18,12,16,39,20,12
Cavan,167,87,80,1454.83,17,21,44,53,32
Cavan,79,28,51,236.05,3,4,15,14,43
Cavan,187,95,92,944.5,24,30,60,46,27
Cavan,246,112,134,1974.82,30,46,58,71,41
Cavan,199,106,93,3628.08,48,36,68,39,8
Cavan,397,209,188,46.3,83,65,100,111,38
Cavan,499,255,244,52.75,137,65,154,99,44
Cavan,300,154,146,24.23,74,36,79,74,37
Cavan,243,132,111,100.06,37,37,88,62,19
Cavan,304,150,154,26.75,67,52,74,83,28
Cavan,221,109,112,23.59,43,31,61,63,23
Cavan,178,93,85,1067.18,37,27,56,41,17
Cavan,152,77,75,4699.63,38,26,65,17,6
Cavan,185,92,93,1172.76,25,24,66,49,21
Cavan,177,90,87,1246.7,26,22,52,39,38
Cavan,160,91,69,406.74,13,21,60,42,24
Cavan,129,60,69,190.57,24,13,36,32,24
Cavan,323,148,175,1819.33,86,35,86,75,41
Cavan,288,155,133,4278.84,48,51,75,90,24
Cavan,280,132,148,25.34,59,36,72,68,45
Cavan,173,98,75,13.01,37,8,61,34,33
Cavan,265,122,143,24.94,58,36,57,76,38
Cavan,342,175,167,27.42,99,33,101,77,32
Cavan,252,134,118,29.35,73,22,83,48,26
Cavan,168,90,78,25.02,35,12,51,39,31
Cavan,244,123,121,19.99,63,35,66,50,30
Cavan,172,91,81,34.72,48,19,60,32,13
Cavan,342,179,163,37.01,88,38,84,94,38
Cavan,366,179,187,36.1,85,52,97,92,40
Cavan,389,204,185,32.29,119,40,111,78,41
Cavan,242,122,120,36.5,63,32,68,53,26
Cavan,210,103,107,32.16,58,28,48,56,20
Cavan,257,129,128,34.34,64,23,75,63,32
Cavan,231,118,113,31.94,65,24,64,59,19
Cavan,185,102,83,23.81,42,15,57,42,29
Cavan,96,59,37,4.99,17,13,14,30,22
Cavan,138,69,69,16.32,29,14,39,35,21
Cavan,147,80,67,15.66,33,21,29,45,19
Cavan,161,84,77,7.05,20,15,39,59,28
Cavan,242,124,118,31,80,28,59,52,23
Cavan,220,109,111,30.44,59,23,55,51,32
Cavan,289,145,144,27.53,56,34,83,74,42
Cavan,326,165,161,37.93,85,29,95,68,49
Cavan,319,167,152,22.99,70,55,78,80,36
Cavan,216,113,103,18.87,36,19,58,72,31
Cavan,172,88,84,35.25,47,12,56,38,19
Cavan,187,106,81,35.45,48,21,54,38,26
Cavan,176,93,83,23.57,40,27,37,48,24
Cavan,301,159,142,27.75,68,41,74,85,33
Cavan,238,129,109,20.15,53,25,70,62,28
Cavan,217,110,107,28.97,63,24,71,42,17
Cavan,244,130,114,21.15,62,36,59,68,19
Cavan,342,230,112,18.44,59,63,109,75,36
Cavan,325,185,140,30.04,87,42,80,77,39
Cavan,213,108,105,20.7,37,29,55,60,32
Cavan,199,103,96,14.63,54,13,42,64,26
Cavan,204,101,103,26.81,38,19,49,61,37
Cavan,163,83,80,27.79,32,14,50,35,32
Cavan,215,110,105,33.1,62,24,63,48,18
Cavan,235,124,111,42.04,67,23,81,44,20
Cavan,159,80,79,39.51,34,20,38,48,19
Cavan,184,86,98,20.13,35,11,35,47,56
Cavan,200,106,94,41.43,48,15,62,51,24
Cavan,234,117,117,18.03,63,22,58,51,40
Cavan,231,128,103,48.32,63,20,79,49,20
Cavan,317,170,147,17.2,63,40,85,88,41
Cavan,216,116,100,32.35,53,30,61,46,26
Cavan,153,77,76,18.85,40,12,26,47,28
Cavan,227,120,107,32.95,52,27,53,70,25
Cavan,189,97,92,19.48,37,21,55,51,25
Cavan,198,91,107,42.66,43,28,42,60,25
Cavan,214,111,103,23.3,42,25,51,68,28
Cavan,166,88,78,199.37,40,18,36,42,30
Cavan,147,76,71,401.41,8,20,35,48,36
Cavan,304,147,157,27.2,82,29,77,75,41
Cavan,176,89,87,15.83,32,25,34,54,31
Cavan,169,88,81,14.86,42,13,46,54,14
Cavan,221,115,106,22.74,57,22,60,58,24
Cavan,194,100,94,33.84,59,14,54,48,19
Cavan,256,122,134,40.04,63,27,73,61,32
Cavan,329,161,168,29.87,93,26,111,61,38
Cavan,222,109,113,119.99,26,24,57,66,49
Cavan,250,115,135,147.04,68,30,93,43,16
Cavan,112,62,50,4.68,23,15,27,28,19
Cavan,189,95,94,4110.13,23,35,50,59,22
Cavan,279,143,136,1961.27,64,39,72,58,46
Cavan,246,112,134,720.7,71,25,103,36,11
Cavan,279,118,161,209.81,107,25,79,47,21
Cavan,259,128,131,686.27,70,38,102,40,9
Cavan,353,187,166,888.64,99,31,154,44,25
Cavan,255,127,128,1019.81,75,21,87,41,31
Cavan,210,103,107,37.91,44,27,63,56,20
Cavan,401,215,186,411.73,141,45,141,53,21
Cavan,277,136,141,164.29,72,22,84,61,38
Cavan,476,233,243,55.57,90,54,133,139,60
Cavan,195,106,89,17.17,29,32,41,63,30
Cavan,245,120,125,18.5,63,29,71,60,22
Cavan,275,144,131,34.73,77,38,68,72,20
Cavan,226,116,110,14.79,41,21,65,58,41
Cavan,226,118,108,21.87,49,33,55,50,39
Cavan,239,127,112,21.02,39,34,65,65,36
Cavan,164,91,73,22.35,33,26,45,44,16
Cavan,224,111,113,31.88,59,30,69,47,19
Cavan,288,148,140,16.61,67,30,80,77,34
Cavan,163,89,74,18.12,26,19,47,36,35
Cavan,175,89,86,35.19,45,13,54,38,25
Cavan,177,93,84,25.35,34,23,64,40,16
Cavan,180,104,76,36.9,56,15,43,48,18
Cavan,208,111,97,67.76,39,18,48,37,66
Cavan,161,89,72,20.32,27,14,43,51,26
Cavan,174,97,77,13.05,38,13,35,61,27
Cavan,262,131,131,39.87,61,44,75,55,27
Cavan,203,110,93,48.29,36,18,52,65,32
Cavan,253,123,130,49,57,39,59,73,25
Cavan,295,142,153,81.45,74,36,72,87,26
Cavan,216,117,99,436.86,60,26,79,46,5
Cavan,202,95,107,1926.16,50,29,94,20,9
Cavan,244,124,120,71.99,80,28,59,62,15
Cavan,200,98,102,1512.23,67,12,81,22,18
Cavan,239,121,118,34.62,62,24,62,53,38
Cavan,368,190,178,42.63,112,32,113,82,29
Cavan,261,132,129,1725.99,76,19,112,33,21
Cavan,347,180,167,65.29,113,29,115,68,22
Cavan,332,153,179,104.65,102,26,109,66,29
Cavan,215,96,119,1641.58,72,13,92,31,7
Cavan,314,152,162,35.51,91,26,81,79,37
Cavan,310,165,145,34.47,82,36,75,73,44
Cavan,246,120,126,63.74,65,32,71,62,16
Cavan,246,124,122,29.44,86,27,61,53,19
Cavan,213,114,99,19.15,48,22,51,63,29
Cavan,229,116,113,21.93,43,30,53,51,52
Cavan,234,110,124,31.46,55,41,55,59,24
Cavan,205,109,96,20.09,36,28,52,55,34
Cavan,155,77,78,17.26,39,20,33,42,21
Cavan,231,113,118,23.27,57,27,53,72,22
Cavan,219,108,111,104.52,60,26,60,39,34
Cavan,215,110,105,20.38,48,30,58,48,31
Cavan,251,129,122,29.75,57,43,70,64,17
Cavan,188,97,91,50.03,37,23,47,54,27
Cavan,239,106,133,820.68,52,32,69,51,35
Cavan,276,133,143,382.91,59,32,120,43,22
Cavan,220,119,101,19.86,52,27,57,54,30
Cavan,208,107,101,18.23,54,19,51,49,35
Cavan,198,98,100,10.15,38,26,45,56,33
Cavan,285,141,144,33.3,73,22,87,62,41
Cavan,236,115,121,30.72,51,37,59,72,17
Cavan,256,125,131,26.16,47,34,65,67,43
Cavan,181,90,91,13.85,38,22,46,50,25
Cavan,102,42,60,142.99,15,16,21,30,20
Cavan,116,63,53,78.49,26,11,21,37,21
Cavan,307,169,138,29.13,62,51,83,75,36
Cavan,319,164,155,28.22,72,58,78,80,31
Cavan,146,79,67,17.45,22,24,33,39,28
Cavan,138,74,64,12.79,23,19,36,36,24
Cavan,247,125,122,30.81,47,37,62,71,30
Cavan,299,155,144,26.04,73,30,90,73,33
Cavan,138,69,69,6.2,21,17,20,56,24
Cavan,122,54,68,57.94,15,14,20,51,22
Cavan,128,62,66,335.05,23,22,42,21,20
Cavan,184,104,80,11.72,33,16,49,47,39
Cavan,246,116,130,40.76,49,21,67,62,47
Cavan,264,148,116,15.42,47,41,64,78,34
Cavan,184,90,94,2323.44,40,19,76,31,18
Cavan,277,138,139,1197.12,67,39,85,63,23
Cavan,312,152,160,510.5,66,37,96,58,55
Cavan,239,114,125,2246.18,73,16,95,27,28
Cavan,177,80,97,1784.56,48,12,39,44,34
Cavan,208,109,99,28.72,51,28,55,47,27
Cavan,170,85,85,698.38,62,28,61,15,4
Cavan,161,84,77,1593.19,30,15,55,40,21
Cavan,170,86,84,48.79,27,19,28,57,39
Cavan,171,76,95,1210.95,47,10,61,32,21
Cavan,226,128,98,24.69,59,26,59,52,30
Cavan,378,181,197,82.51,112,62,100,80,24
Cavan,147,79,68,377.48,16,15,49,43,24
Cavan,259,140,119,42.41,63,24,68,69,35
Cavan,165,88,77,67.43,40,22,40,38,25
Cavan,354,168,186,47.96,104,35,103,81,31
Cavan,345,179,166,33.04,105,34,93,82,31
Cavan,295,157,138,32.18,62,39,78,78,38
Cavan,275,146,129,26.53,66,23,79,57,50
Cavan,188,93,95,21.27,30,31,44,52,31
Clare,124,67,57,29.45,20,13,29,35,27
Clare,141,72,69,13.14,34,11,41,38,17
Clare,175,91,84,21.76,36,27,34,53,25
Clare,191,100,91,15.13,30,34,43,58,26
Clare,142,79,63,19.02,21,14,43,41,23
Clare,290,149,141,18.31,73,33,62,78,44
Clare,200,109,91,13.52,39,24,44,64,29
Clare,123,64,59,11.01,29,9,37,19,29
Clare,229,113,116,872.55,69,24,90,43,3
Clare,277,136,141,29.96,59,34,78,69,37
Clare,261,136,125,4206.76,60,45,64,82,10
Clare,377,225,152,217.58,100,59,129,76,13
Clare,285,149,136,18.71,85,15,85,63,37
Clare,219,108,111,16.37,42,31,54,63,29
Clare,210,101,109,100.02,44,23,67,43,33
Clare,300,142,158,277,46,27,69,85,73
Clare,405,214,191,1332.64,152,38,138,66,11
Clare,328,173,155,2491.95,126,36,91,62,13
Clare,343,161,182,61.67,77,48,77,99,42
Clare,309,162,147,561.21,46,52,55,110,46
Clare,249,125,124,112.93,40,22,46,98,43
Clare,322,158,164,3888.61,56,41,78,124,23
Clare,303,141,162,102.35,65,53,44,88,53
Clare,213,110,103,139.95,36,33,41,67,36
Clare,173,78,95,440.31,30,16,81,29,17
Clare,207,99,108,4230.36,41,36,113,15,2
Clare,264,131,133,4216.98,36,30,57,104,37
Clare,263,130,133,4041.37,35,30,67,76,55
Clare,402,207,195,3622.08,139,28,186,42,7
Clare,467,223,244,3310.04,113,75,111,136,32
Clare,277,120,157,1583.99,55,22,173,22,5
Clare,297,145,152,4278.98,88,18,169,16,6
Clare,424,202,222,6870.74,136,52,163,62,11
Clare,314,140,174,1323.88,84,49,84,91,6
Clare,257,120,137,10.85,63,33,54,74,33
Clare,260,134,126,13.19,53,33,59,79,36
Clare,159,81,78,14.04,19,12,56,38,34
Clare,159,86,73,12.86,31,25,33,56,14
Clare,287,150,137,16.91,73,28,80,75,31
Clare,294,158,136,6.1,46,41,68,96,43
Clare,211,120,91,7.87,34,27,67,53,30
Clare,220,108,112,16.19,59,27,54,55,25
Clare,196,101,95,11.08,37,24,39,53,43
Clare,154,86,68,4.66,41,16,42,34,21
Clare,355,172,183,4428.42,5,315,33,1,1
Clare,248,131,117,40.57,53,40,52,72,31
Clare,435,170,265,158.66,23,325,49,30,8
Clare,105,49,56,2.95,22,14,23,32,14
Clare,142,63,79,7.32,31,14,36,40,21
Clare,205,104,101,15.44,51,35,62,50,7
Clare,238,123,115,41.83,57,23,81,61,16
Clare,83,37,46,3.3,24,3,24,21,11
Clare,398,195,203,28.42,105,52,99,113,29
Clare,194,93,101,85.56,34,20,40,68,32
Clare,317,155,162,703.26,47,41,79,91,59
Clare,236,108,128,5247.36,59,28,74,43,32
Clare,132,66,66,964.85,19,12,35,37,29
Clare,278,127,151,1124.49,77,38,98,55,10
Clare,132,57,75,357.14,30,14,49,22,17
Clare,267,140,127,59.3,61,22,75,71,38
Clare,309,152,157,1164.88,83,26,136,55,9
Clare,243,122,121,133.47,74,23,71,53,22
Clare,125,54,71,3368.09,29,7,76,8,5
Clare,291,145,146,52.08,80,25,72,66,48
Clare,290,151,139,6.95,60,24,84,83,39
Clare,272,130,142,24.42,64,36,77,65,30
Clare,304,152,152,4114.73,85,35,157,24,3
Clare,318,167,151,2537.2,81,42,94,82,19
Clare,265,131,134,1182.77,59,33,112,46,15
Clare,373,175,198,972.79,126,60,101,76,10
Clare,240,127,113,5857.66,33,36,147,20,4
Clare,284,146,138,2928.47,91,31,114,45,3
Clare,396,203,193,4056.59,110,40,163,73,10
Clare,310,143,167,2302.52,82,37,113,64,14
Clare,358,185,173,5938.95,100,55,156,35,12
Clare,306,147,159,4895.84,85,43,95,69,14
Clare,312,158,154,4537.65,74,47,77,88,26
Clare,425,192,233,999.81,167,38,163,46,11
Clare,282,144,138,4300.88,53,40,83,60,46
Clare,339,167,172,7872.74,89,59,88,77,26
Clare,305,147,158,3902.55,74,46,107,62,16
Clare,332,168,164,1614.72,55,36,82,85,74
Clare,281,133,148,3929.36,61,30,83,59,48
Clare,276,136,140,3122.98,40,30,50,106,50
Clare,214,112,102,7685.95,46,40,75,33,20
Clare,220,112,108,5661.64,43,32,69,52,24
Clare,222,97,125,3465.77,40,18,78,52,34
Clare,215,106,109,181.94,31,22,66,54,42
Clare,89,53,36,2382.86,4,12,31,30,12
Clare,170,84,86,5870.17,22,9,50,58,31
Clare,202,102,100,5779.19,24,16,53,56,53
Clare,289,144,145,1929.16,56,23,78,77,55
Clare,221,108,113,8172.17,34,36,74,56,21
Clare,196,96,100,74.52,40,31,57,43,25
Clare,315,163,152,7231.57,73,45,82,76,39
Clare,159,77,82,793.07,24,33,54,33,15
Clare,162,74,88,8028.94,32,17,62,34,17
Clare,272,153,119,2794.53,59,47,146,17,3
Clare,216,115,101,1780.11,33,50,115,17,1
Clare,225,105,120,3330.37,29,21,64,73,38
Clare,200,96,104,984.09,17,25,37,61,60
Clare,203,103,100,4632.69,34,27,44,75,23
Clare,206,107,99,12.19,47,23,52,50,34
Clare,265,131,134,16.92,77,19,74,61,34
Clare,327,161,166,63.86,88,51,68,89,31
Clare,309,154,155,22.74,90,23,103,66,27
Clare,334,174,160,26.01,84,42,93,75,40
Clare,150,73,77,21.46,28,25,24,49,24
Clare,135,67,68,22.01,39,10,39,25,22
Clare,162,86,76,32.14,34,16,42,53,17
Clare,282,141,141,10.96,56,41,57,87,41
Clare,217,110,107,20.04,63,17,60,44,33
Clare,154,79,75,13.9,37,6,40,35,36
Clare,269,145,124,16.26,62,25,60,69,53
Clare,200,103,97,21.27,42,26,54,64,14
Clare,275,145,130,29.14,81,23,80,60,31
Clare,259,130,129,10.97,86,17,95,37,24
Clare,192,88,104,6.63,49,20,45,51,27
Clare,222,122,100,9.66,26,29,53,67,47
Clare,231,111,120,15.97,39,24,57,71,40
Clare,255,126,129,18.77,61,23,49,70,52
Clare,280,140,140,31.26,67,36,57,71,49
Clare,245,120,125,26.42,56,29,59,67,34
Clare,187,89,98,10.49,40,30,39,46,32
Clare,215,107,108,110.46,29,23,57,69,37
Clare,202,100,102,50.05,44,19,40,72,27
Clare,176,82,94,260.71,56,11,58,29,22
Clare,223,111,112,515.52,63,17,92,41,10
Clare,265,136,129,116.7,49,45,53,83,35
Clare,309,161,148,120.26,60,46,60,80,63
Clare,310,158,152,42.65,67,31,79,87,46
Clare,285,146,139,32.78,63,27,59,84,52
Clare,270,128,142,51.54,72,42,55,86,15
Clare,239,127,112,25.35,55,34,45,64,41
Clare,227,105,122,20.69,55,25,57,54,36
Clare,222,117,105,21.75,45,35,58,64,20
Clare,198,104,94,11.43,45,12,60,54,27
Clare,270,130,140,771.49,80,22,125,37,6
Clare,175,85,90,170.93,42,18,84,27,4
Clare,221,118,103,13.6,47,18,59,71,26
Clare,101,49,52,5.35,8,5,23,37,28
Clare,149,78,71,12.81,34,12,36,44,23
Clare,230,128,102,27.25,36,19,67,70,38
Clare,190,90,100,25,42,17,42,56,33
Clare,189,98,91,72.16,33,15,59,52,30
Clare,152,75,77,53.52,35,12,50,39,16
Clare,232,113,119,101.05,49,31,70,60,22
Clare,429,216,213,42.1,119,42,125,103,40
Clare,257,128,129,21.97,49,33,52,84,39
Clare,245,120,125,1020.6,62,21,142,18,2
Clare,405,204,201,358.65,138,32,132,81,22
Clare,305,151,154,51.79,74,41,72,90,28
Clare,211,94,117,27.5,28,28,54,64,37
Clare,148,75,73,11.33,31,17,42,39,19
Clare,139,56,83,507.22,14,25,38,37,25
Clare,245,124,121,18.12,48,33,54,72,38
Clare,202,106,96,15.92,42,23,44,58,35
Clare,338,172,166,59.85,72,39,83,95,49
Clare,215,97,118,131.22,20,78,39,58,20
Clare,299,140,159,25.83,42,55,74,70,58
Clare,162,84,78,7.49,36,21,38,42,25
Clare,198,98,100,16.05,42,18,47,66,25
Clare,225,111,114,15.42,50,22,64,48,41
Clare,323,172,151,18.76,76,34,74,97,42
Clare,324,167,157,19.21,70,29,71,98,56
Clare,199,101,98,339.87,39,17,119,21,3
Clare,213,107,106,2215.27,46,29,74,35,29
Clare,176,86,90,399.17,39,17,63,32,25
Clare,211,102,109,2724.94,38,18,129,19,7
Clare,371,181,190,1021.03,76,37,177,63,18
Clare,297,147,150,883.58,82,38,86,69,22
Clare,264,117,147,2946.2,36,40,52,100,36
Clare,265,131,134,2493.48,32,38,71,98,26
Clare,252,112,140,3203.34,70,36,72,61,13
Clare,277,129,148,906.05,87,28,95,56,11
Clare,181,92,89,2372.62,51,18,79,26,7
Clare,274,132,142,724.5,58,36,86,52,42
Clare,353,182,171,3292.11,116,45,117,56,19
Clare,274,140,134,5287.74,88,29,120,27,10
Clare,145,68,77,3820.72,18,14,35,49,29
Clare,236,113,123,4677.16,57,19,84,52,24
Clare,230,98,132,5033.37,46,34,74,64,12
Clare,173,88,85,1591.98,27,19,49,44,34
Clare,367,186,181,387.02,117,54,85,105,6
Clare,283,119,164,150.97,27,27,28,55,146
Clare,245,120,125,5946.6,72,30,116,25,2
Clare,190,87,103,1141.02,47,22,56,33,32
Clare,293,146,147,96.59,51,49,60,108,25
Clare,239,105,134,3499.22,46,26,69,26,72
Clare,271,134,137,549.33,66,31,95,52,27
Clare,247,118,129,1048.4,56,33,53,84,21
Clare,201,90,111,2425.37,50,29,36,67,19
Clare,233,115,118,6133.03,75,43,51,52,12
Clare,239,110,129,3545.68,35,13,52,51,88
Clare,202,85,117,1234.93,16,27,30,68,61
Clare,366,172,194,3097.18,31,28,47,94,166
Clare,320,145,175,2353.56,111,37,130,35,7
Clare,217,103,114,2184.09,32,30,57,75,23
Clare,214,118,96,3151.74,13,18,79,51,53
Clare,207,97,110,3546.89,43,20,76,43,25
Clare,198,99,99,4195.98,36,22,76,51,13
Clare,217,105,112,4153.11,49,25,84,46,13
Clare,266,129,137,2856.68,61,32,93,60,20
Clare,265,128,137,1790.93,71,25,106,54,9
Clare,287,131,156,3850.9,102,34,113,30,8
Clare,215,110,105,4625.74,35,33,66,70,11
Clare,231,118,113,1200.35,64,27,81,44,15
Clare,150,56,94,3142.81,25,10,43,31,41
Clare,176,95,81,2887.75,30,14,49,47,36
Clare,286,138,148,2344.26,73,17,121,32,43
Clare,344,168,176,2271.41,99,35,142,55,13
Clare,256,120,136,395.01,70,26,143,17,0
Clare,260,116,144,6643.84,94,23,114,28,1
Clare,195,83,112,383.62,51,16,97,28,3
Clare,258,127,131,933.64,51,30,70,67,40
Clare,274,123,151,1834.53,59,20,173,16,6
Clare,193,87,106,159.98,37,19,35,58,44
Clare,256,121,135,2401.43,100,28,79,45,4
Clare,293,148,145,539.01,76,28,137,46,6
Clare,322,142,180,3117.8,110,41,86,74,11
Clare,248,122,126,955.66,54,21,135,25,13
Clare,249,130,119,127.25,56,34,50,71,38
Clare,331,153,178,502.54,36,28,126,90,51
Clare,256,124,132,983.36,85,30,97,37,7
Clare,208,104,104,2913.08,69,26,65,37,11
Clare,191,82,109,2332.25,57,19,88,24,3
Clare,260,130,130,178.03,79,24,69,71,17
Clare,233,117,116,552.06,49,15,115,36,18
Clare,148,72,76,1444.97,30,20,44,46,8
Clare,310,152,158,2246.31,107,31,141,30,1
Clare,324,166,158,45.92,58,46,75,117,28
Clare,287,133,154,1955.19,81,17,115,49,25
Clare,295,141,154,620.71,62,29,134,47,23
Clare,187,99,88,4252.32,20,29,110,26,2
Clare,139,74,65,4961.45,18,17,34,44,26
Clare,188,92,96,5810.36,34,18,58,49,29
Clare,76,43,33,3070.33,3,8,42,18,5
Clare,167,81,86,3269,42,18,43,35,29
Clare,193,91,102,7067.27,43,29,49,45,27
Clare,277,132,145,4780.31,69,44,83,60,21
Clare,253,116,137,4568.52,78,47,61,54,13
Clare,159,92,67,2008.72,20,16,48,39,36
Clare,205,104,101,29.89,57,22,55,45,26
Clare,177,98,79,70.06,53,28,34,43,19
Clare,195,100,95,26.82,45,15,56,59,20
Clare,221,113,108,261.68,51,19,49,53,49
Clare,77,33,44,828.94,21,7,31,12,6
Clare,226,117,109,46.71,37,23,45,81,40
Clare,98,48,50,396.72,26,8,45,13,6
Clare,154,69,85,4110.61,35,12,45,40,22
Clare,173,85,88,1264.64,37,22,42,43,29
Clare,188,96,92,1860.1,37,11,69,42,29
Clare,154,87,67,1848.85,16,13,49,46,30
Clare,333,177,156,15.7,71,49,93,96,24
Clare,367,185,182,21.96,78,44,87,108,50
Clare,219,101,118,9.12,59,25,62,52,21
Clare,284,138,146,7.6,59,39,69,83,34
Clare,182,80,102,10.2,47,19,42,48,26
Clare,161,79,82,14.73,30,19,36,50,26
Clare,193,97,96,8.69,38,18,44,59,34
Clare,145,74,71,11.65,30,14,32,40,29
Clare,255,119,136,24,64,17,79,59,36
Clare,174,98,76,5.81,34,19,38,56,27
Clare,218,102,116,19.17,48,27,59,59,25
Clare,224,128,96,69.13,46,31,50,68,29
Clare,247,132,115,23.11,77,15,74,56,25
Clare,170,90,80,17.24,34,12,33,64,27
Clare,96,48,48,312.74,31,6,45,6,8
Clare,224,114,110,9.97,33,48,61,42,40
Clare,235,109,126,92.29,57,23,61,60,34
Clare,198,103,95,13.2,46,19,50,55,28
Clare,166,89,77,13.62,17,27,39,53,30
Clare,116,58,58,2685.93,17,15,23,40,21
Clare,113,63,50,816.48,19,8,22,36,28
Clare,269,139,130,169.58,47,41,56,87,38
Clare,97,41,56,113.12,7,5,15,32,38
Clare,387,202,185,25.06,80,53,94,121,39
Clare,183,91,92,193.43,53,16,70,25,19
Clare,190,91,99,83.02,46,20,51,45,28
Clare,186,86,100,78.9,46,19,70,42,9
Clare,323,157,166,5.82,75,28,87,77,56
Clare,171,82,89,263.71,31,18,53,33,36
Clare,289,150,139,40.02,67,28,87,76,31
Clare,139,71,68,243.2,26,13,38,29,33
Clare,200,104,96,16.85,50,11,43,61,35
Clare,263,135,128,43.7,61,30,65,81,26
Clare,214,102,112,173.93,58,20,88,42,6
Clare,280,132,148,907.3,75,30,74,65,36
Clare,262,145,117,817.16,56,52,70,68,16
Clare,191,106,85,2518.79,17,19,37,51,67
Clare,168,80,88,248.85,39,16,34,55,24
Clare,127,63,64,747.41,8,10,37,40,32
Clare,255,128,127,7.05,52,24,59,73,47
Clare,211,102,109,22.68,57,20,63,50,21
Clare,172,91,81,23.3,35,22,29,62,24
Clare,187,89,98,21.34,51,18,43,41,34
Clare,205,104,101,173.88,58,10,84,43,10
Clare,129,67,62,20.86,18,16,23,41,31
Clare,148,73,75,17.58,19,21,34,56,18
Clare,122,62,60,21.19,25,14,34,35,14
Clare,432,211,221,97.97,94,78,122,106,32
Clare,328,172,156,30.12,67,43,74,101,43
Clare,146,81,65,25.08,36,9,40,41,20
Clare,170,86,84,18.48,35,14,44,47,30
Clare,236,127,109,33.51,42,22,78,79,15
Clare,255,134,121,15.93,55,25,66,57,52
Clare,243,120,123,18.78,63,32,47,71,30
Clare,342,169,173,10.92,67,44,97,88,46
Clare,148,81,67,4.81,23,13,29,50,33
Clare,185,95,90,17.79,38,17,45,50,35
Clare,151,76,75,6.27,36,19,38,39,19
Clare,266,138,128,29.96,67,25,82,62,30
Clare,316,157,159,44.54,84,46,80,82,24
Clare,209,105,104,22.25,46,17,60,53,33
Clare,203,102,101,15.11,42,18,60,55,28
Clare,190,98,92,10,32,18,48,54,38
Clare,217,117,100,82.7,47,33,64,41,32
Clare,219,103,116,302.38,43,22,65,56,33
Clare,294,144,150,15.86,53,45,58,92,46
Clare,140,71,69,25.16,21,28,28,36,27
Clare,152,83,69,41.22,32,18,37,45,20
Clare,183,99,84,144.76,24,24,46,58,31
Clare,132,73,59,32.14,29,25,30,37,11
Clare,252,129,123,34.1,71,22,68,55,36
Clare,266,135,131,31,60,28,74,75,29
Clare,334,174,160,32.2,93,30,93,89,29
Clare,268,127,141,25.61,76,28,81,62,21
Clare,174,91,83,45.37,39,18,38,55,24
Clare,199,108,91,5.03,58,24,43,54,20
Clare,317,159,158,66.03,84,39,92,76,26
Clare,232,125,107,17.96,44,29,68,64,27
Clare,198,89,109,927.06,50,17,54,49,28
Clare,190,89,101,297.29,38,14,56,56,26
Clare,280,130,150,689.79,79,39,84,59,19
Clare,181,92,89,217.1,23,19,28,55,56
Clare,124,56,68,691.12,19,4,33,37,31
Clare,172,78,94,3022.9,23,19,40,53,37
Clare,81,46,35,894.28,10,14,17,29,11
Clare,77,33,44,1541.42,12,4,19,25,17
Clare,158,81,77,1741.16,18,9,30,36,65
Clare,139,66,73,3060.8,25,11,41,32,30
Clare,135,72,63,3543.21,15,28,40,33,19
Clare,247,126,121,1174.75,38,31,51,88,39
Clare,259,120,139,177,90,39,57,58,15
Clare,298,150,148,238.79,31,30,47,82,108
Clare,395,202,193,23.55,112,38,126,85,34
Clare,334,176,158,30.21,69,41,98,79,47
Clare,110,64,46,12.96,19,8,22,45,16
Clare,198,95,103,10.49,67,17,54,43,17
Clare,303,146,157,66.97,64,46,66,98,29
Clare,424,220,204,84.47,110,57,95,123,39
Clare,228,115,113,37.42,61,24,53,67,23
Clare,281,152,129,49.48,82,29,81,72,17
Clare,324,163,161,2181.51,95,44,94,77,14
Clare,245,124,121,516.53,69,17,116,33,10
Clare,195,92,103,10.17,42,19,46,54,34
Clare,258,128,130,13.71,51,20,62,83,42
Clare,244,128,116,10.02,50,20,50,78,46
Clare,125,59,66,7.19,23,9,35,29,29
Clare,182,96,86,12.01,33,27,44,43,35
Clare,226,117,109,10.86,54,28,40,65,39
Clare,315,160,155,18.41,71,40,85,74,45
Clare,135,76,59,8.82,31,17,41,37,9
Clare,177,79,98,17.82,27,16,44,40,50
Clare,80,41,39,27.45,17,7,19,21,16
Clare,268,132,136,32.11,64,20,88,58,38
Clare,274,137,137,15.04,61,36,70,78,29
Clare,364,157,207,819.38,42,59,86,89,88
Clare,250,121,129,26.39,56,29,64,72,29
Clare,247,117,130,81.1,37,36,49,78,47
Clare,233,133,100,27.17,51,26,60,75,21
Clare,336,172,164,20.38,93,31,108,76,28
Clare,169,90,79,7.52,46,18,47,45,13
Clare,245,115,130,16.29,48,22,67,81,27
Clare,297,167,130,12.2,58,29,80,80,50
Clare,79,39,40,57.04,12,5,17,29,16
Clare,231,103,128,90.21,45,28,47,56,55
Clare,258,134,124,94.25,39,31,79,78,31
Clare,178,96,82,56.33,36,19,36,62,25
Clare,154,87,67,27.81,31,19,37,46,21
Clare,118,57,61,124.35,10,19,37,39,13
Clare,180,76,104,968.53,42,23,60,35,20
Clare,150,68,82,238.11,35,14,29,51,21
Clare,78,39,39,771.13,7,6,22,22,21
Clare,94,44,50,3.3,19,12,14,38,11
Clare,289,147,142,20.58,85,31,72,81,20
Clare,257,130,127,62.42,79,21,67,68,22
Clare,191,100,91,178.69,46,18,58,42,27
Clare,282,146,136,191.92,81,19,123,51,8
Clare,207,102,105,4219.84,56,25,72,52,2
Clare,191,100,91,10.28,46,20,43,55,27
Clare,88,45,43,61.52,25,8,28,20,7
Clare,85,40,45,110.12,12,12,21,26,14
Clare,217,110,107,14.98,40,26,50,69,32
Clare,141,84,57,24.52,37,19,28,41,16
Clare,155,77,78,33.74,26,12,33,53,31
Clare,140,71,69,13.39,27,17,38,33,25
Clare,97,53,44,5.06,21,9,20,28,19
Clare,319,169,150,9.69,64,33,88,95,39
Clare,224,118,106,13.33,38,28,51,62,45
Clare,293,158,135,13.12,81,39,73,69,31
Clare,219,113,106,31.99,31,41,38,78,31
Clare,292,150,142,2722.79,37,24,86,75,70
Clare,292,145,147,2063.69,69,47,75,68,33
Clare,256,126,130,2053.03,63,26,112,49,6
Clare,245,128,117,664.25,25,29,65,72,54
Clare,219,113,106,80.4,56,23,73,51,16
Clare,382,200,182,43.78,39,15,149,149,30
Clare,125,72,53,4.8,26,13,33,28,25
Clare,367,195,172,53.26,90,40,111,89,37
Clare,202,102,100,15.83,48,20,44,60,30
Clare,257,129,128,16.09,73,21,62,74,27
Clare,237,120,117,20.89,68,23,71,45,30
Clare,128,64,64,3.31,17,13,30,42,26
Clare,199,98,101,9.1,52,24,40,45,38
Clare,214,108,106,1370.87,66,7,86,34,21
Clare,335,161,174,482.07,86,41,128,61,19
Clare,331,159,172,254.3,119,20,132,51,9
Clare,340,163,177,44.54,91,43,111,66,29
Clare,234,121,113,27.2,70,23,52,57,32
Clare,154,79,75,12.56,30,19,26,41,38
Clare,275,140,135,17.5,52,29,69,75,50
Clare,94,46,48,3.21,12,9,28,26,19
Clare,149,74,75,12.16,19,31,27,57,15
Clare,196,100,96,9.37,42,16,52,43,43
Clare,391,196,195,31.12,95,50,105,115,26
Clare,354,176,178,99.95,134,49,84,74,13
Clare,167,86,81,15.94,30,21,40,47,29
Clare,247,117,130,28.64,61,25,65,68,28
Clare,309,157,152,31.86,77,37,85,84,26
Clare,274,134,140,36.9,68,30,79,56,41
Clare,187,90,97,88.77,34,17,46,55,35
Clare,293,141,152,28.81,88,22,94,58,31
Clare,185,88,97,284.5,34,15,49,47,40
Clare,176,87,89,152.79,30,20,55,41,30
Clare,246,120,126,29.79,57,31,45,64,49
Clare,404,208,196,62.99,84,41,94,125,60
Clare,270,139,131,40.05,71,25,86,58,30
Clare,362,173,189,530.92,95,35,147,65,20
Clare,388,192,196,523.74,100,65,105,100,18
Clare,302,144,158,676.91,94,27,137,33,11
Clare,347,172,175,1043.04,120,21,160,40,6
Clare,258,136,122,3442.34,54,21,68,79,36
Clare,273,129,144,829.13,73,19,143,26,12
Clare,142,78,64,11.01,31,15,29,44,23
Clare,219,113,106,62.87,56,23,50,59,31
Clare,247,133,114,26.84,61,29,78,52,27
Clare,228,123,105,40.41,61,25,58,60,24
Clare,104,49,55,4.54,29,11,26,24,14
Clare,301,164,137,58.07,87,24,77,79,34
Clare,353,165,188,91.74,92,44,73,103,41
Clare,221,112,109,28.92,58,23,61,53,26
Clare,324,152,172,63.04,73,54,73,92,32
Clare,160,86,74,10.02,34,17,45,36,28
Clare,231,112,119,22.98,57,22,61,69,22
Clare,209,108,101,55.5,45,23,51,63,27
Clare,214,116,98,26.45,62,17,65,42,28
Clare,226,116,110,22.71,41,34,57,78,16
Clare,281,151,130,33.76,76,33,89,55,28
Clare,251,119,132,530.78,72,20,70,52,37
Clare,158,75,83,436.98,42,16,41,35,24
Clare,163,88,75,456.82,35,12,64,32,20
Clare,121,64,57,7.65,29,15,15,46,16
Clare,133,65,68,11.25,23,13,31,40,26
Clare,302,146,156,17.04,61,40,66,95,40
Clare,273,134,139,1609.72,55,34,144,31,9
Clare,374,154,220,52.47,45,36,56,78,159
Clare,238,114,124,2266.06,58,24,52,60,44
Clare,268,138,130,7125.01,46,20,76,85,41
Clare,383,153,230,7162.23,122,38,115,72,36
Clare,178,95,83,807.98,20,20,75,44,19
Clare,197,93,104,4283.07,23,25,56,52,41
Clare,164,82,82,974.64,21,22,40,51,30
Clare,118,59,59,1752.07,14,10,32,34,28
Clare,256,109,147,885.49,42,21,77,54,62
Clare,148,69,79,3424.5,23,11,45,38,31
Clare,143,69,74,1748.12,13,9,46,42,33
Clare,145,65,80,4700.62,18,11,40,34,42
Clare,212,91,121,4323.09,36,23,58,42,53
Clare,209,97,112,2721.92,41,14,97,32,25
Clare,301,142,159,1963.92,28,17,91,90,75
Clare,124,66,58,4390.93,8,8,35,33,40
Clare,114,54,60,3337.24,11,14,32,35,22
Cork,161,87,74,33.75,32,18,32,60,19
Cork,249,113,136,36.6,62,20,62,60,45
Cork,226,119,107,30.93,55,29,56,56,30
Cork,90,51,39,9.48,11,8,9,36,26
Cork,130,69,61,16.43,34,11,27,29,29
Cork,287,139,148,21.46,70,34,57,79,47
Cork,128,69,59,24.16,13,20,20,50,25
Cork,145,69,76,40.22,34,13,31,45,22
Cork,134,73,61,32.89,30,15,33,35,21
Cork,231,118,113,14.84,50,19,77,51,34
Cork,225,110,115,16.67,47,28,59,71,20
Cork,220,110,110,36.51,51,24,62,57,26
Cork,267,128,139,41.9,70,33,65,72,27
Cork,357,188,169,41.11,75,46,96,93,47
Cork,394,187,207,90.39,85,48,109,102,50
Cork,348,175,173,56.3,74,50,79,99,46
Cork,221,114,107,3.9,57,23,58,45,38
Cork,207,102,105,15.83,44,19,63,54,27
Cork,257,130,127,21.97,52,47,58,77,23
Cork,348,170,178,19.07,83,46,95,86,38
Cork,301,151,150,22.12,82,34,93,58,34
Cork,221,119,102,33.63,57,20,53,62,29
Cork,173,75,98,64.56,43,16,42,42,30
Cork,142,71,71,27.28,23,23,29,41,26
Cork,177,92,85,50.88,33,30,36,53,25
Cork,174,84,90,78.08,42,15,49,49,19
Cork,244,125,119,14.2,61,15,71,56,41
Cork,381,202,179,23.42,82,51,107,92,49
Cork,335,170,165,13.74,84,27,113,59,52
Cork,219,106,113,22.91,68,24,59,53,15
Cork,267,135,132,31.71,51,31,97,66,22
Cork,321,145,176,3140.13,92,31,174,24,0
Cork,450,221,229,4333.34,142,52,157,87,12
Cork,311,144,167,6772.35,111,23,135,36,6
Cork,233,108,125,4858.32,67,25,113,23,5
Cork,360,180,180,1357.31,58,50,94,100,58
Cork,405,206,199,3279.59,100,41,160,60,44
Cork,264,130,134,7132.82,30,67,58,101,8
Cork,352,181,171,5212.73,112,15,184,34,7
Cork,362,180,182,2794.37,131,56,80,84,11
Cork,199,92,107,5321.28,56,3,125,14,1
Cork,253,129,124,1882.9,46,24,163,17,3
Cork,217,111,106,706.61,20,41,44,72,40
Cork,348,176,172,107.5,70,45,72,96,65
Cork,341,164,177,298.03,68,57,56,126,34
Cork,230,109,121,4690.81,46,26,74,55,29
Cork,386,173,213,3562.89,94,69,88,124,11
Cork,260,123,137,3346.42,41,36,68,72,43
Cork,217,113,104,7122.46,32,35,55,60,35
Cork,258,134,124,4156.2,45,37,72,68,36
Cork,347,161,186,6820.77,49,78,83,124,13
Cork,197,102,95,5074.57,32,23,42,58,42
Cork,230,118,112,5096.5,42,28,66,63,31
Cork,244,123,121,4341.71,29,46,48,81,40
Cork,293,142,151,3952.68,53,47,69,99,25
Cork,288,143,145,6697.67,41,39,73,104,31
Cork,249,120,129,6044.13,41,37,78,74,19
Cork,267,132,135,1371.64,53,37,66,79,32
Cork,296,150,146,3753.96,55,51,72,86,32
Cork,243,112,131,114.99,71,31,46,82,13
Cork,298,138,160,206.11,38,47,63,105,45
Cork,318,158,160,128.58,60,43,89,91,35
Cork,314,167,147,1978.96,62,51,87,97,17
Cork,300,146,154,4223.51,59,39,73,89,40
Cork,209,90,119,4492.5,51,40,49,54,15
Cork,216,102,114,496.73,59,37,52,57,11
Cork,196,92,104,4248.31,59,10,115,10,2
Cork,142,67,75,1846.82,24,11,91,16,0
Cork,237,116,121,1472.49,64,12,127,27,7
Cork,325,162,163,1214.99,69,45,138,65,8
Cork,225,105,120,4329.34,39,27,57,63,39
Cork,255,120,135,4978.14,35,41,73,78,28
Cork,229,121,108,5552.19,50,31,64,73,11
Cork,292,135,157,2895.42,62,40,100,60,30
Cork,248,124,124,3467.76,54,41,102,48,3
Cork,241,115,126,436.09,96,19,82,38,6
Cork,319,154,165,7611.19,145,25,117,29,3
Cork,323,141,182,3183.77,69,44,145,50,15
Cork,200,94,106,7429.97,57,9,122,10,2
Cork,164,85,79,8931.49,46,9,98,10,1
Cork,283,141,142,44.72,77,31,71,87,17
Cork,217,101,116,1072.04,94,13,83,19,8
Cork,276,131,145,931.07,69,57,48,93,9
Cork,303,160,143,4332.1,83,46,96,71,7
Cork,350,163,187,5259.28,106,37,122,71,14
Cork,314,141,173,3008.64,41,54,86,86,47
Cork,197,95,102,926.31,27,21,43,79,27
Cork,310,155,155,6076.53,35,58,74,123,20
Cork,206,87,119,6546.75,48,27,95,32,4
Cork,162,80,82,11169.33,22,15,106,16,3
Cork,168,85,83,4546.93,31,20,73,37,7
Cork,172,76,96,1728.57,31,19,71,39,12
Cork,143,69,74,1145.29,21,18,62,21,21
Cork,398,197,201,9244.42,78,62,118,109,31
Cork,532,268,264,62.97,128,80,141,143,40
Cork,224,94,130,1899.83,77,29,88,28,2
Cork,238,106,132,865.71,45,22,96,34,41
Cork,187,97,90,22.58,41,18,51,50,27
Cork,238,121,117,26.43,72,22,60,62,22
Cork,218,109,109,33.34,63,19,50,53,33
Cork,259,129,130,34.82,70,25,84,50,30
Cork,192,92,100,83.94,50,18,53,48,23
Cork,180,89,91,34.5,35,20,64,32,29
Cork,252,118,134,33.86,31,30,51,64,76
Cork,119,67,52,15.32,19,6,41,26,27
Cork,166,88,78,33.61,31,15,46,44,30
Cork,304,161,143,21.65,76,30,103,55,40
Cork,160,78,82,14.67,33,16,34,48,29
Cork,143,78,65,9.27,29,12,25,53,24
Cork,220,108,112,19.99,54,15,63,56,32
Cork,231,111,120,31.33,51,40,57,71,12
Cork,230,122,108,29.32,55,22,74,52,27
Cork,138,67,71,123.17,22,6,39,36,35
Cork,247,133,114,46.35,54,33,62,83,15
Cork,191,99,92,40.5,41,10,46,57,37
Cork,169,75,94,157.02,53,13,57,35,11
Cork,182,99,83,1078.94,35,19,45,61,22
Cork,172,79,93,330.71,26,20,43,59,24
Cork,140,67,73,1161.18,39,7,66,22,6
Cork,248,125,123,52.57,59,22,65,65,37
Cork,142,74,68,14.86,28,14,28,47,25
Cork,113,51,62,22.64,24,13,18,39,19
Cork,112,57,55,28.91,21,7,30,35,19
Cork,162,85,77,276.88,29,15,41,41,36
Cork,97,47,50,535.75,12,10,21,31,23
Cork,358,189,169,25.54,91,31,123,74,39
Cork,355,187,168,26.47,86,38,111,81,39
Cork,327,139,188,93,48,29,59,95,96
Cork,279,145,134,75.6,57,20,84,87,31
Cork,294,152,142,68.41,74,30,83,77,30
Cork,428,224,204,2333.1,163,27,193,39,6
Cork,394,193,201,67.86,77,43,105,113,56
Cork,242,132,110,109.71,37,28,46,83,48
Cork,226,113,113,1683.92,46,8,153,14,5
Cork,203,90,113,793.13,50,16,111,16,10
Cork,215,107,108,5677.32,63,6,135,10,1
Cork,331,171,160,36.01,90,52,70,88,31
Cork,355,179,176,55.88,85,45,87,100,38
Cork,277,141,136,17.12,56,31,77,68,45
Cork,207,112,95,14.36,26,31,64,60,26
Cork,215,112,103,103.86,73,16,80,37,9
Cork,203,94,109,43.84,47,20,61,50,25
Cork,153,69,84,1369.09,44,14,58,26,11
Cork,177,91,86,25.33,34,18,43,42,40
Cork,166,75,91,37.12,27,14,53,50,22
Cork,301,157,144,29.68,78,29,94,73,27
Cork,269,132,137,33.5,64,47,66,71,21
Cork,267,141,126,35.37,84,38,59,56,30
Cork,348,168,180,598.94,105,31,151,43,18
Cork,245,122,123,50.24,62,24,63,69,27
Cork,247,122,125,42.19,58,29,72,57,31
Cork,279,136,143,148.35,59,37,76,75,32
Cork,350,175,175,34.64,82,75,69,93,31
Cork,245,128,117,903.32,44,22,59,62,58
Cork,295,149,146,2676.39,67,23,132,56,17
Cork,238,115,123,393.89,58,28,72,56,24
Cork,298,147,151,1551.28,76,29,91,70,32
Cork,207,112,95,92.83,42,28,49,66,22
Cork,332,150,182,4416.13,51,44,91,104,42
Cork,179,89,90,123.97,38,19,37,56,29
Cork,162,88,74,1809.35,19,14,54,42,33
Cork,211,108,103,1385.3,52,17,91,32,19
Cork,238,117,121,5189.59,76,21,106,21,14
Cork,337,160,177,6051.36,95,82,87,65,8
Cork,285,133,152,3729.1,71,28,93,71,22
Cork,321,157,164,940.64,80,41,87,79,34
Cork,259,124,135,402.23,50,33,73,68,35
Cork,325,173,152,26.71,78,40,86,94,27
Cork,224,123,101,21.91,45,25,69,50,35
Cork,276,141,135,35.43,73,40,77,60,26
Cork,364,185,179,167.58,123,36,141,47,17
Cork,376,192,184,76.2,101,39,111,87,38
Cork,427,216,211,26.74,104,55,119,106,43
Cork,266,135,131,22.1,79,15,88,40,44
Cork,189,90,99,23.08,50,14,61,42,22
Cork,231,126,105,23.72,44,36,52,72,27
Cork,285,154,131,25.77,71,29,89,57,39
Cork,220,105,115,12.01,61,21,69,45,24
Cork,210,102,108,22.34,61,17,62,43,27
Cork,231,116,115,34.19,61,33,72,48,17
Cork,316,152,164,23.74,88,21,82,84,41
Cork,187,95,92,74.98,35,23,52,55,22
Cork,332,167,165,18.8,56,40,84,96,56
Cork,186,77,109,114.52,39,26,44,50,27
Cork,227,111,116,2625.64,29,25,37,93,43
Cork,195,101,94,3613.99,16,20,76,50,33
Cork,147,74,73,3477.15,14,20,42,41,30
Cork,84,43,41,2108.75,8,3,34,20,19
Cork,81,41,40,2553.35,6,16,29,20,10
Cork,159,76,83,495.79,32,10,52,42,23
Cork,126,70,56,838.38,20,21,28,40,17
Cork,173,96,77,126.18,42,15,41,40,35
Cork,435,180,255,203.66,74,38,91,86,146
Cork,372,184,188,215.84,56,23,83,87,123
Cork,202,110,92,87.46,33,31,41,60,37
Cork,212,92,120,2129.71,52,23,55,54,28
Cork,136,60,76,2329.21,22,12,41,32,29
Cork,327,157,170,1156.01,105,33,100,57,32
Cork,253,120,133,241.37,46,52,52,80,23
Cork,219,107,112,884.56,66,21,91,30,11
Cork,291,167,124,12.29,63,42,64,82,40
Cork,240,118,122,17.67,53,18,48,62,59
Cork,219,119,100,12.82,43,17,78,59,22
Cork,324,171,153,25.26,90,22,111,59,42
Cork,173,85,88,13.64,43,11,40,51,28
Cork,152,80,72,14.51,20,30,26,57,19
Cork,210,107,103,4.93,51,37,29,56,37
Cork,179,101,78,7.14,37,18,49,50,25
Cork,229,118,111,37.63,64,17,61,52,35
Cork,136,78,58,48.94,12,32,27,49,16
Cork,272,139,133,9.59,50,35,64,82,41
Cork,84,46,38,13.84,14,5,16,22,27
Cork,279,149,130,16.86,62,31,82,64,40
Cork,234,115,119,22.39,62,27,67,51,27
Cork,381,194,187,39.35,109,39,106,91,36
Cork,340,159,181,36.15,93,47,84,83,33
Cork,243,120,123,55.46,55,28,65,74,21
Cork,345,173,172,360.3,108,23,123,66,25
Cork,333,170,163,85.12,76,50,71,102,34
Cork,293,139,154,3591.87,88,21,156,26,2
Cork,236,112,124,239.61,51,46,65,52,22
Cork,250,102,148,3951.76,65,41,61,61,22
Cork,235,110,125,2397.05,29,22,61,73,50
Cork,323,153,170,2798.67,99,42,110,63,9
Cork,339,163,176,134.18,79,34,107,76,43
Cork,212,96,116,1796.08,58,31,53,57,13
Cork,196,86,110,2192.74,65,16,92,19,4
Cork,215,101,114,2961.39,69,18,89,31,8
Cork,208,107,101,3948.37,55,19,75,47,12
Cork,373,176,197,538.49,115,34,137,66,21
Cork,260,122,138,58.2,60,34,49,76,41
Cork,242,130,112,90.56,59,33,81,45,24
Cork,204,105,99,1650.77,23,15,54,71,41
Cork,261,129,132,3364.66,40,41,64,82,34
Cork,182,95,87,5300.4,26,18,59,55,24
Cork,145,74,71,161.08,21,10,41,33,40
Cork,215,99,116,245.69,27,26,56,62,44
Cork,191,96,95,25.41,30,22,58,46,35
Cork,199,92,107,105.84,18,28,40,91,22
Cork,326,167,159,34.8,83,40,88,82,33
Cork,319,157,162,26.74,91,33,93,73,29
Cork,126,64,62,28.32,22,15,22,43,24
Cork,195,107,88,18.78,51,28,39,50,27
Cork,129,59,70,46.17,15,9,31,45,29
Cork,152,73,79,724.13,31,23,44,31,23
Cork,346,173,173,28.08,91,37,93,83,42
Cork,349,164,185,39.26,70,43,89,89,58
Cork,250,127,123,34.01,63,24,57,64,42
Cork,199,99,100,39.47,28,34,54,66,17
Cork,219,114,105,22.12,50,33,61,60,15
Cork,179,83,96,21.63,53,19,50,29,28
Cork,196,97,99,23.09,48,25,45,53,25
Cork,163,73,90,4301.25,28,9,48,47,31
Cork,177,88,89,118.34,43,13,55,43,23
Cork,128,63,65,984.34,17,7,34,29,41
Cork,157,84,73,196.04,23,11,42,45,36
Cork,115,57,58,321.31,33,7,57,6,12
Cork,173,96,77,1740.74,21,30,40,50,32
Cork,327,165,162,13.39,81,38,77,80,51
Cork,279,148,131,11.89,61,37,69,86,26
Cork,241,130,111,9.85,38,30,54,64,55
Cork,232,107,125,38.87,49,18,64,77,24
Cork,308,163,145,30.41,63,37,98,80,30
Cork,178,87,91,96.74,31,23,37,54,33
Cork,174,82,92,27.71,24,19,49,50,32
Cork,234,126,108,299.5,45,42,42,72,33
Cork,192,102,90,179.22,28,30,48,58,28
Cork,321,151,170,6391.49,112,19,163,25,2
Cork,379,184,195,2545.13,145,35,133,62,4
Cork,364,170,194,1481.77,136,45,116,49,18
Cork,409,202,207,3458.34,147,25,203,32,2
Cork,261,133,128,4371.86,79,30,120,29,3
Cork,191,97,94,632.53,44,5,117,18,7
Cork,281,141,140,35.82,47,45,63,95,31
Cork,291,138,153,2177.79,74,45,81,73,18
Cork,295,150,145,206.19,66,45,79,77,28
Cork,144,71,73,3163.93,29,9,100,6,0
Cork,304,156,148,5482.81,87,32,119,63,3
Cork,361,181,180,2516.24,87,52,65,108,49
Cork,231,105,126,5929.16,43,21,80,51,36
Cork,250,125,125,492.99,53,27,64,69,37
Cork,451,236,215,974.38,111,34,245,46,15
Cork,193,88,105,33.61,36,25,45,62,25
Cork,197,106,91,481.55,54,22,69,39,13
Cork,199,98,101,116.42,34,16,49,56,44
Cork,151,76,75,1106.14,24,14,56,38,19
Cork,282,145,137,745.97,112,25,70,70,5
Cork,244,129,115,1205.79,58,34,52,70,30
Cork,195,99,96,18.48,31,25,36,66,37
Cork,199,102,97,22.52,44,33,45,54,23
Cork,317,157,160,20.07,77,29,89,79,43
Cork,276,130,146,23.06,81,31,68,67,29
Cork,319,163,156,29.63,88,35,99,59,38
Cork,124,63,61,19.45,27,11,20,49,17
Cork,114,53,61,21.46,11,27,18,41,17
Cork,94,51,43,14.3,16,7,14,42,15
Cork,238,116,122,19.2,46,20,66,73,33
Cork,145,85,60,8.08,37,14,50,34,10
Cork,208,108,100,27.46,40,36,42,72,18
Cork,249,118,131,1412.29,79,22,102,34,12
Cork,266,122,144,3348.61,39,27,82,87,31
Cork,436,191,245,221.06,91,47,178,91,29
Cork,300,150,150,2568.16,35,36,71,95,63
Cork,187,95,92,73.99,34,25,43,75,10
Cork,232,105,127,85.12,43,11,68,59,51
Cork,272,135,137,154.74,63,48,50,85,26
Cork,214,103,111,101.64,32,29,53,64,36
Cork,306,155,151,48.64,65,51,72,89,29
Cork,295,149,146,3613.47,98,23,143,23,8
Cork,193,95,98,7254.82,58,9,106,17,3
Cork,387,191,196,1593.1,139,26,178,38,6
Cork,210,104,106,5597.01,63,8,124,15,0
Cork,285,142,143,351.65,101,23,108,42,11
Cork,313,153,160,5606.81,118,24,129,37,5
Cork,372,185,187,6675.76,94,57,136,76,9
Cork,291,151,140,6202.84,99,18,151,19,4
Cork,243,115,128,6798.91,65,13,146,12,7
Cork,221,109,112,3231.32,34,48,29,94,16
Cork,218,110,108,3756.68,36,33,48,86,15
Cork,371,185,186,4822.19,98,62,92,107,12
Cork,300,161,139,439.11,52,53,63,111,21
Cork,341,161,180,2084.57,59,65,77,112,28
Cork,367,193,174,4849.3,130,42,123,65,7
Cork,349,162,187,6032.84,114,28,170,34,3
Cork,316,155,161,4821.04,109,29,114,57,7
Cork,343,172,171,6011.95,124,27,160,27,5
Cork,250,123,127,6995.36,78,18,130,22,2
Cork,198,89,109,654.33,57,23,76,36,6
Cork,389,191,198,5580.18,123,53,158,51,4
Cork,299,143,156,4734.38,89,41,76,86,7
Cork,215,102,113,2754.29,36,22,57,66,34
Cork,366,169,197,4890.83,131,24,160,39,12
Cork,353,162,191,2275.57,111,37,141,60,4
Cork,229,115,114,1930.7,27,32,66,67,37
Cork,263,123,140,1234.62,40,39,42,103,39
Cork,238,126,112,4159.24,35,45,40,83,35
Cork,310,145,165,4268.15,76,39,120,61,14
Cork,250,121,129,5801.14,79,27,93,37,14
Cork,337,159,178,6074.04,62,58,98,97,22
Cork,331,164,167,3830.66,83,62,77,92,17
Cork,282,142,140,2125.88,33,49,67,105,28
Cork,172,87,85,2080.84,22,21,27,52,50
Cork,363,178,185,163.69,101,36,109,86,31
Cork,244,114,130,50.64,47,29,54,80,34
Cork,217,128,89,117.58,33,55,71,49,9
Cork,148,68,80,2139.19,25,22,50,29,22
Cork,157,81,76,73.7,39,11,59,21,27
Cork,177,91,86,18.77,31,19,41,46,40
Cork,185,103,82,16.62,27,24,41,59,34
Cork,279,150,129,16.49,74,38,62,66,39
Cork,212,105,107,16.47,60,24,52,50,26
Cork,274,133,141,14.9,68,37,71,68,30
Cork,294,152,142,38.92,63,43,82,84,22
Cork,276,134,142,49.29,54,52,59,90,21
Cork,345,176,169,229.21,99,42,117,67,20
Cork,198,97,101,106.8,40,18,50,65,25
Cork,368,191,177,38.9,67,59,73,119,50
Cork,253,113,140,82.36,36,43,47,78,49
Cork,174,97,77,42.25,24,19,39,65,27
Cork,184,90,94,76.99,31,23,34,63,33
Cork,248,129,119,107.03,25,32,53,88,50
Cork,458,231,227,198.35,135,37,147,81,58
Cork,244,120,124,100.31,49,32,75,58,30
Cork,234,116,118,37.38,39,39,45,86,25
Cork,214,115,99,33.88,39,34,52,68,21
Cork,252,135,117,42.4,53,29,75,69,26
Cork,319,163,156,470.99,70,21,126,61,41
Cork,333,167,166,3285.19,68,52,109,78,26
Cork,243,123,120,1119.16,38,18,94,43,50
Cork,298,142,156,3385.59,82,19,149,41,7
Cork,271,130,141,606.04,97,21,123,19,11
Cork,193,100,93,21.9,48,16,59,45,25
Cork,242,103,139,141.46,48,36,45,75,38
Cork,256,130,126,22.04,72,35,78,51,20
Cork,315,164,151,3307.99,115,10,178,12,0
Cork,330,161,169,5224.08,112,14,187,13,4
Cork,197,96,101,9089.65,43,14,129,11,0
Cork,296,138,158,1023.41,88,23,161,21,3
Cork,299,147,152,811.05,87,33,125,46,8
Cork,214,99,115,7173.75,40,16,146,11,1
Cork,314,157,157,7240.86,108,11,186,8,1
Cork,227,104,123,3008.77,68,14,129,16,0
Cork,403,195,208,8510.73,147,25,208,22,1
Cork,278,128,150,4741.76,41,50,56,107,24
Cork,235,122,113,4822.29,58,24,91,46,16
Cork,390,183,207,25.79,100,45,99,107,39
Cork,246,123,123,24.31,60,23,75,64,24
Cork,266,132,134,39.55,49,28,62,82,45
Cork,255,129,126,82.61,53,27,57,53,65
Cork,195,99,96,13.46,45,23,55,45,27
Cork,242,118,124,18.33,50,32,66,62,32
Cork,170,78,92,35.95,33,21,60,46,10
Cork,176,93,83,21.73,45,14,35,46,36
Cork,330,161,169,27.97,82,29,77,83,59
Cork,110,59,51,58.89,36,11,31,24,8
Cork,318,161,157,72.48,71,42,78,85,42
Cork,293,142,151,146.03,82,32,91,72,16
Cork,234,123,111,27.22,45,31,60,67,31
Cork,195,108,87,24.5,34,22,56,55,28
Cork,293,143,150,20.49,60,34,88,81,30
Cork,289,144,145,64.17,66,15,143,51,14
Cork,254,124,130,39.44,70,32,73,62,17
Cork,272,143,129,46.11,62,27,83,70,30
Cork,186,91,95,27.33,36,18,54,44,34
Cork,207,110,97,50.33,34,21,52,58,42
Cork,205,96,109,271.59,50,23,80,33,19
Cork,278,156,122,84.98,50,24,66,82,56
Cork,228,122,106,16.12,44,21,66,56,41
Cork,146,70,76,24.1,22,14,40,52,18
Cork,226,119,107,24.32,51,30,63,52,30
Cork,233,120,113,23.39,56,28,73,50,26
Cork,259,124,135,19.83,65,28,81,60,25
Cork,202,98,104,84.34,47,18,85,37,15
Cork,193,108,85,3093.39,25,21,56,49,42
Cork,242,113,129,3421.95,61,21,60,52,48
Cork,222,117,105,4267.67,46,22,120,30,4
Cork,311,162,149,61.53,57,55,64,89,46
Cork,238,112,126,749.3,31,37,66,51,53
Cork,250,115,135,3180.7,91,30,73,51,5
Cork,228,121,107,5351.61,58,33,114,20,3
Cork,266,115,151,983.6,65,25,64,67,45
Cork,198,108,90,1042.64,20,38,68,35,37
Cork,193,108,85,2117.13,28,28,85,32,20
Cork,220,121,99,3218.02,47,26,55,65,27
Cork,172,91,81,31.53,37,19,43,41,32
Cork,230,137,93,87.82,60,29,69,55,17
Cork,242,121,121,2758.81,70,24,108,31,9
Cork,152,76,76,194.13,32,11,72,21,16
Cork,194,100,94,200,27,15,51,45,56
Cork,251,104,147,1330.46,21,21,41,56,112
Cork,306,152,154,19.71,63,33,83,75,52
Cork,286,144,142,12.11,64,25,78,80,39
Cork,244,101,143,453.2,48,7,71,32,86
Cork,243,126,117,2055.39,67,22,110,34,10
Cork,216,117,99,7.76,48,17,68,60,23
Cork,328,179,149,16.09,68,46,98,73,43
Cork,170,93,77,14.97,27,22,40,55,26
Cork,176,92,84,14.84,39,22,37,57,21
Cork,312,155,157,36.11,73,45,83,77,34
Cork,218,94,124,32.72,59,22,62,47,28
Cork,248,126,122,80.78,65,18,96,48,21
Cork,254,124,130,113.94,55,37,70,72,20
Cork,214,113,101,153.85,48,23,57,67,19
Cork,327,148,179,4296.3,96,18,127,31,55
Cork,210,99,111,1415.01,58,18,90,30,14
Cork,290,136,154,3210.42,60,38,98,56,38
Cork,257,126,131,496.29,56,37,94,54,16
Cork,251,120,131,1841.96,73,35,74,59,10
Cork,113,57,56,4763.91,5,14,55,20,19
Cork,111,61,50,2863.19,6,16,41,25,23
Cork,140,61,79,1313.36,16,16,41,42,25
Cork,385,173,212,652.35,98,54,116,79,38
Cork,241,118,123,343.61,55,28,69,61,28
Cork,93,54,39,2579.68,10,6,43,24,10
Cork,150,82,68,3722.27,21,11,45,43,30
Cork,177,90,87,323.79,30,25,43,54,25
Cork,189,92,97,4925.72,16,18,47,60,48
Cork,135,76,59,2702,15,23,60,22,15
Cork,124,56,68,5307.76,22,10,41,36,15
Cork,396,159,237,645.64,77,21,77,43,178
Cork,194,104,90,2540.66,29,27,79,45,14
Cork,252,114,138,1341.35,77,37,65,51,22
Cork,292,141,151,447.62,65,22,98,48,59
Cork,236,119,117,32.23,49,30,51,74,32
Cork,156,86,70,6.72,28,13,42,51,22
Cork,275,147,128,68.64,59,39,82,61,34
Cork,216,113,103,18.71,47,28,54,58,29
Cork,221,113,108,6.24,47,15,65,49,45
Cork,152,77,75,25.1,24,10,45,48,25
Cork,164,93,71,5.58,17,19,42,51,35
Cork,279,148,131,20.02,63,24,87,74,31
Cork,247,119,128,33.15,46,27,74,69,31
Cork,279,146,133,32.36,76,26,87,56,34
Cork,196,109,87,14.53,54,18,63,43,18
Cork,197,107,90,25.46,32,32,37,67,29
Cork,290,146,144,29.97,81,29,88,61,31
Cork,225,121,104,45.52,55,22,58,59,31
Cork,223,111,112,25.08,49,32,36,66,40
Cork,157,89,68,15.83,28,16,41,50,22
Cork,194,100,94,50.01,41,24,43,65,21
Cork,326,169,157,869.06,93,15,165,34,19
Cork,161,74,87,25.4,28,26,35,52,20
Cork,255,136,119,30.72,57,34,56,76,32
Cork,313,152,161,2032.01,90,13,164,30,16
Cork,275,140,135,2641.39,71,21,97,59,27
Cork,244,119,125,2241.56,68,16,109,32,19
Cork,269,131,138,4064.12,84,16,125,27,17
Cork,202,106,96,62.51,37,29,49,70,17
Cork,366,183,183,4177.22,146,25,119,63,13
Cork,312,156,156,417.95,92,29,114,51,26
Cork,160,76,84,1574.34,55,9,90,5,1
Cork,183,87,96,1064.15,25,19,58,52,29
Cork,224,113,111,6386.86,67,24,78,38,17
Cork,375,188,187,53.1,75,44,96,119,41
Cork,299,153,146,69.06,66,40,83,75,35
Cork,340,168,172,55.14,84,38,87,83,48
Cork,392,190,202,4840.46,155,28,152,45,12
Cork,139,71,68,830.28,21,16,37,40,25
Cork,223,102,121,5640.57,75,22,96,24,6
Cork,169,84,85,1308.75,59,15,84,11,0
Cork,232,112,120,5753.25,47,38,49,66,32
Cork,346,162,184,2491.52,100,47,78,91,30
Cork,249,123,126,6996.54,59,43,61,67,19
Cork,345,174,171,5208.02,84,30,116,69,46
Cork,312,157,155,1440.86,98,34,131,33,16
Cork,330,163,167,5447.25,104,22,177,26,1
Cork,153,77,76,48.36,32,7,74,27,13
Cork,197,91,106,34.66,47,24,46,51,29
Cork,349,166,183,2353.72,115,29,182,22,1
Cork,255,125,130,3465.99,65,19,142,24,5
Cork,200,107,93,305.77,48,23,84,38,7
Cork,296,151,145,6226.86,90,15,167,21,3
Cork,203,99,104,6241.54,70,18,105,9,1
Cork,178,82,96,1912.72,36,21,62,39,20
Cork,237,112,125,1953.37,85,16,110,21,5
Cork,227,114,113,4421.33,78,24,85,36,4
Cork,310,155,155,3492.37,107,25,132,37,9
Cork,286,139,147,2285.4,79,41,88,63,15
Cork,340,175,165,62.33,59,53,64,115,49
Cork,286,141,145,6227.14,101,51,77,45,12
Cork,206,104,102,2652.72,28,43,42,61,32
Cork,301,145,156,3827.37,75,44,88,83,11
Cork,229,123,106,5538.76,74,29,95,27,4
Cork,386,187,199,8158.61,87,88,81,118,12
Cork,262,121,141,1154.29,37,37,55,85,48
Cork,316,151,165,3798.35,68,46,83,82,37
Cork,240,119,121,2954.03,42,13,64,49,72
Cork,197,102,95,2969.55,28,17,43,64,45
Cork,163,83,80,4155.09,25,27,34,48,29
Cork,123,69,54,6824.99,19,8,50,32,14
Cork,245,118,127,1399.25,60,49,58,62,16
Cork,200,128,72,3800.69,14,21,98,49,18
Cork,221,118,103,3405.71,28,39,67,62,25
Cork,208,110,98,1785.12,26,19,53,73,37
Cork,200,98,102,3368.76,18,25,46,68,43
Cork,261,124,137,8754.28,45,36,69,93,18
Cork,256,124,132,4175.09,33,33,56,89,45
Cork,333,152,181,3903.14,80,44,81,77,51
Cork,198,97,101,5124.22,55,19,68,26,30
Cork,288,136,152,7082.26,99,24,140,25,0
Cork,316,149,167,1056.11,78,50,63,85,40
Cork,205,103,102,2425.66,32,20,54,57,42
Cork,318,148,170,955.52,94,44,78,75,27
Cork,145,75,70,4109.63,20,9,42,51,23
Cork,197,87,110,5714.95,26,19,45,42,65
Cork,190,109,81,5642.84,33,26,55,41,35
Cork,201,96,105,1871.89,63,30,61,31,16
Cork,124,57,67,6485.02,5,7,25,42,45
Cork,205,95,110,12.78,46,14,47,59,39
Cork,388,207,181,20.27,92,47,105,102,42
Cork,200,99,101,29.89,46,23,44,60,27
Cork,259,135,124,44.73,60,35,75,70,19
Cork,201,96,105,45.45,41,21,50,67,22
Cork,257,132,125,350.76,74,19,128,30,6
Cork,271,132,139,18.74,50,24,88,62,47
Cork,241,115,126,32.89,69,19,58,55,40
Cork,281,147,134,30.39,79,31,90,62,19
Cork,203,104,99,15.54,42,27,51,56,27
Cork,201,95,106,33.27,44,25,48,62,22
Cork,250,138,112,13.61,56,37,57,70,30
Cork,179,100,79,10.02,46,13,50,52,18
Cork,222,111,111,7.95,45,18,61,65,33
Cork,175,89,86,21.59,31,15,45,60,24
Cork,225,110,115,22.45,40,21,54,62,48
Cork,152,85,67,64.46,23,14,52,29,34
Cork,129,67,62,887.26,9,11,32,41,36
Cork,368,182,186,756.15,152,44,128,39,5
Cork,277,130,147,31.55,75,27,88,63,24
Cork,195,99,96,42.82,34,45,37,62,17
Cork,355,169,186,556.04,111,36,142,47,19
Cork,308,140,168,301.16,110,10,145,28,15
Cork,289,138,151,1714.33,93,22,115,41,18
Cork,150,68,82,970.53,43,11,32,41,23
Cork,255,122,133,269.35,58,21,55,85,36
Cork,157,79,78,92.17,42,4,53,43,15
Cork,217,106,111,1114.95,59,25,72,41,20
Cork,129,70,59,9.84,37,9,31,30,22
Cork,145,77,68,14.13,21,19,25,48,32
Cork,128,67,61,20.35,28,16,23,48,13
Cork,120,64,56,128.6,29,6,32,37,16
Cork,184,86,98,175.78,64,13,69,29,9
Cork,163,85,78,29.71,40,21,37,47,18
Cork,152,78,74,619.3,37,15,53,40,7
Cork,151,80,71,77.84,16,14,49,52,20
Cork,204,103,101,9.87,46,26,55,44,33
Cork,270,138,132,30.25,60,48,66,73,23
Cork,222,109,113,114.01,66,21,71,55,9
Cork,260,124,136,21.3,41,39,71,75,34
Cork,169,91,78,32.52,29,27,44,49,20
Cork,363,190,173,15.27,75,37,104,108,39
Cork,146,75,71,8.07,28,17,30,52,19
Cork,94,50,44,42.72,21,10,23,32,8
Cork,253,138,115,19.87,80,26,72,58,17
Cork,213,113,100,17.74,49,15,54,58,37
Cork,191,97,94,28.3,47,22,47,56,19
Cork,251,142,109,13.38,55,33,75,59,29
Cork,262,138,124,24.13,45,39,54,83,41
Cork,196,102,94,15.67,42,12,53,55,34
Cork,181,86,95,23.95,41,13,51,47,29
Cork,182,100,82,41.63,28,32,33,50,39
Cork,173,78,95,2072.7,41,30,61,33,8
Cork,265,121,144,961.6,60,39,72,53,41
Cork,217,107,110,3558.89,24,34,59,59,41
Cork,203,106,97,43.58,41,24,64,53,21
Cork,169,83,86,22.13,34,19,41,50,25
Cork,244,121,123,33.52,44,25,59,62,54
Cork,245,137,108,20.93,55,24,61,68,37
Cork,216,120,96,5.79,32,22,54,76,32
Cork,235,115,120,4263.43,56,35,54,60,30
Cork,210,108,102,7250.38,26,40,43,73,28
Cork,236,116,120,4776.94,26,45,57,81,27
Cork,302,151,151,4921.29,31,55,60,93,63
Cork,233,114,119,5456.29,35,56,55,83,4
Cork,323,155,168,3806.27,40,36,57,79,111
Cork,257,128,129,66.5,62,23,66,70,36
Cork,332,162,170,4069.08,144,34,85,68,1
Cork,227,106,121,4876.06,35,18,143,25,6
Cork,253,126,127,50.36,65,26,57,75,30
Cork,327,164,163,2275.37,100,61,66,89,11
Cork,379,192,187,7436.48,132,39,141,64,3
Cork,245,119,126,6756.57,78,22,92,49,4
Cork,229,99,130,6147.65,46,10,153,17,3
Cork,264,128,136,1146.64,54,59,33,107,11
Cork,228,107,121,3305.5,54,11,142,18,3
Cork,155,64,91,3220.98,32,7,105,11,0
Cork,285,139,146,97.24,49,35,54,89,58
Cork,296,167,129,404.3,48,29,120,61,38
Cork,287,138,149,4876.72,39,50,73,109,16
Cork,281,128,153,2193.87,41,38,79,91,32
Cork,158,70,88,4119.09,19,22,49,51,17
Cork,265,134,131,3166.07,55,38,114,51,7
Cork,273,123,150,4636.94,38,40,80,93,22
Cork,229,116,113,4808.2,37,37,49,88,18
Cork,240,110,130,6418.66,48,48,48,84,12
Cork,242,121,121,6965.23,39,45,74,77,7
Cork,280,139,141,5215.61,62,24,104,68,22
Cork,280,140,140,2882.35,105,23,94,48,10
Cork,268,131,137,6472.49,65,24,153,20,6
Cork,219,105,114,2047.3,66,11,126,14,2
Cork,325,143,182,5939.76,130,29,136,29,1
Cork,382,195,187,58.65,80,57,86,122,37
Cork,221,110,111,4472.87,50,44,67,55,5
Cork,214,107,107,7395.89,53,40,70,49,2
Cork,254,121,133,5474.61,36,28,53,71,66
Cork,241,117,124,6106.52,43,37,61,63,37
Cork,189,94,95,2648.32,16,19,49,55,50
Cork,330,155,175,6307.22,103,19,185,19,4
Cork,215,112,103,3878,61,20,91,41,2
Cork,240,109,131,1502.62,33,17,82,66,42
Cork,189,98,91,2502.05,45,13,105,19,7
Cork,280,125,155,2356.25,44,31,86,74,45
Cork,260,121,139,2653.87,27,33,36,91,73
Cork,221,109,112,44.87,45,27,67,50,32
Cork,315,158,157,4777.43,47,67,61,115,25
Cork,400,232,168,542.73,54,103,97,126,20
Cork,209,108,101,6989.27,41,41,69,49,9
Cork,204,103,101,5132.33,34,28,77,52,13
Cork,156,72,84,434.44,56,8,74,17,1
Cork,135,79,56,1069.93,8,2,111,8,6
Cork,95,47,48,8984.3,7,2,76,7,3
Cork,263,128,135,407.2,41,40,71,74,37
Cork,271,136,135,1696.37,52,59,36,94,30
Cork,362,166,196,4994.14,121,54,123,60,4
Cork,210,102,108,2791.59,65,14,104,23,4
Cork,278,142,136,2026.5,41,45,83,75,34
Cork,229,108,121,3675.59,46,42,57,60,24
Cork,343,167,176,4445.94,94,59,81,105,4
Cork,303,145,158,5096.63,64,54,78,89,18
Cork,113,52,61,4779.02,11,9,84,9,0
Cork,125,60,65,1058.3,21,7,87,9,1
Cork,121,52,69,4148.95,14,9,90,4,4
Cork,202,94,108,6058.97,52,4,138,6,2
Cork,245,120,125,6426.74,97,19,103,22,4
Cork,373,192,181,2944.12,134,36,114,76,13
Cork,243,127,116,4700.38,81,8,126,22,6
Cork,248,121,127,2572.96,49,45,68,66,20
Cork,161,83,78,1077.56,16,22,73,38,12
Cork,303,144,159,2836.26,127,32,86,49,9
Cork,220,101,119,1897.75,23,16,117,30,34
Cork,165,82,83,765.39,15,12,87,27,24
Cork,189,96,93,5415.63,61,10,104,14,0
Cork,232,108,124,1622.17,51,29,54,67,31
Cork,98,39,59,1041.47,17,5,67,4,5
Cork,329,154,175,5674.17,87,47,73,78,44
Cork,207,104,103,777.69,19,28,61,47,52
Cork,223,106,117,5264.9,53,35,76,55,4
Cork,276,136,140,2729.97,57,49,49,94,27
Cork,137,59,78,3530.38,12,4,115,4,2
Cork,220,99,121,6855.93,24,11,176,6,3
Cork,201,99,102,4141.77,35,42,37,76,11
Cork,139,71,68,2202.99,21,10,72,24,12
Cork,255,133,122,424.06,53,29,47,67,59
Cork,199,106,93,14.03,46,21,45,57,30
Cork,171,89,82,47.31,35,25,36,56,19
Cork,225,124,101,15.16,38,21,50,75,41
Cork,354,179,175,50.52,90,42,79,99,44
Cork,264,134,130,55.13,54,47,56,85,22
Cork,409,200,209,37.44,125,48,100,96,40
Cork,253,129,124,144.47,57,28,71,64,33
Cork,186,91,95,139.3,41,21,55,49,20
Cork,201,101,100,923.82,28,29,78,47,19
Cork,124,61,63,1412.96,15,7,35,31,36
Cork,230,123,107,93.64,51,23,68,60,28
Cork,111,59,52,324.32,8,13,38,22,30
Cork,341,160,181,21.14,72,41,115,83,30
Cork,202,107,95,519.66,54,17,94,22,15
Cork,225,112,113,1332.9,64,15,113,24,9
Cork,567,242,325,47.19,176,51,185,119,36
Cork,276,142,134,16.06,51,39,60,76,50
Cork,346,174,172,110.2,81,32,82,67,84
Cork,294,160,134,11.92,85,31,71,73,34
Cork,285,153,132,18.16,60,34,64,93,34
Cork,320,168,152,68.4,80,30,107,68,35
Cork,291,150,141,24.73,87,22,97,59,26
Cork,339,175,164,27.48,102,31,121,60,25
Cork,313,156,157,58.86,88,26,158,31,10
Cork,329,158,171,28.17,84,42,99,81,23
Cork,199,98,101,2148.82,59,19,74,32,15
Cork,224,119,105,37.29,67,23,56,61,17
Cork,141,68,73,507.91,34,4,76,12,15
Cork,262,134,128,75.95,50,21,59,51,81
Cork,227,94,133,74.72,28,13,45,42,99
Cork,193,97,96,4120.94,64,14,88,22,5
Cork,199,104,95,7.92,32,33,36,67,31
Cork,340,180,160,87.1,103,37,86,92,22
Cork,300,155,145,42.59,81,41,83,81,14
Cork,289,141,148,78.34,52,48,83,75,31
Cork,316,156,160,127.64,73,32,139,55,17
Cork,364,180,184,89.65,93,54,89,101,27
Cork,336,184,152,34.52,97,35,105,72,27
Cork,328,167,161,23.82,92,14,109,58,55
Cork,202,101,101,14.39,39,32,57,56,18
Cork,169,94,75,24.59,20,20,46,54,29
Cork,219,109,110,452.29,37,23,58,71,30
Cork,251,121,130,437.84,61,29,79,47,35
Cork,207,106,101,677.52,29,37,31,63,47
Cork,254,126,128,22.18,61,30,69,61,33
Cork,283,133,150,42.67,65,32,69,60,57
Cork,141,62,79,683.95,42,10,44,26,19
Cork,193,90,103,434.82,25,23,47,56,42
Cork,269,138,131,461.66,58,30,99,46,36
Cork,219,109,110,1798.31,52,28,57,50,32
Cork,150,78,72,24.65,32,13,30,50,25
Cork,141,76,65,13.08,35,12,34,41,19
Cork,210,104,106,15.35,43,24,32,77,34
Cork,147,66,81,477.79,30,24,37,30,26
Cork,151,73,78,927.63,39,21,36,38,17
Cork,239,115,124,34.25,42,15,52,56,74
Cork,219,112,107,20.64,52,28,56,55,28
Cork,299,151,148,45.74,85,43,69,84,18
Cork,219,112,107,23.28,44,25,54,71,25
Cork,261,121,140,5512.73,28,27,66,98,42
Cork,287,137,150,2810.42,93,21,84,65,24
Cork,311,159,152,118.33,80,31,123,57,20
Cork,298,143,155,1101.83,76,34,127,50,11
Cork,286,141,145,2987.16,103,33,101,44,5
Cork,382,198,184,7656.54,118,41,197,25,1
Cork,355,171,184,1526.82,82,59,77,92,45
Cork,351,173,178,671.76,85,41,138,54,33
Cork,167,87,80,2057.89,21,22,37,52,35
Cork,181,85,96,2779.53,18,18,35,56,54
Cork,301,144,157,2701.85,84,26,142,40,9
Cork,286,140,146,731.32,78,26,96,56,30
Cork,362,178,184,103.99,99,34,150,55,24
Cork,289,133,156,900.14,92,46,86,53,12
Cork,378,174,204,105.34,77,61,100,89,51
Cork,313,147,166,35.08,37,24,73,87,92
Cork,195,98,97,1067.18,20,27,52,45,51
Cork,187,90,97,4131.23,23,24,50,53,37
Cork,170,81,89,3141.4,33,13,59,38,27
Cork,129,66,63,5060.61,16,14,31,34,34
Cork,234,121,113,1580.86,23,28,77,57,49
Cork,257,128,129,2443.55,39,42,60,77,39
Cork,149,83,66,1867.68,22,18,55,21,33
Cork,194,92,102,1077.75,64,19,80,18,13
Cork,134,65,69,4366.24,17,16,84,7,10
Cork,78,38,40,1889.21,9,12,29,12,16
Cork,209,112,97,2244.51,34,26,58,58,33
Cork,314,161,153,26.56,80,53,102,54,25
Cork,352,174,178,41.58,85,44,117,72,34
Cork,204,110,94,19.61,44,24,64,39,33
Cork,153,84,69,14.06,24,14,37,47,31
Cork,290,163,127,7.37,64,34,71,84,37
Cork,163,85,78,51.27,27,22,44,45,25
Cork,231,106,125,33.46,55,18,73,48,37
Cork,228,114,114,42.78,55,28,63,66,16
Cork,211,105,106,18.83,42,31,50,56,32
Cork,195,101,94,18.27,52,22,51,48,22
Cork,209,116,93,26.89,53,22,53,57,24
Cork,223,117,106,24.52,44,33,64,60,22
Cork,229,116,113,855.42,36,16,78,69,30
Cork,182,83,99,120.7,46,12,98,17,9
Cork,186,95,91,175.82,52,23,48,52,11
Cork,284,126,158,58.84,70,19,77,70,48
Cork,130,64,66,50.09,33,15,30,28,24
Cork,306,150,156,21.96,94,35,72,75,30
Cork,134,68,66,22.91,24,13,25,47,25
Cork,200,119,81,11.24,43,22,63,54,18
Cork,199,108,91,16.57,41,24,66,49,19
Cork,347,186,161,16.87,90,38,114,69,36
Cork,289,148,141,1800.56,107,15,131,21,15
Cork,98,54,44,32.82,21,11,20,24,22
Cork,75,38,37,63.01,8,6,19,24,18
Cork,207,112,95,30.38,52,17,61,59,18
Cork,302,157,145,16.03,77,28,67,90,40
Cork,181,97,84,20.56,39,10,40,60,32
Cork,320,157,163,15.13,88,30,86,75,41
Cork,216,114,102,9.39,43,26,65,47,35
Cork,234,119,115,13.53,56,15,72,58,33
Cork,275,138,137,27.94,70,22,90,64,29
Cork,239,122,117,24.34,63,30,67,55,24
Cork,229,115,114,22.82,53,25,84,53,14
Cork,330,180,150,23.63,78,31,112,79,30
Cork,273,146,127,28.79,72,27,90,53,31
Cork,250,134,116,38.14,67,29,70,67,17
Cork,322,157,165,57.94,86,56,87,79,14
Cork,283,136,147,21.6,64,29,84,73,33
Cork,233,119,114,38.96,47,28,57,72,29
Cork,242,118,124,2799.89,55,28,94,36,29
Cork,264,137,127,2333.89,26,31,49,96,62
Cork,258,123,135,271.6,67,21,103,48,19
Cork,224,117,107,33.42,54,31,71,43,25
Cork,247,123,124,30.76,65,20,88,53,21
Cork,265,133,132,47.49,63,41,60,80,21
Cork,264,134,130,15.39,60,38,74,64,28
Cork,356,173,183,37.18,64,36,123,97,36
Cork,272,131,141,2908.78,81,16,137,27,11
Cork,311,156,155,58.36,74,24,93,78,42
Cork,316,160,156,22.13,68,45,82,91,30
Cork,139,65,74,4627.78,34,9,79,10,7
Cork,349,163,186,1039.42,127,26,149,38,9
Cork,176,86,90,2770.82,32,17,89,24,14
Cork,275,129,146,4666.4,75,13,152,20,15
Cork,146,79,67,3388.57,33,16,45,38,14
Cork,311,153,158,12.99,62,37,85,87,40
Cork,255,126,129,19.15,62,37,60,76,20
Cork,212,107,105,23.78,57,15,62,54,24
Cork,215,104,111,28.25,46,31,55,60,23
Cork,138,76,62,9.76,28,11,39,46,14
Cork,185,91,94,48.34,34,20,45,50,36
Cork,263,147,116,36.13,51,40,59,77,36
Cork,306,140,166,293.69,66,38,132,57,13
Cork,266,143,123,51.5,73,30,70,65,28
Cork,210,107,103,48.29,51,22,58,47,32
Cork,232,110,122,1274.83,47,36,46,74,29
Cork,251,124,127,175.17,87,25,72,50,17
Cork,82,43,39,623.26,17,5,49,8,3
Cork,178,81,97,416.27,38,31,42,42,25
Cork,180,97,83,110.83,14,34,27,62,43
Cork,262,114,148,6691.01,55,43,90,64,10
Cork,380,193,187,6410.15,77,79,79,115,30
Cork,330,153,177,4048.04,75,53,99,93,10
Cork,299,145,154,3398.31,67,38,143,45,6
Cork,228,123,105,55.87,38,45,48,74,23
Cork,456,228,228,300.32,154,54,106,109,33
Cork,307,150,157,56.27,65,42,74,97,29
Cork,187,84,103,856.62,56,21,65,40,5
Cork,200,98,102,5164.62,26,12,153,8,1
Cork,254,132,122,5117.98,52,33,148,16,5
Cork,284,143,141,379.99,48,45,115,57,19
Cork,182,76,106,6417.49,35,22,81,37,7
Cork,227,124,103,7228.84,51,33,91,48,4
Cork,252,116,136,3551.5,34,34,146,29,9
Cork,227,120,107,5344.7,40,36,83,62,6
Cork,273,109,164,2138.61,40,40,156,31,6
Cork,250,112,138,1102.16,29,34,173,13,1
Cork,366,187,179,114.8,52,60,75,106,73
Cork,174,83,91,5073.18,24,43,73,30,4
Cork,204,92,112,5083.23,27,30,87,49,11
Cork,280,143,137,17.95,47,36,57,98,42
Cork,159,75,84,130.63,27,9,42,54,27
Cork,220,109,111,274.65,39,26,56,63,36
Cork,324,159,165,448.55,57,24,65,75,103
Cork,213,102,111,2369.01,49,40,61,53,10
Cork,262,128,134,135.16,57,27,74,59,45
Cork,187,87,100,364.34,25,24,52,46,40
Cork,141,69,72,4846.36,46,13,73,8,1
Cork,100,50,50,3422.43,32,3,55,9,1
Cork,165,88,77,13.83,38,19,44,37,27
Cork,176,83,93,22.02,45,16,45,47,23
Cork,194,98,96,8.48,42,23,60,40,29
Cork,349,169,180,46.89,89,36,103,72,49
Cork,191,98,93,6.79,43,23,52,56,17
Cork,237,130,107,14.45,51,33,72,49,32
Cork,223,116,107,32.14,75,23,75,37,13
Cork,278,144,134,52.08,58,57,49,97,17
Cork,290,147,143,29.11,56,37,92,77,28
Cork,363,183,180,80.51,99,53,98,87,26
Cork,340,172,168,2197.18,134,31,127,43,5
Cork,349,171,178,19.16,88,50,98,82,31
Cork,308,157,151,30.92,88,52,72,70,26
Cork,287,135,152,73.04,71,36,77,67,36
Cork,248,120,128,27.65,61,29,67,55,36
Cork,294,143,151,38.45,70,33,82,81,28
Cork,232,117,115,190.25,34,22,50,66,60
Cork,192,86,106,263.03,40,22,77,36,17
Cork,266,152,114,36.65,62,37,78,55,34
Cork,231,116,115,29.29,56,27,66,57,25
Cork,179,85,94,5276.34,49,12,106,9,3
Cork,213,107,106,144.35,46,16,70,49,32
Cork,144,67,77,3140.81,48,12,70,14,0
Cork,106,44,62,4.88,20,11,19,35,21
Cork,154,82,72,10.84,26,18,39,46,25
Cork,101,58,43,6.02,12,9,17,48,15
Cork,156,74,82,158.81,24,11,37,56,28
Cork,89,45,44,15.11,17,10,13,27,22
Cork,161,92,69,17.74,37,21,31,43,29
Cork,195,100,95,7.32,58,17,42,41,37
Cork,143,73,70,21.53,29,9,37,41,27
Cork,110,57,53,43.97,20,12,22,27,29
Cork,204,109,95,13.71,48,16,45,55,40
Cork,377,199,178,14.94,74,44,100,80,79
Cork,313,161,152,14.6,61,27,81,91,53
Cork,174,87,87,8.38,53,14,56,33,18
Cork,253,138,115,15.84,49,41,70,67,26
Cork,274,136,138,20.44,70,49,72,58,25
Cork,265,139,126,51.94,67,32,70,65,31
Cork,244,135,109,10.33,57,20,68,65,34
Cork,304,152,152,21.75,76,43,87,79,19
Cork,285,149,136,10.09,60,37,94,62,32
Cork,224,109,115,38.62,49,13,67,58,37
Cork,229,108,121,515.05,44,28,99,33,25
Cork,179,86,93,15.25,35,28,44,61,11
Cork,159,78,81,35.97,21,34,23,56,25
Cork,135,77,58,14.17,33,18,38,33,13
Cork,276,154,122,31.95,58,31,81,67,39
Cork,238,115,123,36.89,45,19,68,61,45
Cork,117,65,52,7.82,20,16,19,39,23
Cork,160,84,76,9.95,29,21,28,62,20
Cork,187,92,95,96.23,32,16,55,49,35
Cork,160,71,89,26.84,41,20,33,48,18
Cork,154,78,76,73.39,34,16,43,37,24
Cork,151,74,77,126.93,28,18,33,56,16
Cork,101,57,44,571.65,19,5,37,27,13
Cork,109,49,60,1415.97,19,14,29,31,16
Cork,137,69,68,275.96,26,16,41,38,16
Cork,193,92,101,17.81,55,14,55,48,21
Cork,188,101,87,16.06,32,18,49,64,25
Cork,220,107,113,620.83,73,26,87,31,3
Cork,198,98,100,27.65,48,20,55,45,30
Cork,367,181,186,79.41,112,37,117,67,34
Cork,300,147,153,26.52,75,26,114,54,31
Cork,245,119,126,1727.47,38,22,89,54,42
Cork,281,137,144,22.97,84,27,102,50,18
Cork,324,166,158,33.93,70,39,82,88,45
Cork,205,104,101,21.56,47,25,44,48,41
Cork,163,84,79,21.07,37,21,34,45,26
Cork,251,131,120,24.79,64,28,67,69,23
Cork,174,81,93,39.69,47,8,66,23,30
Cork,219,117,102,49.49,55,36,49,56,23
Cork,264,133,131,99.1,57,25,74,69,39
Cork,218,105,113,18.93,52,26,61,52,27
Cork,262,137,125,26.82,57,40,79,65,21
Cork,322,173,149,23.59,86,44,79,83,30
Cork,205,104,101,17.42,59,22,43,51,30
Cork,345,177,168,16.35,81,30,84,88,62
Cork,366,182,184,39.05,91,21,101,69,84
Cork,250,131,119,2432.85,95,14,108,27,6
Cork,203,89,114,5280.41,80,10,98,12,3
Cork,416,205,211,55.1,116,40,161,80,19
Cork,315,165,150,22.39,78,37,85,77,38
Cork,284,144,140,31.97,55,35,78,75,41
Cork,281,145,136,39.66,49,43,90,69,30
Cork,199,94,105,11.61,26,19,54,72,28
Cork,219,116,103,28.37,47,23,71,54,24
Cork,199,101,98,21.09,52,23,51,44,29
Cork,234,126,108,22.53,46,46,54,64,24
Cork,255,126,129,34.74,57,44,62,73,19
Cork,224,106,118,41.12,52,30,80,44,18
Cork,301,148,153,29.23,67,39,71,79,45
Cork,230,119,111,21.43,61,22,68,57,22
Cork,259,134,125,10.46,61,29,77,47,45
Cork,285,150,135,15.54,84,22,84,54,41
Cork,286,141,145,26.6,75,29,73,68,41
Cork,246,140,106,66.22,74,12,87,50,23
Cork,290,146,144,92.28,64,43,69,75,39
Cork,245,127,118,4223.12,79,24,99,36,7
Cork,184,85,99,287.31,31,33,50,34,36
Cork,177,89,88,214.81,48,16,80,27,6
Cork,169,91,78,3081.36,46,10,81,24,8
Cork,245,120,125,11.51,59,24,73,65,24
Cork,235,121,114,29.97,50,27,56,74,28
Cork,249,122,127,26.39,53,23,80,62,31
Cork,254,138,116,22.92,56,23,74,61,40
Cork,207,110,97,18.68,40,27,49,56,35
Cork,209,108,101,17.27,45,17,63,55,29
Cork,299,156,143,43.35,91,35,93,56,24
Cork,203,111,92,27.03,39,19,57,57,31
Cork,266,137,129,30.17,81,21,72,71,21
Cork,191,95,96,55.59,27,18,49,60,37
Cork,198,112,86,37.66,49,24,60,45,20
Cork,221,108,113,1306.83,47,19,61,56,38
Cork,155,72,83,1390.07,17,5,49,45,39
Cork,213,105,108,262.84,77,17,50,53,16
Cork,214,90,124,56.74,39,36,51,61,27
Cork,277,126,151,62.23,40,22,84,78,53
Cork,374,175,199,92.72,72,42,106,94,60
Cork,331,157,174,150.48,93,54,84,75,25
Cork,177,82,95,2073.67,32,24,43,52,26
Cork,371,156,215,2177.45,74,27,139,52,79
Cork,277,140,137,3085.18,89,24,132,27,5
Cork,213,103,110,4338.09,60,14,103,30,6
Cork,265,127,138,4710.02,55,17,138,41,14
Cork,248,131,117,476.44,79,24,63,56,26
Cork,246,116,130,1386.49,39,16,74,64,53
Cork,189,101,88,4593.29,11,19,72,50,37
Cork,162,84,78,6172.6,28,19,47,45,23
Cork,158,74,84,1809.79,38,13,43,40,24
Cork,208,96,112,2991.51,31,23,73,52,29
Cork,243,108,135,1000.68,55,28,65,71,24
Cork,167,70,97,1633.72,25,9,60,41,32
Cork,154,72,82,2506.71,21,10,62,42,19
Cork,186,81,105,4261.07,23,25,71,34,33
Cork,220,103,117,1155.59,30,32,74,49,35
Cork,88,41,47,2336.51,10,11,44,18,5
Cork,177,87,90,6188.81,17,12,51,54,43
Cork,253,137,116,19.63,78,22,80,46,27
Cork,205,97,108,54.83,51,18,71,48,17
Cork,207,104,103,311.5,59,19,88,30,11
Cork,303,153,150,4983.47,110,23,144,22,4
Cork,152,81,71,6.67,16,18,44,42,32
Cork,165,82,83,8.83,29,22,39,52,23
Cork,427,219,208,28.84,112,60,115,100,40
Cork,211,112,99,25.14,61,18,49,62,21
Cork,249,129,120,19.54,61,32,58,69,29
Cork,228,105,123,126.08,36,14,55,43,80
Cork,251,132,119,20.98,54,23,79,69,26
Cork,207,103,104,2587.5,66,15,78,36,12
Cork,166,85,81,16.75,24,16,48,47,31
Cork,214,116,98,16.69,37,19,56,72,30
Cork,221,107,114,63.59,32,33,55,59,42
Cork,266,135,131,5903.9,92,15,142,14,3
Cork,230,108,122,62.35,65,15,97,41,12
Cork,328,167,161,291.93,111,22,144,37,14
Cork,272,138,134,24.13,78,23,97,57,17
Cork,262,131,131,31.45,49,43,62,89,19
Cork,318,150,168,38.41,93,32,111,63,19
Cork,372,189,183,31.43,80,44,103,101,44
Cork,345,171,174,26.88,84,33,102,89,37
Cork,219,111,108,24.05,43,36,53,63,24
Cork,201,91,110,21.21,37,26,53,53,32
Cork,125,63,62,87.31,18,12,33,41,21
Cork,172,84,88,23.95,32,13,53,44,30
Cork,257,128,129,18.03,56,20,77,64,40
Cork,162,81,81,46.42,38,20,47,36,21
Cork,303,161,142,44.19,77,35,92,78,21
Cork,215,95,120,8906.75,35,43,55,75,7
Cork,231,101,130,5563.72,36,38,40,77,40
Cork,267,147,120,3601.88,33,48,49,75,62
Cork,197,102,95,4349.65,19,26,28,53,71
Cork,380,182,198,3667.88,123,28,153,66,10
Cork,304,140,164,6406.61,45,50,74,110,25
Cork,221,113,108,2191.55,33,23,55,77,33
Cork,215,92,123,6394.43,39,30,62,65,19
Cork,261,123,138,3515.1,76,20,153,12,0
Cork,373,181,192,3229.97,114,63,101,90,5
Cork,256,129,127,2476.16,77,26,104,47,2
Cork,318,160,158,4611.9,86,39,118,68,7
Cork,302,144,158,6365.13,71,62,81,81,7
Cork,390,183,207,4802.72,136,36,157,55,6
Cork,264,129,135,3614.26,26,41,44,102,51
Cork,237,119,118,818.73,60,23,114,31,9
Cork,173,77,96,347.45,37,10,109,13,4
Cork,310,149,161,4477.96,87,30,158,31,4
Cork,259,137,122,5688.18,80,33,100,43,3
Cork,381,173,208,5497.44,120,29,189,40,3
Cork,208,93,115,849,55,23,93,37,0
Cork,354,190,164,67.36,64,30,108,107,45
Cork,368,168,200,4377.67,125,54,123,65,1
Cork,261,128,133,257.1,54,42,90,66,9
Cork,369,178,191,1247.35,97,52,134,71,15
Cork,422,196,226,184.91,103,60,176,67,16
Cork,262,135,127,345.61,41,42,73,82,24
Cork,262,139,123,338.32,74,18,140,26,4
Cork,415,210,205,3709.6,96,67,99,127,26
Cork,184,92,92,4358.95,16,24,39,66,39
Cork,301,154,147,1808.46,79,39,109,64,10
Cork,251,114,137,5993.89,43,36,75,89,8
Cork,319,169,150,6435.34,90,32,125,60,12
Cork,368,163,205,4288.09,87,29,230,22,0
Cork,388,188,200,56.1,123,39,141,61,24
Cork,355,191,164,26.76,102,30,108,76,39
Cork,353,170,183,20.53,97,36,98,89,33
Cork,261,128,133,69.76,44,32,72,64,49
Cork,313,159,154,20.49,64,43,76,90,40
Cork,235,124,111,28.14,53,41,47,72,22
Cork,248,115,133,39.51,54,24,71,74,25
Cork,300,156,144,2844.65,72,47,84,83,14
Cork,285,128,157,2483.4,53,41,82,83,26
Cork,311,153,158,5410.01,64,49,85,89,24
Cork,269,117,152,3749.55,33,56,43,103,34
Cork,315,130,185,7277.35,121,53,88,44,9
Cork,417,188,229,5222.29,177,13,187,37,3
Cork,228,125,103,3821.14,65,21,88,41,13
Cork,285,127,158,4087.25,65,35,88,64,33
Cork,214,101,113,1221.29,51,20,128,15,0
Cork,283,145,138,4617.54,97,7,166,13,0
Cork,291,154,137,6002.6,120,16,120,31,4
Cork,232,120,112,51.43,43,41,47,79,22
Cork,472,240,232,1179.6,180,58,142,82,10
Cork,253,121,132,23.41,72,23,87,58,13
Cork,438,196,242,33.97,104,31,143,75,85
Cork,258,124,134,51,55,32,85,63,23
Cork,120,65,55,23.24,18,19,20,42,21
Cork,214,109,105,19.36,34,27,64,56,33
Cork,305,135,170,59.28,56,36,63,81,69
Cork,306,162,144,21.16,73,41,75,86,31
Cork,210,99,111,1793.11,27,27,57,50,49
Cork,167,86,81,2097.91,29,24,43,52,19
Cork,194,99,95,3437.28,33,18,72,40,31
Cork,123,59,64,1187.57,14,15,43,33,18
Cork,250,114,136,102.67,46,41,54,84,25
Cork,310,156,154,505.28,99,28,96,65,22
Cork,282,144,138,2340.56,76,25,132,33,16
Cork,255,117,138,903.28,42,17,58,57,81
Cork,113,55,58,126.25,17,12,56,14,14
Cork,206,85,121,981.43,17,15,38,43,93
Cork,260,133,127,58.33,55,30,80,52,43
Cork,223,109,114,239.26,64,18,120,15,6
Cork,324,157,167,1783.74,118,25,119,52,10
Cork,189,90,99,2367.03,55,17,64,45,8
Cork,151,65,86,2473.87,38,6,85,16,6
Cork,220,108,112,1981.59,70,19,81,40,10
Cork,247,123,124,75.02,58,41,62,59,27
Cork,168,88,80,45.36,26,16,42,47,37
Cork,252,122,130,100.73,61,32,64,72,23
Cork,237,110,127,37.94,57,23,83,45,29
Cork,161,80,81,28.11,30,9,53,44,25
Cork,308,155,153,40.54,62,34,71,98,43
Cork,380,196,184,42.67,73,30,102,98,77
Cork,299,162,137,36.24,48,47,68,97,39
Cork,532,241,291,475.71,163,66,145,103,55
Cork,179,87,92,820.1,34,9,99,24,13
Cork,302,152,150,4216.17,102,23,152,21,4
Cork,311,154,157,364.77,103,32,136,28,12
Cork,141,59,82,1175.76,14,14,61,29,23
Cork,307,139,168,839.43,116,38,114,35,4
Cork,322,150,172,86.42,54,36,77,101,54
Cork,156,80,76,3817.17,28,18,41,45,24
Cork,228,111,117,154.15,45,14,124,33,12
Cork,294,138,156,4060.89,90,26,133,38,7
Cork,267,139,128,4240.25,83,18,133,23,10
Cork,277,143,134,975.09,55,38,61,81,42
Cork,359,180,179,2532.86,70,44,97,124,24
Cork,208,91,117,2024.39,34,20,52,46,56
Cork,92,53,39,130.54,4,9,31,25,23
Cork,398,192,206,451.16,122,54,103,101,18
Cork,271,142,129,5895.79,44,29,61,94,43
Cork,245,109,136,2693.58,31,34,54,82,44
Cork,239,120,119,2535.35,25,33,55,72,54
Cork,146,63,83,4117.08,25,23,47,37,14
Cork,153,75,78,1720.3,18,12,31,51,41
Cork,239,112,127,2284.28,28,15,59,69,68
Cork,156,73,83,5101.54,10,12,41,50,43
Cork,310,165,145,20.23,78,46,81,74,31
Cork,286,142,144,30.08,79,28,80,69,30
Cork,384,209,175,29.48,87,42,116,98,41
Cork,248,136,112,24.36,60,31,70,52,35
Cork,197,100,97,35.01,49,21,49,61,17
Cork,295,146,149,42.86,70,46,68,82,29
Cork,205,105,100,38.84,38,24,56,55,32
Cork,240,123,117,86.31,41,34,72,58,35
Cork,234,127,107,41.28,54,41,50,65,24
Cork,306,153,153,70.68,62,39,95,82,28
Cork,315,167,148,1478.01,74,44,83,90,24
Cork,197,99,98,382.27,31,26,24,63,53
Cork,381,204,177,3812.78,140,46,102,79,14
Cork,319,152,167,302.52,97,29,101,66,26
Cork,291,146,145,331.22,75,41,66,85,24
Cork,201,105,96,11.96,51,23,53,51,23
Cork,153,72,81,12.51,34,23,24,54,18
Cork,276,137,139,17.48,46,30,65,76,59
Cork,185,97,88,15.64,30,21,51,50,33
Cork,302,148,154,44.05,76,20,95,62,49
Cork,351,164,187,3686.74,59,46,91,101,54
Cork,432,211,221,43.74,75,67,111,132,47
Cork,267,124,143,2655.71,93,20,83,43,28
Cork,320,154,166,6869.75,112,21,160,24,3
Cork,330,164,166,337.59,85,37,98,87,23
Cork,253,118,135,1286.71,36,43,76,50,48
Cork,289,147,142,4782.95,60,51,90,70,18
Cork,145,69,76,390.49,16,10,83,23,13
Cork,270,135,135,6301.79,94,34,103,34,5
Cork,259,123,136,6790.41,89,21,125,21,3
Cork,311,146,165,1540.4,90,32,121,44,24
Cork,243,115,128,38.59,44,26,67,70,36
Cork,367,179,188,5580.39,106,28,197,31,5
Cork,323,156,167,205.16,48,41,68,98,68
Cork,374,173,201,4291.35,149,26,139,46,14
Cork,331,151,180,3036.67,51,36,91,103,50
Cork,413,206,207,2242.8,104,60,129,92,28
Cork,170,88,82,8456.45,40,15,110,4,1
Cork,413,193,220,7567.15,151,40,185,33,4
Cork,362,180,182,4491.37,100,39,179,40,4
Cork,283,127,156,6786.25,87,13,164,17,2
Cork,205,107,98,4128.49,66,16,115,8,0
Cork,354,171,183,4854.64,141,19,156,35,3
Cork,253,129,124,98.37,79,18,94,40,22
Cork,263,143,120,33.86,52,39,69,67,36
Cork,208,103,105,2591.77,90,22,88,8,0
Cork,225,117,108,623.02,79,11,116,14,5
Cork,138,68,70,2593.16,27,11,49,22,29
Cork,372,173,199,4808.31,102,77,106,69,18
Cork,202,97,105,4934.53,44,21,54,60,23
Cork,256,123,133,4364.8,26,26,68,71,65
Cork,118,63,55,766.24,9,9,47,28,25
Cork,189,91,98,671.45,22,28,41,46,52
Cork,194,96,98,6656.37,28,18,50,46,52
Cork,299,149,150,4957.47,98,21,136,36,8
Cork,279,140,139,2039.18,46,29,115,56,33
Cork,211,112,99,3766.24,24,19,99,42,27
Cork,141,68,73,2020.78,22,13,76,15,15
Cork,237,119,118,1711.1,47,31,74,67,18
Cork,250,118,132,3787.65,29,10,48,61,102
Cork,230,118,112,1980.93,42,46,71,49,22
Cork,289,134,155,3775.16,69,40,72,62,46
Cork,148,78,70,1318.47,12,17,53,39,27
Cork,180,90,90,1833.74,31,30,67,45,7
Cork,199,93,106,9.46,43,37,38,54,27
Cork,237,117,120,29.61,49,37,59,62,30
Cork,195,86,109,36.86,48,25,56,43,23
Cork,248,133,115,26.36,60,22,65,69,32
Cork,172,100,72,14.19,33,16,40,50,33
Cork,202,105,97,27.55,35,40,48,57,22
Cork,244,119,125,21.64,61,24,79,47,33
Cork,249,118,131,15.9,57,39,49,72,32
Cork,147,66,81,1832.73,16,12,27,43,49
Cork,158,80,78,3412.82,21,12,47,38,40
Cork,131,66,65,1510.37,11,10,27,43,40
Cork,143,62,81,1113.4,21,10,39,24,49
Cork,282,132,150,3125.1,65,36,65,83,33
Cork,290,145,145,3537.28,49,36,82,70,53
Cork,294,140,154,986.18,47,30,88,85,44
Cork,220,108,112,493.52,25,31,54,77,33
Cork,292,154,138,1804.67,83,26,107,53,23
Cork,263,131,132,2128.37,58,42,79,55,29
Cork,251,126,125,8694.15,62,18,135,26,10
Cork,220,114,106,92.89,43,36,48,50,43
Cork,207,99,108,2902.37,91,14,73,21,8
Cork,214,116,98,33.01,38,28,47,70,31
Cork,184,95,89,23.73,26,14,53,69,22
Cork,182,84,98,1033.01,36,19,43,63,21
Cork,243,124,119,991.57,54,27,99,37,26
Cork,300,150,150,24.26,51,40,79,91,39
Cork,165,75,90,50.73,45,15,38,42,25
Cork,380,180,200,1654.21,102,55,122,72,29
Cork,257,129,128,15.34,64,19,85,52,37
Cork,180,86,94,2858.1,55,11,97,15,2
Cork,155,74,81,156.79,33,28,45,36,13
Cork,214,107,107,8.01,49,23,75,44,23
Cork,206,101,105,31.96,55,19,62,41,29
Cork,158,79,79,626.19,32,24,50,33,19
Cork,183,89,94,78.13,46,19,48,44,26
Cork,232,114,118,83.46,46,41,44,83,18
Cork,257,125,132,265.84,67,19,147,20,4
Cork,294,150,144,94.08,61,36,72,83,42
Cork,224,120,104,343.76,60,28,63,59,14
Cork,258,136,122,14.74,57,27,87,60,27
Cork,198,105,93,15.74,47,19,58,44,30
Cork,206,105,101,37.95,52,24,57,50,23
Cork,222,122,100,115.42,39,39,52,62,30
Cork,237,119,118,21.71,55,27,75,55,25
Cork,255,109,146,35.92,53,17,102,46,37
Cork,281,135,146,59.28,81,24,84,69,23
Cork,199,95,104,4358.78,63,25,72,33,6
Cork,202,105,97,32.1,39,19,59,53,32
Cork,214,120,94,20.12,48,23,73,38,32
Cork,250,125,125,32.01,89,17,79,34,31
Cork,173,93,80,97.27,37,18,48,46,24
Cork,137,70,67,23.8,35,6,34,36,26
Cork,151,83,68,70.08,33,21,35,40,22
Cork,186,93,93,117.73,30,29,46,55,26
Cork,88,46,42,5,17,8,21,30,12
Cork,215,108,107,1842.99,32,24,51,62,46
Cork,280,143,137,43.2,46,28,67,87,52
Cork,274,124,150,214.95,48,38,60,74,54
Cork,345,160,185,31.25,53,35,69,102,86
Cork,87,42,45,1427.17,8,5,29,17,28
Cork,80,38,42,1454.68,8,8,20,20,24
Cork,388,190,198,38.87,109,39,126,68,46
Cork,289,155,134,103.57,55,43,77,89,25
Cork,264,138,126,20.72,53,33,65,76,37
Cork,281,155,126,31.25,78,23,89,58,33
Cork,310,155,155,46.6,74,52,71,89,24
Cork,195,101,94,59.75,35,23,42,60,35
Cork,222,113,109,355.1,48,31,39,90,14
Cork,205,107,98,38.5,31,32,45,68,29
Cork,330,163,167,2469.01,109,42,118,58,3
Cork,132,68,64,7149.05,10,10,96,12,4
Cork,208,98,110,245.68,40,11,110,27,20
Cork,263,126,137,6267.72,77,11,152,20,3
Cork,225,106,119,4374.79,64,16,130,15,0
Cork,230,102,128,338.94,35,33,59,60,43
Cork,297,153,144,3880.32,78,35,92,72,20
Cork,249,129,120,6163.06,82,24,113,27,3
Cork,315,152,163,6450.69,110,37,124,42,2
Cork,222,114,108,9419.95,51,26,55,74,16
Cork,319,141,178,1835.83,92,40,103,65,19
Cork,270,140,130,1515.64,72,28,105,49,16
Cork,136,78,58,951.34,17,11,48,37,23
Cork,309,151,158,355.98,41,38,63,93,74
Cork,202,92,110,1161.39,35,24,73,54,16
Cork,152,69,83,870.29,16,10,37,43,46
Cork,336,157,179,2270.19,82,51,96,84,23
Cork,360,172,188,2521.63,112,49,119,65,15
Cork,194,94,100,10253.16,51,18,106,17,2
Cork,274,139,135,4127.62,95,12,137,25,5
Cork,240,117,123,652.52,36,33,50,79,42
Cork,199,97,102,2280.78,26,27,49,65,32
Cork,217,110,107,796.53,62,27,35,68,25
Cork,230,115,115,294.08,28,44,46,82,30
Cork,171,99,72,938.36,20,21,77,37,16
Cork,200,85,115,1191.84,49,26,55,48,22
Cork,287,166,121,8.85,76,23,91,51,46
Cork,263,137,126,18.1,62,33,80,59,29
Cork,286,158,128,23.49,78,28,93,57,30
Cork,235,117,118,16.28,59,26,67,62,21
Cork,395,204,191,32.27,93,41,103,114,44
Cork,117,60,57,29.65,20,14,32,39,12
Cork,216,106,110,33.6,43,22,60,60,31
Cork,275,129,146,31.26,88,31,78,52,26
Cork,256,119,137,27.99,74,24,70,52,36
Cork,171,85,86,36.5,27,19,40,49,36
Cork,189,99,90,19.32,38,26,47,41,37
Cork,353,167,186,43.59,98,43,107,65,40
Cork,286,134,152,5867.15,67,24,178,16,1
Cork,416,218,198,217.6,77,55,148,89,47
Cork,176,86,90,3518.94,54,7,98,15,2
Cork,281,136,145,3653.38,101,33,98,44,5
Cork,377,177,200,2007.07,131,37,172,33,4
Cork,339,182,157,194.68,93,49,92,94,11
Cork,202,105,97,1302.77,40,17,100,34,11
Cork,281,140,141,2247.82,49,50,72,77,33
Cork,373,189,184,89.83,92,59,82,111,29
Cork,385,196,189,48.29,75,50,109,95,56
Cork,478,228,250,106.19,73,76,102,128,99
Cork,216,103,113,1475.03,63,12,131,10,0
Cork,267,131,136,100.79,76,23,109,41,18
Cork,341,177,164,131.78,76,43,73,116,33
Cork,214,101,113,770.03,26,28,47,69,44
Cork,294,150,144,135.3,54,40,77,79,44
Cork,195,91,104,3857.72,41,22,104,25,3
Cork,283,138,145,1389.42,93,34,121,34,1
Cork,302,131,171,3203.05,52,47,80,98,25
Cork,332,153,179,509.06,133,35,123,29,12
Cork,401,199,202,5305.64,120,63,122,77,19
Cork,320,163,157,2544.27,44,44,74,92,66
Cork,231,114,117,3158.59,33,37,50,77,34
Cork,225,114,111,341.35,30,27,49,79,40
Cork,347,167,180,1265.24,115,16,164,36,16
Cork,162,69,93,658.07,19,19,43,50,31
Cork,285,135,150,3108.27,50,49,75,86,25
Cork,172,82,90,2302.88,37,11,88,19,17
Cork,330,181,149,76.04,102,27,131,42,28
Cork,344,167,177,17.75,97,40,92,92,23
Cork,270,138,132,4725.24,83,19,142,19,7
Cork,186,82,104,4797.52,59,9,105,13,0
Cork,205,107,98,1247.85,51,25,62,50,17
Cork,162,81,81,271.57,37,23,73,23,6
Cork,204,108,96,246.11,50,9,122,19,4
Cork,167,82,85,3762.36,59,1,100,5,2
Cork,239,125,114,72.55,44,34,92,48,21
Cork,244,130,114,27.27,54,34,72,63,21
Cork,374,192,182,78.2,59,43,80,94,98
Cork,321,162,159,2797.29,75,59,68,92,27
Cork,263,130,133,4946.4,70,46,75,65,7
Cork,208,96,112,5325.41,62,20,89,30,7
Cork,328,175,153,4833.77,130,35,105,53,5
Cork,249,121,128,2911.16,45,50,65,82,7
Cork,193,84,109,5494.51,32,42,51,51,17
Cork,383,192,191,4962.36,133,40,174,34,2
Cork,267,126,141,4231.78,36,29,66,90,46
Cork,208,99,109,2024.25,70,20,87,23,8
Cork,251,124,127,2140.72,74,22,103,44,8
Cork,220,113,107,4179.33,68,17,107,25,3
Cork,482,246,236,36.77,105,81,128,123,45
Cork,304,154,150,5282.27,102,17,168,16,1
Cork,270,138,132,281.66,90,19,97,43,21
Cork,252,129,123,33.02,57,32,73,63,27
Cork,227,113,114,19.95,58,32,57,49,31
Cork,198,102,96,24.73,28,29,47,60,34
Cork,166,81,85,22.45,29,27,47,50,13
Cork,117,55,62,31.62,18,12,26,33,28
Cork,238,117,121,88.89,59,28,53,67,31
Cork,144,74,70,1632.56,24,20,39,43,18
Cork,133,59,74,912.61,15,24,20,47,27
Cork,316,155,161,23.33,81,33,86,79,37
Cork,316,154,162,1000.01,109,17,151,33,6
Cork,300,138,162,215.51,76,19,93,74,38
Cork,269,137,132,29.03,72,24,83,57,33
Cork,256,130,126,42.37,48,29,50,79,50
Cork,160,83,77,5.53,27,11,48,51,23
Cork,165,88,77,11.94,40,18,46,46,15
Cork,181,92,89,19.07,49,15,43,50,24
Cork,135,69,66,13.1,20,7,29,51,28
Cork,252,136,116,21.65,57,33,63,72,27
Cork,196,96,100,53.26,46,19,56,51,24
Cork,175,96,79,26.25,31,29,45,52,18
Cork,93,46,47,10.06,9,7,10,40,27
Cork,102,54,48,6.5,16,9,18,36,23
Cork,181,93,88,16.13,45,20,55,43,18
Cork,184,89,95,22.69,57,12,54,41,20
Cork,194,102,92,16.73,25,27,42,68,32
Cork,185,101,84,20.78,47,18,51,38,31
Cork,143,81,62,6.06,26,11,39,43,24
Cork,162,86,76,30.56,41,10,39,39,33
Cork,257,127,130,98.54,49,13,56,55,84
Cork,180,99,81,33.75,32,22,31,60,35
Cork,151,80,71,18.27,32,16,37,38,28
Cork,228,104,124,43.53,49,18,36,46,79
Cork,274,128,146,40.2,60,36,67,68,43
Cork,199,94,105,274.19,42,11,90,26,30
Cork,281,131,150,2663.51,66,40,84,62,29
Cork,219,111,108,2575.23,44,23,74,55,23
Cork,139,57,82,2428.46,13,10,48,40,28
Cork,161,67,94,361.39,21,19,48,36,37
Cork,190,96,94,199.99,42,23,43,44,38
Cork,268,119,149,458.21,71,31,65,61,40
Cork,252,116,136,1051.12,71,30,112,30,9
Cork,263,131,132,3262.02,62,34,81,58,28
Cork,229,101,128,2431.18,49,17,87,44,32
Cork,131,64,67,2749.5,7,8,41,28,47
Cork,122,62,60,170.08,11,8,26,41,36
Cork,114,59,55,3706.47,5,14,52,26,17
Cork,138,66,72,44.47,30,15,32,39,22
Cork,116,51,65,1202,17,14,34,37,14
Cork,159,73,86,52.45,51,15,47,32,14
Cork,138,64,74,218.03,21,11,31,40,35
Cork,93,36,57,1025.14,11,7,20,25,30
Cork,349,183,166,17.45,72,37,105,92,43
Cork,245,131,114,9.13,59,17,70,68,31
Cork,239,117,122,428.1,43,28,81,50,37
Cork,271,135,136,35.44,67,35,71,60,38
Cork,335,161,174,25.48,61,41,81,101,51
Cork,265,131,134,433.59,88,19,132,25,1
Cork,399,191,208,149.36,84,55,103,94,63
Cork,183,90,93,79.38,27,26,44,56,30
Cork,364,148,216,168.42,60,43,59,90,112
Cork,407,203,204,98.29,67,56,104,135,45
Cork,231,117,114,7357.16,48,47,73,56,7
Cork,214,101,113,6988.67,47,37,71,50,9
Cork,397,187,210,746.68,120,61,123,83,10
Cork,356,184,172,93.47,92,39,109,77,39
Cork,319,136,183,5747.13,145,50,92,31,1
Cork,372,199,173,271.17,80,69,68,121,34
Cork,261,134,127,593.27,75,33,88,49,16
Cork,328,147,181,6249.29,115,29,131,45,8
Cork,436,216,220,3127.91,138,60,158,74,6
Cork,394,199,195,749.21,195,50,105,32,12
Cork,232,105,127,987.37,71,36,78,34,13
Cork,123,59,64,6.71,16,12,37,32,26
Cork,335,161,174,29.49,59,47,90,80,59
Cork,238,122,116,34.08,45,35,60,71,27
Cork,146,73,73,612.13,28,6,53,29,30
Cork,189,94,95,268.34,25,32,45,52,35
Cork,254,135,119,18.07,53,30,68,71,32
Cork,325,179,146,23.08,100,33,91,71,30
Cork,263,149,114,13.41,73,23,89,47,31
Cork,311,150,161,30.42,56,29,81,60,85
Cork,338,161,177,58.74,79,44,77,103,35
Cork,135,63,72,85.13,23,22,18,56,16
Cork,167,86,81,247.7,33,14,31,48,41
Cork,80,43,37,570.37,17,5,23,20,15
Cork,83,46,37,538.02,17,6,17,27,16
Cork,210,107,103,278.2,41,17,47,75,30
Cork,144,63,81,4740.74,48,14,71,10,1
Cork,252,128,124,1816.18,35,33,59,85,40
Cork,253,113,140,227.95,66,27,65,64,31
Cork,108,49,59,180.39,10,8,29,45,16
Cork,162,83,79,3441.02,29,12,44,49,28
Cork,162,73,89,1370.99,29,14,36,42,41
Cork,404,206,198,781.48,97,62,114,97,34
Cork,238,113,125,1075.11,44,19,60,74,41
Cork,190,99,91,209.3,38,10,68,47,27
Cork,168,82,86,2001.05,47,26,38,43,14
Cork,194,90,104,6302.38,56,13,74,36,15
Cork,203,86,117,5219.45,72,8,85,28,10
Cork,236,125,111,22.07,65,17,81,35,38
Cork,265,137,128,26.47,80,23,78,64,20
Cork,235,132,103,23.75,49,37,59,56,34
Cork,344,178,166,18.78,74,39,97,87,47
Cork,238,121,117,43.63,63,27,69,59,20
Cork,216,110,106,39.43,34,34,54,69,25
Cork,241,129,112,25.13,59,28,65,60,29
Cork,295,171,124,16.58,48,26,87,88,46
Cork,296,151,145,16.15,87,33,76,78,22
Cork,276,136,140,35.78,60,35,53,97,31
Cork,192,101,91,27.83,26,31,48,52,35
Cork,242,122,120,67.55,50,33,52,79,28
Cork,310,158,152,28.58,81,36,76,77,40
Cork,173,90,83,190.87,23,18,49,52,31
Cork,194,115,79,3533.18,33,34,74,36,17
Cork,217,110,107,18,54,25,66,46,26
Cork,262,123,139,42.55,68,20,102,48,24
Cork,112,55,57,24.68,14,12,26,37,23
Cork,142,75,67,22.72,35,14,37,39,17
Cork,105,48,57,380.89,24,8,40,27,6
Cork,88,45,43,892.95,11,8,25,28,16
Cork,230,122,108,17.62,41,33,60,59,37
Cork,207,104,103,18.71,26,32,50,71,28
Cork,228,126,102,121.24,50,30,73,47,28
Cork,225,112,113,12.04,51,26,64,54,30
Cork,179,86,93,16.46,40,22,51,38,28
Cork,271,131,140,16.92,66,30,72,60,43
Cork,278,146,132,24.28,77,19,88,55,39
Cork,264,137,127,31.74,50,35,63,80,36
Cork,233,120,113,34.52,46,22,56,76,33
Cork,380,195,185,26.86,89,32,148,84,27
Cork,232,113,119,103.43,76,17,101,31,7
Cork,201,101,100,2083.87,52,16,112,15,6
Cork,273,131,142,49.92,75,27,99,53,19
Cork,233,131,102,26.06,45,30,74,66,18
Cork,228,106,122,2602.26,51,29,103,41,4
Cork,287,146,141,661.49,84,35,134,34,0
Cork,400,205,195,89.89,106,53,131,87,23
Cork,412,200,212,91.7,140,42,153,60,17
Cork,239,108,131,238.47,55,32,75,62,15
Cork,289,134,155,127.84,62,33,71,83,40
Cork,196,99,97,55.55,35,26,48,55,32
Cork,305,147,158,53.36,59,45,78,86,37
Cork,247,127,120,36.21,63,25,62,65,32
Cork,210,104,106,171.01,43,20,98,35,14
Cork,176,95,81,14.23,31,23,43,53,26
Cork,201,109,92,30.05,39,22,49,58,33
Cork,217,123,94,98.43,38,26,68,53,32
Cork,265,133,132,772.26,73,33,104,51,4
Cork,416,200,216,28.72,92,46,87,135,56
Cork,164,85,79,2787.27,40,14,54,36,20
Cork,140,64,76,1428.05,23,10,37,33,37
Cork,117,54,63,971.74,26,7,32,21,31
Cork,312,158,154,794.98,43,40,60,104,65
Cork,158,80,78,3115.88,26,13,24,58,37
Cork,172,84,88,2438.33,44,9,90,23,6
Cork,251,103,148,4621.02,98,30,95,26,2
Cork,351,183,168,578.26,83,42,96,74,56
Cork,280,127,153,6095.44,80,28,102,47,23
Cork,299,137,162,2103.78,100,31,130,31,7
Cork,223,117,106,443.64,67,25,91,30,10
Cork,136,75,61,1909.55,17,9,55,43,12
Cork,146,70,76,5717.64,19,16,37,42,32
Cork,326,178,148,722.71,26,26,40,130,104
Cork,184,96,88,2411.47,23,41,25,76,19
Cork,141,86,55,5243,14,10,42,51,24
Cork,172,92,80,2772.76,20,24,35,53,40
Cork,177,87,90,4226.56,53,18,79,20,7
Cork,358,178,180,7480.31,68,41,110,115,24
Cork,225,105,120,3601.96,41,18,57,71,38
Cork,331,166,165,5565.36,44,41,74,92,80
Cork,152,61,91,3102.42,58,8,76,8,2
Cork,252,135,117,3158.57,38,31,73,56,54
Cork,224,102,122,2810.15,31,24,51,62,56
Cork,291,133,158,3687,81,39,82,62,27
Cork,157,83,74,5246.1,15,15,41,55,31
Cork,246,123,123,5971.74,82,14,125,21,4
Cork,155,65,90,415.51,35,12,47,26,35
Cork,235,117,118,1472.83,44,26,82,40,43
Cork,259,138,121,484.24,62,43,61,69,24
Cork,172,91,81,494.93,20,12,55,43,42
Cork,250,123,127,3229.81,28,33,62,95,32
Cork,311,149,162,3739.6,76,61,80,83,11
Cork,282,136,146,2049.87,64,31,73,75,39
Cork,273,132,141,512.23,64,28,67,66,48
Cork,270,117,153,4167.25,65,44,69,59,33
Cork,310,155,155,1410.19,84,50,104,52,20
Cork,150,61,89,337.71,29,22,31,49,19
Cork,263,126,137,3099.22,75,29,107,39,13
Cork,239,125,114,1465.7,64,30,78,57,10
Cork,292,149,143,1237.11,106,26,123,31,6
Cork,211,104,107,4533.54,72,17,96,25,1
Cork,247,115,132,781.6,92,22,114,18,1
Cork,244,128,116,6795.71,71,14,146,11,2
Cork,246,117,129,538.98,51,41,51,84,19
Cork,110,61,49,2175.29,9,16,56,20,9
Cork,173,89,84,3124.6,22,26,71,26,28
Cork,142,69,73,2831,14,12,60,35,21
Cork,182,84,98,2099.51,14,21,37,52,58
Cork,257,126,131,2788.48,37,23,72,66,59
Cork,392,176,216,1529.06,37,19,73,74,189
Cork,159,93,66,2893.7,29,16,76,19,19
Cork,130,73,57,4688.91,8,25,61,19,17
Cork,186,91,95,1762.53,62,14,92,18,0
Cork,230,111,119,1446.64,77,13,127,11,2
Cork,246,121,125,4594.7,77,8,143,16,2
Cork,247,133,114,3496.75,43,27,99,51,27
Cork,173,94,79,1925.47,26,13,89,28,17
Cork,135,72,63,2798.97,20,18,44,38,15
Cork,151,70,81,1229.42,24,14,46,38,29
Cork,227,112,115,2784.93,49,12,116,33,17
Cork,237,125,112,2706.07,42,28,81,55,31
Cork,155,63,92,1818.46,16,20,27,48,44
Cork,118,70,48,3995.67,15,6,62,26,9
Cork,237,125,112,1697.21,34,24,72,69,38
Cork,240,122,118,2851.24,32,45,66,59,38
Cork,221,106,115,5059.06,22,23,60,59,57
Cork,196,98,98,4325.47,27,14,66,48,41
Cork,162,85,77,3805.23,28,14,49,32,39
Cork,177,81,96,5634.25,25,12,64,37,39
Cork,255,124,131,4129.15,46,27,32,77,73
Cork,308,145,163,5662.81,69,31,90,83,35
Cork,283,133,150,3717.91,47,45,64,71,56
Cork,230,113,117,3293.57,21,40,54,83,32
Cork,292,137,155,1812.37,59,51,36,95,51
Cork,172,80,92,5214.97,31,21,46,42,32
Cork,200,94,106,6176.65,25,30,52,53,40
Cork,280,136,144,3943.11,33,52,49,92,54
Cork,194,93,101,1595.97,31,24,65,48,26
Cork,249,123,126,2997.44,33,26,65,83,42
Cork,229,113,116,2074.26,32,36,43,60,58
Cork,263,120,143,3943.5,25,46,51,71,70
Cork,280,143,137,3553.52,39,35,67,66,73
Cork,212,109,103,5076.75,25,23,56,57,51
Cork,215,109,106,7480.6,36,26,59,50,44
Cork,182,94,88,4299.25,30,22,36,60,34
Cork,167,75,92,520.49,30,20,40,52,25
Cork,239,114,125,7976.5,42,36,55,69,37
Cork,208,117,91,6194.9,19,37,42,64,46
Cork,220,108,112,5643.49,50,28,52,59,31
Cork,161,101,60,4615.56,1,153,7,0,0
Cork,256,134,122,239.77,46,79,67,56,8
Cork,214,108,106,914.61,5,152,19,13,25
Cork,171,72,99,4874.57,13,102,39,11,6
Cork,164,72,92,2694.66,15,24,45,34,46
Cork,137,62,75,1264.08,5,85,20,15,12
Cork,223,110,113,2201.64,19,36,77,53,38
Cork,286,143,143,672.16,48,79,58,92,9
Cork,162,87,75,6801.86,0,155,7,0,0
Cork,90,71,19,6241.76,1,87,2,0,0
Cork,172,78,94,1684.44,16,35,38,26,57
Cork,167,90,77,2832.14,9,43,23,48,44
Cork,387,182,205,3486.02,62,37,103,133,52
Cork,198,101,97,4271.66,21,54,46,62,15
Cork,221,100,121,3301.22,34,58,48,33,48
Cork,267,149,118,2315.62,30,61,53,70,53
Cork,233,103,130,2465.09,20,47,42,66,58
Cork,191,80,111,4486.83,20,45,31,41,54
Cork,210,104,106,2659.44,15,23,42,42,88
Cork,216,88,128,2679.27,33,36,51,52,44
Cork,337,159,178,1928.6,64,66,57,102,48
Cork,282,130,152,3071.56,27,41,51,59,104
Cork,268,128,140,2547.19,31,49,35,70,83
Cork,324,152,172,3130.13,29,105,59,84,47
Cork,205,97,108,5344.25,12,30,50,83,30
Cork,266,128,138,2262.62,35,36,64,87,44
Cork,210,108,102,8317.16,32,39,46,65,28
Cork,890,408,482,3639.62,142,81,175,205,287
Cork,258,123,135,2428.99,13,49,43,47,106
Cork,329,168,161,1655.81,26,120,52,84,47
Cork,242,138,104,3018.51,15,121,23,34,49
Cork,265,126,139,3491.8,30,33,57,58,87
Cork,237,107,130,1277.02,17,23,72,38,87
Cork,201,96,105,3943.57,11,48,63,37,42
Cork,251,135,116,5854.23,32,23,63,41,92
Cork,245,117,128,3282.07,22,48,55,58,62
Cork,212,97,115,834.53,33,21,102,29,27
Cork,301,142,159,6291.41,40,56,102,45,58
Cork,232,108,124,4456.23,24,48,80,35,45
Cork,290,131,159,5129.93,51,48,71,96,24
Cork,300,132,168,4479.08,40,54,61,65,80
Cork,235,119,116,3660.27,22,36,68,53,56
Cork,235,105,130,5309.41,65,28,96,37,9
Cork,333,146,187,4433.14,58,61,84,66,64
Cork,198,112,86,3208.5,13,37,55,47,46
Cork,202,107,95,3724.67,27,30,38,66,41
Cork,271,123,148,3016.14,22,50,51,76,72
Cork,267,123,144,1112.09,32,32,52,68,83
Cork,254,111,143,3666.97,27,36,61,65,65
Cork,281,144,137,3677.38,39,32,68,67,75
Cork,171,81,90,5844.56,27,24,51,42,27
Cork,162,79,83,2289.3,25,23,65,27,22
Cork,169,75,94,7841.14,26,22,43,52,26
Cork,161,84,77,5150.68,30,28,38,32,33
Cork,300,168,132,1434.04,83,72,96,46,3
Cork,286,164,122,4060.31,24,49,203,9,1
Cork,138,61,77,9054.52,4,14,59,36,25
Cork,240,121,119,2770.18,14,26,65,76,59
Cork,129,74,55,4295.99,9,20,71,23,6
Cork,141,82,59,7773.73,8,13,120,0,0
Cork,170,91,79,10083.04,6,23,133,3,5
Cork,151,80,71,3941.84,12,21,79,30,9
Cork,118,64,54,4223.03,9,18,69,20,2
Cork,158,81,77,4494.25,14,23,36,50,35
Cork,198,98,100,2841.81,37,24,36,58,43
Cork,191,91,100,1662.63,32,27,30,50,52
Cork,240,117,123,3229.58,45,30,39,55,71
Cork,224,106,118,3097.77,44,23,49,60,48
Cork,144,79,65,2753.08,12,23,89,13,7
Cork,380,244,136,2869.01,10,51,184,99,36
Cork,138,75,63,2010.64,5,49,70,11,3
Cork,175,80,95,2076.81,4,46,80,30,15
Cork,124,73,51,3674.29,9,17,71,14,13
Cork,363,192,171,15582.07,20,31,95,85,132
Cork,254,129,125,28834.15,40,53,141,19,1
Cork,83,46,37,20082.26,6,22,48,7,0
Cork,162,91,71,6567.75,20,24,100,14,4
Cork,310,179,131,3874.56,11,62,215,18,4
Cork,170,92,78,2719.61,9,21,93,21,26
Cork,219,118,101,9331.86,13,78,110,13,5
Cork,250,120,130,9737.1,29,39,115,40,27
Cork,272,155,117,6498.63,45,35,67,81,44
Cork,272,142,130,6306.52,36,41,76,80,39
Cork,177,90,87,4775.91,31,26,63,42,15
Cork,210,107,103,2514.07,35,30,42,67,36
Cork,319,158,161,8152.52,63,43,105,77,31
Cork,272,144,128,7347.18,49,31,63,80,49
Cork,336,204,132,2449.07,10,28,133,68,97
Cork,210,114,96,5481.17,5,44,85,54,22
Cork,258,133,125,7710.7,19,37,131,44,27
Cork,254,120,134,5234.31,13,34,145,41,21
Cork,269,133,136,5751.8,35,32,96,72,34
Cork,157,79,78,10662.86,16,11,78,28,24
Cork,182,93,89,10038.06,11,22,76,48,25
Cork,232,123,109,2199.24,41,29,90,48,24
Cork,107,54,53,2232.7,11,28,39,16,13
Cork,191,93,98,848.86,33,21,60,40,37
Cork,192,101,91,8975.74,65,16,90,18,3
Cork,183,102,81,1427.72,15,20,79,39,30
Cork,319,153,166,351.66,61,40,86,87,45
Cork,207,107,100,12869.13,7,39,81,46,34
Cork,212,107,105,5704.45,9,37,91,39,36
Cork,241,126,115,4738.31,11,31,92,65,42
Cork,227,112,115,6811.29,17,44,92,42,32
Cork,175,94,81,5488.13,19,24,85,23,24
Cork,200,103,97,7142.86,11,34,89,41,25
Cork,235,113,122,8280.48,59,29,56,48,43
Cork,224,104,120,5813.65,38,21,54,53,58
Cork,222,106,116,2825.61,33,29,51,63,46
Cork,251,136,115,4855.68,32,24,64,78,53
Cork,246,117,129,6064.64,18,29,46,59,94
Cork,169,81,88,4890.47,23,20,30,39,57
Cork,111,48,63,2013.42,14,7,17,27,46
Cork,249,105,144,7688.98,26,54,55,103,11
Cork,433,227,206,7817.3,132,57,152,85,7
Cork,243,109,134,3751.33,44,33,55,84,27
Cork,393,202,191,2600.91,76,66,86,140,25
Cork,292,137,155,8460.09,53,39,70,76,54
Cork,340,166,174,6927.32,58,78,82,105,17
Cork,323,167,156,4114.34,62,53,81,100,27
Cork,359,185,174,5814.61,47,67,80,142,23
Cork,206,94,112,5233.08,21,26,47,63,49
Cork,225,122,103,1794.54,38,24,105,36,22
Cork,349,185,164,3515.91,57,71,82,111,28
Cork,303,141,162,6842.97,64,51,80,95,13
Cork,193,113,80,7241.75,11,27,110,33,12
Cork,195,102,93,5512.52,31,19,72,37,36
Cork,153,84,69,10593.37,11,16,40,28,58
Cork,222,116,106,11619.99,50,24,67,38,43
Cork,241,132,109,7946.19,44,34,70,71,22
Cork,281,147,134,7080.05,82,40,80,50,29
Cork,203,96,107,8894.15,33,24,50,54,42
Cork,128,64,64,3922.53,12,17,62,25,12
Cork,196,100,96,7475.49,30,22,62,54,28
Cork,209,105,104,5719.92,35,27,50,67,30
Cork,239,110,129,8752.33,49,24,66,52,48
Cork,229,105,124,4985.74,62,23,63,45,36
Cork,210,105,105,7081.91,46,22,60,50,32
Cork,196,90,106,1180.76,29,21,33,53,60
Cork,220,109,111,1786.58,42,42,46,59,31
Cork,192,95,97,5681.48,22,32,39,53,46
Cork,160,81,79,8235.54,20,16,47,39,38
Cork,225,107,118,8857.57,44,27,65,59,30
Cork,241,113,128,12882.88,42,32,72,64,31
Cork,262,135,127,12056.51,49,23,84,56,50
Cork,234,105,129,7854.46,6,163,35,20,10
Cork,191,99,92,7901.7,25,46,58,32,30
Cork,130,68,62,19714.89,2,45,71,9,3
Cork,111,70,41,2562.39,2,40,60,8,1
Cork,213,81,132,2749.7,4,122,42,10,35
Cork,102,42,60,4566.62,2,24,69,3,4
Cork,212,112,100,10187.9,25,73,49,40,25
Cork,198,95,103,10621.75,26,75,51,37,9
Cork,174,84,90,4123.22,6,65,47,28,28
Cork,376,215,161,7786.94,21,39,221,69,26
Cork,237,118,119,9441.48,2,126,50,22,37
Cork,145,76,69,7507.12,6,72,35,14,18
Cork,140,60,80,6750.24,7,54,21,34,24
Cork,124,70,54,13123.08,0,6,8,25,85
Cork,282,141,141,1535.76,7,126,57,54,38
Cork,299,142,157,5657.52,16,154,29,40,60
Cork,179,80,99,3990.81,10,63,46,30,30
Cork,238,103,135,13450.89,0,231,6,0,1
Cork,299,132,167,3096.26,31,95,106,32,35
Cork,360,137,223,2427.3,6,146,20,52,136
Cork,188,56,132,3271.04,3,179,3,2,1
Cork,309,145,164,4263.07,27,101,96,49,36
Cork,170,96,74,4018.82,10,34,53,39,34
Cork,224,104,120,1524.67,23,42,74,49,36
Cork,170,83,87,6802.72,5,91,36,11,27
Cork,284,141,143,5471.96,30,104,78,40,32
Cork,269,116,153,3899.17,29,76,63,59,42
Cork,207,95,112,3615.34,20,45,51,52,39
Cork,255,117,138,4367.19,16,66,49,44,80
Cork,254,111,143,3885.57,20,30,57,47,100
Cork,182,86,96,7251,38,19,50,29,46
Cork,264,121,143,8090.47,54,28,71,55,56
Cork,284,139,145,6636.75,44,23,84,67,66
Cork,203,93,110,3456.03,21,19,30,42,91
Cork,287,134,153,5998.54,34,34,73,58,88
Cork,275,124,151,3731.9,26,61,42,70,76
Cork,237,109,128,3962.95,33,46,56,65,37
Cork,211,102,109,5207.56,24,29,52,44,62
Cork,259,137,122,8063.51,43,45,70,62,39
Cork,244,117,127,9042.4,38,22,78,54,52
Cork,200,93,107,6775.53,29,32,45,54,40
Cork,320,155,165,9807.83,32,78,119,77,14
Cork,313,162,151,7577.04,33,69,113,81,17
Cork,242,136,106,9224.67,26,40,94,58,24
Cork,332,142,190,4746.04,74,57,128,57,16
Cork,135,65,70,4635.83,9,21,38,23,44
Cork,256,129,127,8825.15,53,32,78,57,36
Cork,204,104,100,7620.19,45,24,56,38,41
Cork,303,153,150,10868.79,53,42,69,86,53
Cork,148,82,66,10170.42,5,14,49,53,27
Cork,182,93,89,8302.54,19,12,41,65,45
Cork,235,105,130,6169.44,45,27,67,54,42
Cork,162,86,76,7259.04,8,23,63,38,30
Cork,141,78,63,10274.72,18,30,48,35,10
Cork,144,67,77,8209.81,25,18,34,40,27
Cork,169,82,87,8958.39,15,24,33,66,31
Cork,145,72,73,7631.58,17,23,42,35,28
Cork,133,72,61,6928.53,15,26,40,39,13
Cork,85,51,34,5856.82,4,2,18,24,37
Cork,249,121,128,10668.84,40,40,66,64,39
Cork,229,119,110,6864.71,39,24,56,56,54
Cork,233,113,120,11659.33,32,34,67,63,37
Cork,205,103,102,8100.53,30,25,43,63,44
Cork,191,72,119,4855.23,54,28,60,26,23
Cork,332,160,172,6273.74,78,60,80,75,39
Cork,314,140,174,2027.97,30,38,70,91,85
Cork,436,211,225,5596.34,153,61,119,64,39
Cork,389,176,213,5072.7,111,62,103,96,17
Cork,353,168,185,3909.41,71,51,112,114,5
Cork,261,137,124,7592.95,56,34,139,28,4
Cork,234,117,117,2436.23,64,26,102,32,10
Cork,319,165,154,1012.85,80,48,84,91,16
Cork,261,114,147,13000.6,91,48,70,42,10
Cork,266,117,149,7719.09,69,38,65,75,19
Cork,318,138,180,3883.12,118,42,94,56,8
Cork,266,121,145,8974.96,74,47,70,62,13
Cork,148,74,74,6034.9,36,27,38,40,7
Cork,404,188,216,3779.98,100,75,106,112,11
Cork,264,131,133,4337.4,47,31,77,65,44
Cork,222,115,107,1643.9,41,21,79,43,38
Cork,194,103,91,10475.16,17,20,128,20,9
Cork,203,101,102,2211.76,38,20,47,65,33
Cork,228,131,97,2395.13,25,17,57,45,84
Cork,150,74,76,9252.98,13,27,101,7,2
Cork,211,86,125,18852.75,62,32,94,19,4
Cork,184,91,93,4883.62,40,13,58,38,35
Cork,273,105,168,746.11,48,33,61,60,71
Cork,161,91,70,5586.2,16,25,46,43,31
Cork,273,140,133,2528.11,95,44,44,84,6
Cork,223,128,95,217.41,27,40,76,51,29
Cork,257,101,156,5629.18,68,31,83,47,28
Cork,244,118,126,4004.99,61,16,100,39,28
Cork,291,148,143,4704.25,85,41,70,81,14
Cork,154,75,79,1304.26,31,15,54,29,25
Cork,227,103,124,2108.55,32,43,36,80,36
Cork,287,140,147,932.46,67,20,89,70,41
Cork,250,125,125,3952.07,34,39,61,76,40
Cork,242,118,124,2360.61,20,27,45,97,53
Cork,214,103,111,6950.31,52,23,100,22,17
Cork,245,120,125,8603.43,37,37,68,87,16
Cork,358,148,210,2146.1,50,51,56,70,131
Cork,232,114,118,4649.02,35,37,46,76,38
Cork,238,114,124,2866.88,34,18,157,21,8
Cork,222,105,117,3974.43,48,32,65,62,15
Cork,323,152,171,8172.46,93,47,105,71,7
Cork,322,156,166,1076.36,87,24,137,59,15
Cork,248,121,127,1273.34,53,31,85,53,26
Cork,218,105,113,1473.39,23,26,61,60,48
Cork,269,123,146,1257.22,52,29,132,47,9
Cork,322,152,170,4793.52,48,38,93,75,68
Cork,339,155,184,385.54,70,53,83,87,46
Cork,187,92,95,3226.2,50,25,60,34,18
Cork,364,154,210,9330.22,120,62,106,65,11
Cork,144,78,66,6452.19,11,7,117,9,0
Cork,138,71,67,12032.44,15,10,103,10,0
Cork,222,107,115,5382.08,43,38,60,71,10
Cork,263,108,155,429.29,51,42,75,77,18
Cork,302,141,161,2011.2,71,66,76,83,6
Cork,287,136,151,9899.97,50,46,70,102,19
Cork,321,141,180,6376.26,79,67,67,91,17
Cork,179,81,98,1555.05,40,16,88,30,5
Cork,203,92,111,4522.67,55,25,81,38,4
Cork,362,170,192,2546.27,80,82,76,103,21
Cork,352,178,174,1763.04,112,88,76,68,8
Cork,371,197,174,1375.79,90,37,204,40,0
Cork,284,141,143,4457.91,21,28,68,80,87
Cork,250,116,134,2018.42,33,18,99,48,52
Cork,274,135,139,1934.63,32,24,58,59,101
Cork,246,124,122,2635.86,51,25,44,71,55
Cork,380,197,183,6594.02,77,92,66,134,11
Cork,188,90,98,3135.21,31,27,33,62,35
Cork,335,168,167,3115.58,56,68,46,122,43
Cork,324,173,151,4653.43,44,34,61,80,105
Cork,257,127,130,3152.06,51,36,46,66,58
Cork,238,118,120,4921.22,36,24,122,40,16
Cork,310,124,186,4579.16,32,24,47,51,156
Cork,244,125,119,3937.26,45,27,72,58,42
Cork,220,116,104,1166.11,14,80,48,39,39
Cork,101,53,48,3993.04,4,28,34,18,17
Cork,122,66,56,2324.08,8,51,48,9,6
Cork,193,86,107,1629.93,6,111,36,35,5
Cork,149,77,72,3502.83,17,23,48,23,38
Cork,278,125,153,3087.93,83,46,82,53,14
Cork,263,107,156,4714.28,83,51,66,58,5
Cork,190,82,108,6119.36,45,17,38,48,42
Cork,242,119,123,2965.65,54,35,65,53,35
Cork,280,131,149,2332.98,57,39,66,79,39
Cork,236,108,128,4520.03,69,41,54,51,21
Cork,234,109,125,4922.27,58,49,69,43,15
Cork,239,111,128,4603.68,76,46,55,41,21
Cork,175,87,88,9714.13,52,21,64,32,6
Cork,113,70,43,11995.75,16,9,37,45,6
Cork,168,78,90,4771.91,29,23,54,41,21
Cork,323,139,184,3610.75,37,31,59,78,118
Cork,179,79,100,4475.78,30,12,50,46,41
Cork,161,75,86,5498.26,19,19,35,48,40
Cork,134,65,69,8150.36,23,5,30,31,45
Cork,235,111,124,4292.16,20,47,44,84,40
Cork,295,146,149,5316.08,47,34,73,108,33
Cork,198,83,115,5312.87,32,15,78,37,36
Cork,185,85,100,4221.53,14,23,74,44,30
Cork,132,71,61,3249.39,16,16,55,30,15
Cork,100,59,41,7431.63,7,16,48,24,5
Cork,268,131,137,6138.48,48,37,57,77,49
Cork,139,47,92,1952.03,21,15,23,31,49
Cork,275,135,140,2863.96,28,25,60,74,88
Cork,259,126,133,2657.26,32,22,60,66,79
Cork,408,181,227,5954.12,85,24,116,62,121
Cork,261,121,140,1933.51,32,27,79,74,49
Cork,212,98,114,2801.86,32,31,57,55,37
Cork,199,92,107,5302.28,46,26,51,36,40
Cork,193,96,97,2358.2,25,29,27,72,40
Cork,280,126,154,5965.95,34,34,80,76,56
Cork,234,115,119,4645.35,24,23,44,62,81
Cork,204,92,112,3196.54,33,24,44,59,44
Cork,361,180,181,7322.52,62,44,88,103,64
Cork,163,85,78,5468.7,18,21,35,43,46
Cork,217,102,115,8092.49,28,42,42,61,44
Cork,317,149,168,1095.43,53,43,78,86,57
Cork,290,148,142,5552.79,43,45,68,86,48
Cork,196,90,106,6494.58,22,32,49,55,38
Cork,286,142,144,8096.48,45,37,65,77,62
Cork,199,102,97,5392.52,29,24,53,57,36
Cork,279,132,147,5496.67,31,50,57,116,25
Cork,282,133,149,8457.8,53,50,66,93,20
Cork,213,99,114,8022.6,63,32,80,35,3
Cork,234,113,121,6444.86,57,37,65,69,6
Cork,391,182,209,5840.96,95,76,98,112,10
Cork,245,121,124,699.47,58,41,59,62,25
Cork,375,182,193,3094.88,105,32,196,37,5
Cork,254,125,129,2538.12,70,14,151,16,3
Cork,224,104,120,1425.16,30,28,61,61,44
Cork,193,94,99,2376.94,20,32,51,63,27
Cork,185,91,94,7512.08,34,25,62,48,16
Cork,213,102,111,4490.73,40,39,61,55,18
Cork,162,91,71,843.31,6,25,119,9,3
Cork,173,95,78,8519.65,10,27,126,9,1
Cork,230,75,155,5980.39,19,13,61,71,66
Cork,147,80,67,10919.63,15,20,58,28,26
Cork,260,156,104,10570.39,18,34,174,26,8
Cork,133,72,61,9336.61,9,14,44,40,26
Cork,172,95,77,12076.11,14,16,87,28,27
Cork,121,68,53,4475.51,7,19,65,24,6
Cork,123,68,55,5062.15,8,23,83,8,1
Cork,181,90,91,34641.15,26,36,112,7,0
Cork,165,92,73,60550.46,8,33,115,8,1
Cork,93,57,36,4173.96,6,13,64,7,3
Cork,142,67,75,8820.97,4,25,44,45,24
Cork,152,83,69,15707.35,22,26,66,21,17
Cork,128,63,65,7266.53,20,19,57,27,5
Cork,141,71,70,17064.02,18,23,64,23,13
Cork,119,64,55,9523.05,3,34,72,10,0
Cork,230,141,89,11105.75,12,85,120,12,1
Cork,145,79,66,7686.6,8,11,75,28,23
Cork,257,127,130,11590.15,32,61,137,24,3
Cork,208,113,95,14126.6,15,42,127,18,6
Cork,193,102,91,6618.66,2,66,103,15,7
Cork,219,114,105,5749.39,25,63,104,22,5
Cork,182,88,94,19780.46,11,37,125,9,0
Cork,150,87,63,5853.43,8,37,87,12,6
Cork,164,85,79,7929.98,8,39,106,9,2
Cork,207,134,73,15123.84,10,26,115,51,5
Cork,154,82,72,13352.99,4,29,71,32,18
Cork,130,66,64,9735.64,16,32,56,14,12
Cork,139,78,61,13619.44,8,52,72,7,0
Cork,166,85,81,14665.61,5,54,69,17,21
Cork,162,77,85,11123.32,18,43,51,30,20
Cork,142,76,66,15349.69,10,28,56,28,20
Cork,129,64,65,6059.75,7,40,52,20,10
Cork,186,95,91,15528.47,13,45,65,43,20
Cork,182,93,89,9646.47,14,32,102,24,10
Cork,228,123,105,788.35,6,37,105,49,31
Cork,145,73,72,12713.72,3,71,45,24,2
Cork,172,109,63,5847.36,13,14,92,35,18
Cork,210,111,99,6133.54,14,29,99,51,17
Cork,220,119,101,10493.18,18,54,96,45,7
Cork,142,83,59,5392.47,11,14,78,29,10
Cork,182,91,91,6762.53,24,26,57,47,28
Cork,133,74,59,1229.63,13,13,70,27,10
Cork,267,170,97,6895.48,28,34,130,54,21
Cork,120,71,49,20711.08,3,39,58,12,8
Cork,93,53,40,10301.28,6,10,60,15,2
Cork,195,105,90,6507.59,1,16,73,34,71
Cork,147,78,69,3954.48,16,17,52,47,15
Cork,159,71,88,9118.02,20,28,67,30,14
Cork,175,98,77,8641.98,15,18,64,45,33
Cork,197,94,103,10168.27,22,21,62,56,36
Cork,255,141,114,6022.67,16,20,124,65,30
Cork,211,112,99,2960.16,29,26,69,48,39
Cork,210,106,104,1166.62,16,28,62,65,39
Cork,228,120,108,2516.53,34,25,58,58,53
Cork,98,54,44,13806.71,6,21,47,15,9
Cork,87,46,41,6623.52,5,26,52,2,2
Cork,135,71,64,10090.44,4,51,53,16,11
Cork,195,95,100,6168.15,21,28,77,39,30
Cork,212,110,102,1597.16,16,39,69,57,31
Cork,228,102,126,4549.35,43,37,73,41,34
Cork,240,123,117,6358.8,48,23,70,48,51
Cork,490,388,102,7567.8,47,135,220,71,17
Cork,250,124,126,1376.6,67,24,96,39,24
Cork,372,189,183,1676.08,80,33,142,54,63
Cork,319,167,152,6682.73,84,63,75,71,26
Cork,142,69,73,729.48,30,21,26,44,21
Cork,313,143,170,6310.87,66,57,75,92,23
Cork,190,87,103,5254.72,23,15,50,60,42
Cork,308,146,162,6063.95,60,49,67,101,31
Cork,281,133,148,8410.66,41,22,76,112,30
Cork,227,113,114,5757.18,16,24,45,98,44
Cork,253,131,122,8592.29,26,23,69,92,43
Cork,370,181,189,10615.1,71,55,101,125,18
Cork,271,137,134,3782.33,62,33,92,66,18
Cork,368,180,188,7350.15,91,63,84,108,22
Cork,393,179,214,10041.39,145,55,144,40,9
Cork,311,158,153,1778.51,77,43,77,76,38
Cork,227,115,112,5020.24,29,26,49,72,51
Cork,269,142,127,7677.82,42,52,66,92,17
Cork,144,76,68,2439.6,19,19,77,17,12
Cork,163,76,87,2017.45,26,14,47,30,46
Cork,151,68,83,13167.07,6,49,55,31,10
Cork,201,109,92,2937.61,5,57,54,39,46
Cork,214,91,123,5889.48,19,49,62,43,41
Cork,173,87,86,4426.02,20,21,42,53,37
Cork,240,114,126,1896.9,27,45,62,62,44
Cork,240,114,126,8500.39,16,92,68,33,31
Cork,177,91,86,11024.6,23,54,35,45,20
Cork,142,78,64,5271.95,17,21,53,35,16
Cork,179,106,73,2711.3,13,17,81,60,8
Cork,165,82,83,2189.37,25,16,56,39,29
Cork,183,101,82,721.31,19,27,62,53,22
Cork,296,146,150,896,54,42,52,116,32
Cork,132,64,68,8863.22,9,15,94,10,4
Cork,222,104,118,963.88,36,33,71,56,26
Cork,240,127,113,181.72,21,15,137,46,21
Cork,256,125,131,3664.05,46,35,73,73,29
Cork,228,113,115,6799.68,76,15,121,15,1
Cork,224,115,109,6553.35,41,35,65,65,18
Cork,328,163,165,7115.58,81,40,140,53,14
Cork,242,123,119,10240.79,36,37,64,74,31
Cork,234,104,130,12356.11,39,27,56,88,24
Cork,270,139,131,5066.43,30,36,60,101,43
Cork,316,148,168,5549.7,36,37,58,106,79
Cork,249,126,123,1737.36,48,29,60,73,39
Cork,304,145,159,2236.07,60,38,82,71,53
Cork,329,156,173,3520.86,55,48,76,81,69
Cork,288,152,136,3853.62,36,40,70,87,55
Cork,278,133,145,2910.29,28,35,57,91,67
Cork,403,203,200,10704.7,126,55,137,72,13
Cork,237,115,122,1309.55,25,39,52,81,40
Cork,291,136,155,5212.44,36,35,75,55,90
Cork,215,97,118,6070.02,36,29,49,59,42
Cork,237,108,129,6092.7,30,21,56,53,77
Cork,231,113,118,4654.16,22,29,50,51,79
Cork,398,162,236,3087.21,16,24,91,66,201
Cork,271,132,139,4738.67,28,30,129,57,27
Cork,174,97,77,2150.91,33,14,71,42,14
Cork,230,98,132,3268.44,36,20,68,40,66
Cork,236,104,132,3683.3,33,37,49,71,46
Cork,242,115,127,2306.78,35,28,54,71,54
Cork,321,152,169,4690.93,55,45,57,107,57
Cork,280,128,152,3731.64,31,26,88,65,70
Cork,349,180,169,7778.2,67,57,108,93,24
Cork,223,116,107,6664.87,40,32,72,62,17
Cork,287,132,155,2186.47,89,21,128,45,4
Cork,365,175,190,3817.87,82,69,87,93,34
Cork,233,108,125,5092.12,34,30,80,64,25
Cork,192,96,96,6335.59,49,19,78,42,4
Cork,176,96,80,11111.81,20,28,121,5,2
Cork,205,93,112,443.3,17,21,73,40,54
Cork,304,128,176,3426.36,68,62,72,83,19
Cork,196,88,108,1711.64,28,27,65,52,24
Cork,175,79,96,3343.59,15,21,54,42,43
Cork,232,117,115,5217.82,14,36,95,49,38
Cork,172,80,92,2328.57,17,15,69,34,37
Cork,183,91,92,5584.89,26,14,52,40,51
Cork,171,87,84,5052,17,17,72,37,28
Cork,159,82,77,5176.12,23,16,41,41,38
Cork,168,85,83,6418.34,21,16,50,36,45
Cork,209,102,107,7392.21,26,26,59,57,41
Cork,263,125,138,9449.89,40,33,69,65,56
Cork,227,121,106,6895.71,28,24,58,64,53
Cork,199,102,97,7763.73,27,23,63,51,35
Cork,213,108,105,6487.77,32,34,42,72,33
Cork,246,110,136,3129.61,29,35,78,66,38
Cork,190,90,100,1717.87,28,31,42,52,37
Cork,197,91,106,1173.53,18,19,43,52,65
Cork,254,126,128,2961.37,34,30,62,72,56
Donegal,179,90,89,3.71,31,22,49,47,30
Donegal,231,131,100,8.39,61,25,58,46,41
Donegal,193,89,104,20.13,46,21,38,49,39
Donegal,198,91,107,123.18,24,21,41,65,47
Donegal,196,94,102,95.18,34,25,45,59,33
Donegal,262,127,135,64.59,63,37,58,70,34
Donegal,240,127,113,127.6,60,43,49,54,34
Donegal,172,80,92,86.49,41,17,31,50,33
Donegal,237,111,126,57.38,47,20,57,63,50
Donegal,113,59,54,91.58,21,12,25,31,24
Donegal,132,64,68,14.49,32,9,34,28,29
Donegal,129,62,67,427.61,14,16,29,34,36
Donegal,166,84,82,109.22,42,10,38,38,38
Donegal,154,82,72,162.38,31,15,34,34,40
Donegal,126,69,57,11.17,33,12,28,24,29
Donegal,120,63,57,78.31,21,13,20,26,40
Donegal,119,53,66,94.84,21,12,17,37,32
Donegal,151,77,74,10.48,25,19,26,53,28
Donegal,158,80,78,228.1,20,19,59,31,29
Donegal,171,82,89,21.11,32,18,47,56,18
Donegal,193,88,105,806.22,38,27,49,49,30
Donegal,131,62,69,684.91,28,12,57,21,13
Donegal,224,112,112,146.44,45,22,59,55,43
Donegal,166,79,87,14.37,33,24,32,49,28
Donegal,171,83,88,21.46,43,12,33,57,26
Donegal,210,113,97,16.7,53,22,57,45,33
Donegal,128,68,60,141.28,25,12,39,30,22
Donegal,104,61,43,57.94,30,7,40,18,9
Donegal,77,37,40,57.74,9,5,16,28,19
Donegal,146,86,60,24.72,20,19,43,40,24
Donegal,201,105,96,30.05,47,31,46,51,26
Donegal,163,87,76,29.18,36,26,34,44,23
Donegal,171,91,80,34.46,33,18,57,39,24
Donegal,152,80,72,6.97,28,13,42,44,25
Donegal,116,59,57,824.38,14,16,22,38,26
Donegal,187,96,91,25.61,46,19,51,47,24
Donegal,129,51,78,16.08,32,8,32,34,23
Donegal,84,39,45,49.2,22,8,21,27,6
Donegal,195,92,103,41.12,64,21,49,37,24
Donegal,425,213,212,53.85,125,65,109,82,44
Donegal,279,135,144,29.6,68,36,68,80,27
Donegal,123,60,63,76.99,31,15,34,23,20
Donegal,114,53,61,144.14,28,10,34,24,18
Donegal,356,184,172,31.72,82,32,102,67,73
Donegal,266,138,128,54.6,62,34,75,66,29
Donegal,368,186,182,54.21,116,44,117,66,25
Donegal,256,111,145,1885.6,62,22,124,35,13
Donegal,219,109,110,2430.17,69,32,93,22,3
Donegal,176,89,87,3804.67,48,34,75,15,4
Donegal,199,101,98,182.85,50,37,58,46,8
Donegal,181,89,92,225.78,37,40,57,34,13
Donegal,258,139,119,128.93,73,33,57,85,10
Donegal,308,158,150,43.95,87,35,81,76,29
Donegal,236,114,122,343.55,75,41,103,17,0
Donegal,163,86,77,6513.23,28,21,41,47,26
Donegal,208,94,114,5425.85,17,23,49,75,44
Donegal,129,61,68,858.78,16,7,39,37,30
Donegal,188,86,102,613.06,36,26,35,67,24
Donegal,249,115,134,1235.8,28,27,59,54,81
Donegal,163,84,79,895.11,29,12,40,39,43
Donegal,180,89,91,325.64,61,11,64,29,15
Donegal,231,98,133,314.09,38,35,55,54,49
Donegal,180,81,99,344.32,30,18,43,44,45
Donegal,151,76,75,47.46,43,11,42,28,27
Donegal,226,117,109,42.95,71,22,74,43,16
Donegal,247,131,116,104.12,28,37,44,90,48
Donegal,250,117,133,50.25,48,30,77,61,34
Donegal,173,84,89,51.37,45,19,48,39,22
Donegal,352,159,193,52.04,127,33,112,62,18
Donegal,258,136,122,21.51,60,23,65,81,29
Donegal,150,81,69,3.2,17,16,27,48,42
Donegal,231,111,120,360.87,57,17,108,31,18
Donegal,241,118,123,124.82,73,25,82,37,24
Donegal,306,151,155,106,80,45,101,57,23
Donegal,258,139,119,18.26,78,26,83,42,29
Donegal,288,136,152,65.57,73,35,102,57,21
Donegal,184,95,89,9.09,35,23,41,56,29
Donegal,202,99,103,57.37,49,20,51,51,31
Donegal,254,127,127,23.56,61,36,74,56,27
Donegal,304,144,160,1276.94,118,29,108,40,9
Donegal,238,121,117,851.45,78,24,78,44,14
Donegal,324,151,173,434.26,78,50,77,75,44
Donegal,275,118,157,672.69,75,38,97,45,20
Donegal,391,185,206,36.57,129,27,153,51,31
Donegal,308,147,161,636.12,79,32,116,54,27
Donegal,222,113,109,1173.34,56,29,74,42,21
Donegal,323,159,164,2568.92,71,65,81,88,18
Donegal,310,152,158,928.16,96,47,116,37,14
Donegal,283,141,142,2046.63,82,33,96,53,19
Donegal,248,127,121,64.61,65,25,76,66,16
Donegal,89,45,44,519.75,27,7,24,20,11
Donegal,180,88,92,94.72,45,18,59,38,20
Donegal,218,106,112,172.07,42,37,40,72,27
Donegal,292,140,152,1670.42,98,45,84,52,13
Donegal,212,97,115,711.95,16,26,38,84,48
Donegal,244,124,120,1003,30,35,42,72,65
Donegal,317,148,169,3520.07,48,49,81,79,60
Donegal,199,106,93,1392.77,24,17,40,50,68
Donegal,278,144,134,1347.85,96,38,107,30,7
Donegal,223,117,106,841.19,75,26,85,30,7
Donegal,142,73,69,1306.56,7,19,30,40,46
Donegal,172,88,84,353.27,34,29,47,49,13
Donegal,183,90,93,1301.81,36,30,47,50,20
Donegal,187,90,97,470.52,31,13,45,53,45
Donegal,236,119,117,463.64,46,31,75,64,20
Donegal,165,79,86,1741,41,19,60,36,9
Donegal,197,105,92,1650.43,45,39,50,45,18
Donegal,187,102,85,1328.69,5,24,55,54,49
Donegal,366,180,186,39,75,62,78,105,46
Donegal,129,53,76,261.78,40,13,57,14,5
Donegal,247,133,114,38,48,31,56,92,20
Donegal,94,44,50,1076.55,22,10,42,18,2
Donegal,227,138,89,40.27,45,28,77,56,21
Donegal,124,52,72,335.42,35,12,23,43,11
Donegal,144,67,77,2217.26,47,17,56,16,8
Donegal,199,81,118,243.46,13,21,45,54,66
Donegal,75,44,31,1102.36,11,8,17,24,15
Donegal,125,67,58,817.96,19,21,40,29,16
Donegal,192,90,102,1293.74,59,33,50,39,11
Donegal,199,99,100,385.83,46,25,60,47,21
Donegal,118,52,66,1331.44,17,22,24,40,15
Donegal,243,120,123,425.54,24,24,57,74,64
Donegal,193,96,97,19.03,45,26,46,53,23
Donegal,199,108,91,56.63,61,19,73,30,16
Donegal,232,126,106,17.5,53,15,78,44,42
Donegal,281,146,135,34.85,57,39,73,68,44
Donegal,259,137,122,69.03,57,41,65,69,27
Donegal,258,120,138,3482.58,77,36,96,32,17
Donegal,239,132,107,57.74,74,18,64,53,30
Donegal,326,167,159,61.16,83,42,82,80,39
Donegal,286,139,147,675.93,93,22,102,38,31
Donegal,187,88,99,120.85,34,19,50,53,31
Donegal,250,114,136,478.17,71,27,86,39,27
Donegal,92,46,46,424.88,11,7,28,22,24
Donegal,238,124,114,479.43,71,26,61,43,37
Donegal,241,122,119,325.6,49,32,77,47,36
Donegal,214,112,102,14.54,45,21,53,59,36
Donegal,302,156,146,25.5,75,36,75,82,34
Donegal,192,82,110,26.79,38,24,43,54,33
Donegal,173,91,82,20.56,39,23,47,34,30
Donegal,153,77,76,44.6,31,19,47,35,21
Donegal,118,62,56,59.25,28,7,36,30,17
Donegal,158,79,79,53.6,27,25,40,38,28
Donegal,124,61,63,216.41,21,16,28,28,31
Donegal,224,112,112,26.61,42,41,61,56,24
Donegal,195,99,96,29.69,27,22,42,66,38
Donegal,180,93,87,35.19,39,27,44,48,22
Donegal,173,89,84,21.57,54,20,31,46,22
Donegal,234,116,118,323.2,46,44,57,59,28
Donegal,104,58,46,10.4,18,21,23,29,13
Donegal,194,91,103,44.15,45,32,47,48,22
Donegal,151,83,68,22.15,29,30,29,42,21
Donegal,316,154,162,35.23,73,45,78,77,43
Donegal,249,124,125,170.11,47,45,67,69,21
Donegal,173,80,93,40.04,37,17,41,45,33
Donegal,235,118,117,32.18,58,25,61,58,33
Donegal,272,137,135,30.47,76,31,80,55,30
Donegal,223,105,118,18.22,53,23,65,49,33
Donegal,190,83,107,309.87,50,26,46,40,28
Donegal,278,132,146,30.19,67,27,69,73,42
Donegal,248,116,132,495.55,66,49,69,44,20
Donegal,188,93,95,105.27,37,30,56,35,30
Donegal,184,93,91,703.65,41,19,54,45,25
Donegal,229,109,120,1597.07,96,12,100,18,3
Donegal,194,96,98,171.2,72,21,66,25,10
Donegal,375,196,179,107.11,70,52,112,81,60
Donegal,308,160,148,22.23,80,39,89,68,32
Donegal,239,130,109,57.05,62,26,69,62,20
Donegal,242,117,125,45.56,76,27,67,53,19
Donegal,440,209,231,155.82,125,43,100,104,68
Donegal,168,88,80,2091.14,24,29,43,58,14
Donegal,185,87,98,1228.04,40,26,67,45,7
Donegal,238,114,124,1801.24,39,42,49,83,25
Donegal,270,130,140,235.92,60,28,52,97,33
Donegal,231,101,130,2137.44,55,31,80,50,15
Donegal,331,168,163,198.47,48,61,62,128,32
Donegal,228,118,110,107.36,51,28,39,91,19
Donegal,239,120,119,2220.63,70,18,108,38,5
Donegal,274,131,143,565.96,73,26,163,10,2
Donegal,329,166,163,45.3,93,39,86,90,21
Donegal,302,151,151,322.08,77,49,56,102,18
Donegal,217,105,112,11.22,55,23,65,43,31
Donegal,174,85,89,10.42,54,11,46,41,22
Donegal,164,80,84,2.65,35,14,46,40,29
Donegal,192,87,105,44.66,64,16,62,27,23
Donegal,283,134,149,12.88,107,30,68,60,18
Donegal,195,105,90,6.17,44,20,54,46,31
Donegal,262,128,134,13.45,66,37,67,68,24
Donegal,236,126,110,6.89,62,24,57,53,40
Donegal,202,107,95,37.5,55,26,56,37,28
Donegal,257,145,112,23.69,71,31,67,58,30
Donegal,227,119,108,41.48,47,34,52,67,27
Donegal,223,112,111,42.56,43,32,54,56,38
Donegal,239,116,123,10.66,59,33,74,46,27
Donegal,282,152,130,53.82,65,39,66,74,38
Donegal,326,168,158,42.01,97,24,98,81,26
Donegal,180,84,96,41.05,36,28,53,36,27
Donegal,269,146,123,94.36,66,33,86,54,30
Donegal,233,116,117,49.31,54,29,63,61,26
Donegal,253,130,123,38.61,45,32,69,72,35
Donegal,270,146,124,44.67,74,32,91,49,24
Donegal,261,140,121,85.48,64,32,68,60,37
Donegal,300,139,161,301.69,110,49,95,36,10
Donegal,295,133,162,288.22,59,36,71,72,57
Donegal,193,78,115,284.15,61,28,75,22,7
Donegal,193,83,110,2759.9,52,26,77,26,12
Donegal,244,125,119,219.4,60,35,73,61,15
Donegal,231,125,106,1260.72,26,35,59,70,41
Donegal,214,101,113,186.45,40,26,53,53,42
Donegal,280,142,138,39.19,70,30,78,69,33
Donegal,265,144,121,23.86,54,27,75,62,47
Donegal,294,143,151,825.01,59,34,77,47,77
Donegal,222,93,129,1063.7,48,27,67,48,32
Donegal,290,151,139,105.35,71,43,80,73,23
Donegal,236,125,111,27.73,56,26,73,47,34
Donegal,238,128,110,21.24,61,40,69,54,14
Donegal,297,150,147,39.26,60,47,88,65,37
Donegal,132,70,62,2505.46,22,21,36,39,14
Donegal,219,117,102,230.4,51,38,42,60,28
Donegal,178,87,91,49.17,29,21,50,45,33
Donegal,266,144,122,35.23,70,33,78,52,33
Donegal,177,95,82,9.86,32,25,46,52,22
Donegal,148,75,73,18.58,26,19,36,45,22
Donegal,242,115,127,2255.15,51,21,153,13,4
Donegal,250,132,118,15.07,65,35,78,52,20
Donegal,216,113,103,592.34,69,16,89,40,2
Donegal,429,232,197,73.47,113,54,134,90,38
Donegal,397,195,202,758.73,128,33,159,60,17
Donegal,172,93,79,33.44,32,17,46,47,30
Donegal,226,112,114,28.87,46,28,67,62,23
Donegal,266,138,128,7.85,56,27,82,60,41
Donegal,247,119,128,30.19,40,35,51,82,39
Donegal,206,108,98,17.28,38,24,54,49,41
Donegal,143,61,82,241.15,35,18,47,28,15
Donegal,168,77,91,148.91,43,13,49,35,28
Donegal,248,134,114,47.98,41,16,57,68,66
Donegal,157,87,70,2.73,32,13,41,45,26
Donegal,171,94,77,92.49,31,21,31,60,28
Donegal,143,71,72,23.06,15,19,36,46,27
Donegal,176,75,101,121.91,17,25,33,55,46
Donegal,220,97,123,23.7,49,26,50,56,39
Donegal,134,66,68,19.1,22,17,37,31,27
Donegal,128,63,65,169.65,21,15,34,29,29
Donegal,169,82,87,71.28,32,20,35,53,29
Donegal,149,70,79,3318.41,32,21,35,32,29
Donegal,232,102,130,382.7,58,29,69,49,27
Donegal,160,86,74,4.09,27,26,33,48,26
Donegal,121,67,54,3.24,20,12,24,30,35
Donegal,149,74,75,66.04,33,10,39,47,20
Donegal,209,109,100,13.46,56,19,49,57,28
Donegal,175,94,81,93.87,41,28,45,46,15
Donegal,101,48,53,83.26,16,10,26,32,17
Donegal,154,76,78,19.86,27,12,38,42,35
Donegal,140,67,73,57.28,42,16,43,24,15
Donegal,174,87,87,31.67,33,25,44,52,20
Donegal,211,117,94,29.04,49,30,59,51,22
Donegal,143,66,77,28.99,26,12,37,46,22
Donegal,140,72,68,30.23,32,15,39,42,12
Donegal,105,49,56,52.96,17,9,26,34,19
Donegal,322,168,154,44.44,83,39,70,86,44
Donegal,227,114,113,16.09,65,36,54,48,24
Donegal,156,87,69,16.71,25,17,38,52,24
Donegal,258,138,120,28.48,80,25,79,57,17
Donegal,207,98,109,90.83,38,23,43,71,32
Donegal,221,111,110,820.22,41,27,59,52,42
Donegal,252,128,124,44.75,54,24,62,80,32
Donegal,271,148,123,485.5,12,32,76,70,81
Donegal,226,122,104,84.68,66,15,61,53,31
Donegal,227,107,120,166.13,31,36,35,74,51
Donegal,243,102,141,2799.76,72,30,94,32,15
Donegal,194,98,96,107.1,36,24,44,52,38
Donegal,280,125,155,424.31,102,24,111,36,7
Donegal,220,100,120,875.67,20,31,58,75,36
Donegal,227,109,118,729.32,37,27,46,75,42
Donegal,306,152,154,107.53,63,50,88,77,28
Donegal,225,108,117,194.18,32,27,98,31,37
Donegal,252,117,135,1056.14,17,21,55,80,79
Donegal,279,127,152,853.31,25,31,71,70,82
Donegal,85,47,38,1.97,22,7,17,20,19
Donegal,271,140,131,14.97,65,25,84,64,33
Donegal,199,104,95,1144.34,58,12,69,37,23
Donegal,227,117,110,3383.51,72,28,105,14,8
Donegal,362,176,186,125.7,76,55,76,110,45
Donegal,161,86,75,12.73,33,19,40,45,24
Donegal,153,82,71,38.47,38,21,44,32,18
Donegal,215,103,112,37.29,58,22,55,57,23
Donegal,82,39,43,53.17,19,7,35,11,10
Donegal,102,50,52,47.16,16,14,24,35,13
Donegal,182,105,77,16.92,35,17,47,52,31
Donegal,175,82,93,23.79,43,26,39,42,25
Donegal,138,68,70,8.49,30,22,28,41,17
Donegal,93,44,49,243.33,15,10,20,24,24
Donegal,208,111,97,11.86,54,15,58,47,34
Donegal,177,87,90,883.31,31,32,31,58,25
Donegal,91,54,37,967.3,9,4,16,29,33
Donegal,208,106,102,308.76,28,30,38,59,53
Donegal,280,146,134,101.43,74,36,72,75,23
Donegal,170,80,90,130.81,27,23,35,49,36
Donegal,232,118,114,707.18,60,25,47,64,36
Donegal,191,89,102,256.48,24,15,31,55,66
Donegal,191,102,89,19.62,45,19,60,43,24
Donegal,138,71,67,17.44,32,13,45,32,16
Donegal,207,102,105,105.73,53,27,51,52,24
Donegal,181,93,88,318.67,27,20,31,59,44
Donegal,213,107,106,40.77,45,23,51,55,39
Donegal,191,94,97,2.95,34,23,38,62,34
Donegal,146,77,69,61.2,29,14,39,39,25
Donegal,219,118,101,70.06,53,33,50,47,36
Donegal,213,105,108,9.49,49,26,56,57,25
Donegal,212,103,109,44.33,49,28,51,64,20
Donegal,163,91,72,9.62,27,21,32,55,28
Donegal,182,89,93,28.88,41,16,52,49,24
Donegal,280,147,133,71.79,91,37,93,47,12
Donegal,237,121,116,25.43,66,28,73,44,26
Donegal,261,134,127,25.01,79,36,87,49,10
Donegal,214,100,114,1849.8,70,28,101,11,4
Donegal,230,117,113,144.46,56,44,78,47,5
Donegal,184,87,97,1888.42,58,11,86,26,3
Donegal,220,97,123,115.31,79,29,92,18,2
Donegal,187,94,93,19.91,41,21,54,40,31
Donegal,188,96,92,86.88,28,13,33,53,61
Donegal,175,73,102,281.28,27,7,31,44,66
Donegal,327,155,172,95.33,95,48,85,79,20
Donegal,304,152,152,346.8,92,36,96,68,12
Donegal,265,130,135,69.56,69,32,75,52,37
Donegal,224,117,107,23.48,51,34,46,65,28
Donegal,120,53,67,16.35,20,8,27,32,33
Donegal,156,78,78,18.48,28,20,37,42,29
Donegal,168,90,78,12.98,32,16,40,34,46
Donegal,164,89,75,20.07,35,20,32,49,28
Donegal,282,154,128,25.23,64,34,101,45,38
Donegal,167,87,80,21.07,36,27,36,53,15
Donegal,367,198,169,32.72,83,45,105,97,37
Donegal,245,118,127,1573.53,77,23,101,32,12
Donegal,140,68,72,127.99,42,16,51,18,13
Donegal,205,115,90,32.44,44,29,56,50,26
Donegal,163,87,76,9.08,37,17,36,40,33
Donegal,150,86,64,9.9,37,17,32,39,25
Donegal,201,101,100,3.22,49,25,52,50,25
Donegal,136,70,66,9.97,17,23,22,53,21
Donegal,220,108,112,23.59,57,17,66,49,31
Donegal,246,121,125,17.34,67,23,63,60,33
Donegal,204,103,101,61.79,54,19,45,52,34
Donegal,197,98,99,36.82,59,14,51,34,39
Donegal,176,84,92,19.45,30,8,44,63,31
Donegal,168,89,79,6.1,43,16,40,47,22
Donegal,207,108,99,10.77,41,27,58,63,18
Donegal,250,135,115,54.3,69,26,82,50,23
Donegal,367,191,176,21.43,95,51,91,88,42
Donegal,308,154,154,21.15,76,43,87,68,34
Donegal,312,152,160,12.21,87,41,93,67,24
Donegal,217,101,116,367.87,65,19,77,39,17
Donegal,254,137,117,43.5,66,36,66,57,29
Donegal,282,152,130,32.78,82,21,84,69,26
Donegal,218,107,111,43.98,51,26,59,47,35
Donegal,155,81,74,59.49,22,14,35,49,35
Donegal,147,83,64,6.19,25,17,37,49,19
Donegal,148,83,65,18.74,18,32,21,57,20
Donegal,179,91,88,2.1,45,17,37,43,37
Donegal,190,98,92,25.95,37,25,57,49,22
Donegal,235,120,115,30.35,72,23,75,41,24
Donegal,246,127,119,7.72,48,28,54,70,46
Donegal,177,88,89,26.12,45,20,39,37,36
Donegal,183,86,97,233.09,26,11,45,51,50
Donegal,189,93,96,82.19,40,32,38,53,26
Donegal,223,108,115,372.78,33,17,51,71,51
Donegal,215,103,112,185.38,61,28,71,38,17
Donegal,121,63,58,4.96,25,10,29,28,29
Donegal,291,148,143,7.45,70,38,68,65,50
Donegal,364,162,202,2352.59,72,50,85,85,72
Donegal,273,129,144,815.94,72,29,92,53,27
Donegal,349,165,184,147.02,104,53,95,62,35
Donegal,371,196,175,8.76,92,50,80,106,43
Donegal,191,91,100,125.06,28,34,32,68,29
Donegal,282,150,132,12,52,30,73,68,59
Donegal,174,89,85,106.83,32,24,42,50,26
Donegal,160,80,80,32.63,47,11,54,24,24
Donegal,218,114,104,17.7,41,22,51,52,52
Donegal,178,90,88,78.33,34,24,33,52,35
Donegal,145,67,78,97.27,28,19,39,35,24
Donegal,122,59,63,191.41,20,15,34,37,16
Donegal,249,122,127,63.66,75,19,92,48,15
Donegal,237,118,119,70.09,72,31,56,64,14
Donegal,265,129,136,59.86,72,43,77,53,20
Donegal,215,110,105,920.07,24,26,68,69,28
Donegal,208,104,104,284.24,55,23,84,35,11
Donegal,181,106,75,2.23,26,13,39,45,58
Donegal,172,83,89,22.6,45,15,40,42,30
Donegal,82,36,46,31.54,11,8,15,31,17
Donegal,98,43,55,142.74,24,16,26,18,14
Donegal,224,108,116,220.33,61,27,78,41,17
Donegal,187,102,85,59.41,47,19,58,41,22
Donegal,167,93,74,17.65,24,24,37,43,39
Donegal,76,42,34,2.98,18,10,17,19,12
Donegal,240,119,121,15.15,57,31,59,70,23
Donegal,276,131,145,141.35,85,29,98,48,16
Donegal,309,160,149,26.02,76,33,90,73,37
Donegal,272,139,133,7.78,78,40,60,62,32
Donegal,200,110,90,25.48,46,29,49,53,23
Donegal,248,113,135,41.04,66,26,72,51,33
Donegal,152,72,80,10.52,27,20,46,43,16
Donegal,163,84,79,46.93,37,14,44,45,23
Donegal,220,114,106,66.74,54,22,63,60,21
Donegal,232,119,113,77.78,34,25,53,70,50
Donegal,99,60,39,38.18,15,12,21,39,12
Donegal,174,83,91,63.71,45,11,52,48,18
Donegal,145,74,71,28.21,31,11,53,36,14
Donegal,155,73,82,29.45,40,14,41,26,34
Donegal,113,56,57,144.38,18,11,28,35,21
Donegal,428,220,208,24.72,133,44,137,93,21
Donegal,290,154,136,46.41,68,39,104,48,31
Donegal,271,138,133,137.76,56,50,69,73,23
Donegal,272,146,126,3160.44,82,12,146,32,0
Donegal,215,113,102,3203.36,56,23,98,34,4
Donegal,306,151,155,94.08,91,23,121,44,27
Donegal,282,149,133,168.49,66,29,117,55,15
Donegal,139,71,68,557.64,26,16,35,37,25
Donegal,234,119,115,4466.93,87,30,90,27,0
Donegal,166,92,74,490.71,33,20,46,49,18
Donegal,340,180,160,82.56,101,33,108,75,23
Donegal,411,209,202,36.14,92,55,135,93,36
Donegal,235,119,116,729.01,55,24,72,59,25
Donegal,202,109,93,27.81,40,19,71,51,21
Donegal,272,132,140,32.61,78,26,90,52,26
Donegal,188,95,93,48.25,48,24,46,39,31
Donegal,264,123,141,93.75,55,36,53,64,56
Donegal,174,86,88,33.37,34,26,47,45,22
Donegal,210,99,111,21.14,59,32,55,49,15
Donegal,302,155,147,224.65,86,30,100,67,19
Donegal,189,85,104,1945.59,21,19,44,67,38
Donegal,313,153,160,550.2,68,51,90,89,15
Donegal,269,141,128,228.01,55,31,81,68,34
Donegal,150,72,78,563.2,18,15,35,40,42
Donegal,127,59,68,1029.76,6,12,26,33,50
Donegal,103,60,43,8.25,20,11,27,30,15
Donegal,194,95,99,34.48,30,24,42,66,32
Donegal,300,153,147,31.88,90,27,87,64,32
Donegal,200,98,102,37.57,48,18,49,60,25
Donegal,250,126,124,180.92,44,39,61,79,27
Donegal,193,100,93,505.97,64,22,72,23,12
Donegal,215,110,105,28.09,62,28,60,35,30
Donegal,258,142,116,14.14,65,25,79,63,26
Donegal,264,132,132,81.99,70,33,62,63,36
Donegal,257,137,120,43.15,106,15,81,33,22
Donegal,213,106,107,59.19,71,24,69,38,11
Donegal,190,82,108,667.06,57,24,65,24,20
Donegal,221,110,111,49.41,57,40,53,51,20
Donegal,146,69,77,256.66,37,20,42,37,10
Donegal,141,74,67,1496.58,14,16,28,42,41
Donegal,263,128,135,42.77,62,34,75,67,25
Donegal,279,142,137,23.76,86,28,96,53,16
Donegal,257,131,126,44.19,63,34,72,51,37
Donegal,220,110,110,29.19,60,21,71,40,28
Donegal,356,173,183,18.59,88,53,96,85,34
Donegal,363,187,176,167.3,88,47,98,93,37
Donegal,252,135,117,133.52,50,45,52,80,25
Donegal,200,93,107,1109.4,61,23,91,20,5
Donegal,230,105,125,1178.04,71,23,89,34,13
Donegal,195,100,95,811.8,48,23,75,34,15
Donegal,200,103,97,260.62,67,20,81,24,8
Donegal,145,82,63,21.13,35,16,41,30,23
Donegal,146,77,69,13.61,23,12,27,46,38
Donegal,312,164,148,8.86,69,32,95,72,44
Donegal,281,130,151,104.34,74,35,73,57,42
Donegal,189,96,93,51.47,34,17,45,58,35
Donegal,165,98,67,13.02,34,22,32,57,20
Donegal,279,123,156,293.34,85,24,143,19,8
Donegal,140,70,70,3040.37,9,23,26,36,46
Donegal,172,89,83,5479.8,23,33,64,39,13
Donegal,285,134,151,4042.32,82,29,152,19,3
Donegal,315,150,165,1238.02,68,41,128,55,23
Donegal,221,105,116,3478.23,72,26,108,15,0
Donegal,191,97,94,233.4,8,29,44,62,48
Donegal,177,78,99,2121.36,23,44,45,43,22
Donegal,296,135,161,156.64,43,41,55,95,62
Donegal,244,122,122,1939.57,36,37,47,58,66
Donegal,220,102,118,685.45,42,36,67,57,18
Donegal,250,109,141,2835.01,30,50,68,88,14
Donegal,181,87,94,3730.5,41,42,46,44,8
Donegal,217,109,108,1481.73,22,34,44,52,65
Donegal,202,99,103,2162.51,22,35,71,20,54
Donegal,210,97,113,2375.75,58,29,96,26,1
Donegal,200,86,114,745.36,45,30,102,16,7
Donegal,269,132,137,1325.07,75,63,91,37,3
Donegal,235,100,135,536.21,96,35,70,26,8
Donegal,238,118,120,233.49,57,32,75,56,18
Donegal,248,130,118,1218.96,50,37,90,43,28
Donegal,182,80,102,860.87,12,73,35,41,21
Donegal,124,58,66,1711.19,26,22,42,27,7
Donegal,238,105,133,671.51,36,55,75,47,25
Donegal,196,93,103,2856.43,41,29,72,38,16
Donegal,251,123,128,3101.91,60,24,145,18,4
Donegal,241,112,129,2217.91,83,28,100,22,8
Donegal,328,153,175,1299.11,87,46,128,58,9
Donegal,329,140,189,476.43,123,24,142,33,7
Donegal,210,93,117,2068.78,62,24,79,42,3
Donegal,318,158,160,2241.06,75,48,129,46,20
Donegal,245,130,115,2527.75,81,23,99,38,4
Donegal,233,102,131,1852.6,52,46,55,71,9
Donegal,199,94,105,2770.55,67,16,86,23,7
Donegal,185,85,100,2491.85,33,22,57,41,32
Donegal,207,94,113,624.88,35,11,33,51,77
Donegal,306,156,150,684.59,32,36,92,104,42
Donegal,309,159,150,2960.96,99,51,107,44,8
Donegal,525,241,284,1569.36,75,56,109,136,149
Donegal,383,184,199,5095.93,143,58,115,57,10
Donegal,303,154,149,3987.84,97,38,111,44,13
Donegal,189,89,100,309.11,19,81,33,38,18
Donegal,199,102,97,2601.61,46,36,40,61,16
Donegal,256,121,135,288.06,89,25,98,38,6
Donegal,261,136,125,1016.52,79,23,143,13,3
Donegal,228,109,119,709.5,44,34,73,56,21
Donegal,133,71,62,226.55,7,47,54,22,3
Donegal,132,61,71,667.49,10,10,29,37,46
Donegal,242,121,121,4370.6,51,61,66,57,7
Donegal,201,98,103,1846.17,14,22,49,71,45
Donegal,192,91,101,2989.35,15,32,46,58,41
Donegal,155,78,77,925.65,16,24,44,35,36
Donegal,115,56,59,1168.06,9,32,36,21,17
Donegal,136,72,64,1482.42,10,44,53,20,9
Donegal,191,101,90,3508.58,26,69,73,14,9
Donegal,96,51,45,3149.92,12,19,39,17,9
Donegal,115,61,54,4600.92,17,21,40,22,15
Donegal,82,41,41,9.2,15,4,16,20,27
Donegal,143,71,72,23.27,35,18,33,32,25
Donegal,134,65,69,7.31,30,7,30,27,40
Donegal,175,81,94,39.18,21,28,35,65,26
Donegal,412,219,193,10.54,95,44,134,86,53
Donegal,245,128,117,4.61,38,12,74,77,44
Donegal,314,164,150,12.98,85,40,89,67,33
Donegal,175,90,85,11.91,45,24,37,43,26
Donegal,419,205,214,108.97,101,53,101,101,63
Donegal,312,163,149,27.67,89,41,91,59,32
Donegal,259,131,128,69.12,66,42,68,64,19
Donegal,425,210,215,100.05,97,65,112,97,54
Donegal,233,123,110,5.67,57,20,73,44,39
Donegal,140,65,75,6.43,20,19,32,46,23
Donegal,182,99,83,90.53,37,17,48,49,31
Donegal,148,80,68,124.94,23,12,31,35,47
Donegal,171,89,82,15.12,38,14,36,45,38
Donegal,187,87,100,67.21,30,26,38,50,43
Donegal,212,106,106,106.77,50,7,71,41,43
Donegal,232,118,114,167.01,41,27,57,56,51
Donegal,211,104,107,151.44,31,23,61,50,46
Donegal,184,89,95,94.94,37,25,41,48,33
Donegal,253,123,130,64.16,46,42,51,72,42
Donegal,181,97,84,134.25,33,29,33,57,29
Donegal,331,153,178,120.02,69,31,64,78,89
Donegal,124,64,60,286.18,28,12,32,31,21
Donegal,134,71,63,52.17,35,12,30,42,15
Donegal,124,65,59,13.35,23,14,27,32,28
Donegal,126,62,64,27.99,30,16,33,21,26
Donegal,108,60,48,12.74,31,7,22,23,25
Donegal,128,66,62,9.64,25,15,24,38,26
Donegal,97,48,49,14.71,11,13,23,17,33
Donegal,155,76,79,102.17,34,14,35,55,17
Donegal,248,115,133,49.93,65,27,79,49,28
Donegal,181,91,90,12.17,36,19,42,48,36
Donegal,253,142,111,164.34,64,35,91,47,16
Donegal,283,141,142,1077.77,93,41,92,47,10
Donegal,360,191,169,56.22,114,43,96,84,23
Donegal,275,144,131,32.57,47,38,71,63,56
Donegal,178,88,90,81.77,50,11,46,40,31
Donegal,152,77,75,110.98,31,4,41,38,38
Donegal,151,86,65,35.24,17,20,38,57,19
Donegal,195,104,91,41.06,34,34,49,48,30
Donegal,210,107,103,53.43,50,18,64,51,27
Donegal,110,58,52,13.99,17,11,25,27,30
Donegal,195,116,79,22.37,51,23,52,41,28
Donegal,221,110,111,28.52,56,25,65,42,33
Donegal,111,60,51,3.61,26,12,28,29,16
Donegal,239,120,119,18.58,56,20,63,58,42
Donegal,295,149,146,266.46,87,34,85,51,38
Donegal,235,117,118,132.08,66,28,76,46,19
Donegal,179,80,99,281.47,42,30,53,29,25
Donegal,160,83,77,156.73,33,18,37,38,34
Donegal,348,182,166,43.52,91,51,90,85,31
Donegal,219,111,108,73.33,72,22,64,48,13
Donegal,342,173,169,17.44,93,63,88,70,28
Donegal,173,90,83,36.85,41,15,37,39,41
Donegal,195,104,91,106.22,45,23,57,40,30
Donegal,181,102,79,96.09,33,35,46,46,21
Donegal,244,124,120,68.65,65,31,70,55,23
Donegal,366,179,187,83.17,109,39,119,75,24
Donegal,111,53,58,1017.89,37,15,38,16,5
Donegal,196,94,102,3848.12,29,24,44,61,38
Donegal,172,87,85,233.72,28,31,31,61,21
Donegal,242,117,125,693.78,45,33,65,39,60
Donegal,102,50,52,1415.33,7,5,20,34,36
Donegal,128,64,64,2186.61,8,32,30,38,20
Donegal,125,59,66,304.58,30,17,24,38,16
Donegal,108,52,56,579.49,20,11,24,23,30
Donegal,211,116,95,9.03,44,21,58,56,32
Donegal,192,96,96,37.34,45,24,50,47,26
Donegal,287,142,145,32.88,74,35,82,66,30
Donegal,309,151,158,313.13,90,28,115,42,34
Donegal,192,91,101,37.03,43,19,57,52,21
Donegal,246,131,115,5.06,50,24,73,48,51
Donegal,150,78,72,291.46,22,14,34,33,47
Donegal,255,123,132,1107.37,75,30,86,35,29
Donegal,233,117,116,39.38,59,35,52,53,34
Donegal,259,141,118,40.09,55,41,74,67,22
Donegal,201,94,107,3821.58,16,29,50,66,40
Donegal,210,106,104,448.81,45,34,59,58,14
Donegal,113,63,50,180.02,13,17,27,24,32
Donegal,281,124,157,841.07,88,28,75,50,40
Donegal,311,155,156,38.01,85,41,98,53,34
Donegal,251,132,119,23.47,52,28,65,61,45
Donegal,276,123,153,310.71,90,36,91,45,14
Donegal,208,108,100,349.96,34,32,75,47,20
Donegal,177,89,88,153.06,42,13,62,33,27
Donegal,185,86,99,653.34,36,21,51,43,34
Donegal,228,108,120,284.87,49,32,59,62,26
Donegal,216,112,104,917.79,19,25,36,68,68
Donegal,262,131,131,29.58,65,38,63,71,25
Donegal,120,60,60,15.23,18,7,36,33,26
Donegal,118,56,62,922.65,12,21,27,28,30
Donegal,203,107,96,25.84,40,31,57,54,21
Donegal,127,61,66,93.13,17,9,34,39,28
Donegal,311,165,146,28.21,73,38,108,62,30
Donegal,292,157,135,25.82,55,41,78,84,34
Donegal,292,150,142,40.59,95,30,77,62,28
Donegal,96,45,51,17.44,17,12,29,21,17
Donegal,151,76,75,57.69,34,17,25,36,39
Donegal,108,52,56,84.85,34,8,30,19,17
Donegal,94,44,50,117.93,13,6,26,35,14
Donegal,126,62,64,78.12,34,29,26,30,7
Donegal,109,55,54,474.9,21,10,25,30,23
Donegal,215,104,111,79.98,35,28,47,77,28
Donegal,179,87,92,92.25,32,17,40,54,36
Donegal,86,37,49,12.26,19,6,20,22,19
Donegal,117,63,54,17.86,30,9,33,26,19
Donegal,104,54,50,25.63,19,13,19,25,28
Donegal,184,86,98,45.05,38,21,41,52,32
Donegal,123,58,65,60.47,20,6,25,39,33
Donegal,187,74,113,89.64,41,18,51,46,31
Donegal,127,63,64,140.14,22,22,16,46,21
Donegal,120,62,58,46.24,18,12,34,32,24
Donegal,140,67,73,109.59,36,9,38,31,26
Donegal,106,54,52,4.41,16,18,27,31,14
Donegal,248,123,125,25.72,45,39,71,67,26
Donegal,274,137,137,479.63,56,56,67,61,34
Donegal,230,117,113,30.43,47,33,68,56,26
Donegal,278,147,131,60.41,80,25,96,51,26
Donegal,238,104,134,317.77,71,35,85,38,9
Donegal,136,68,68,361.09,24,22,37,29,24
Donegal,241,126,115,44.34,51,30,51,61,48
Donegal,267,144,123,37.01,76,37,66,53,35
Donegal,268,127,141,423.35,64,38,57,70,39
Donegal,228,119,109,17.77,51,43,55,56,23
Donegal,374,191,183,39.38,92,55,89,74,64
Donegal,209,106,103,18.19,55,20,62,53,19
Donegal,231,109,122,2632.24,70,17,80,38,26
Donegal,241,117,124,41.6,80,26,81,30,24
Donegal,172,82,90,1168.18,27,24,49,42,30
Donegal,255,121,134,27.7,72,27,69,59,28
Donegal,166,86,80,53.1,28,19,28,53,38
Donegal,193,88,105,2391.04,65,21,81,18,8
Donegal,186,89,97,766.26,76,17,72,20,1
Donegal,84,44,40,380.04,8,12,21,24,19
Donegal,166,78,88,1469.21,37,19,54,33,23
Donegal,174,93,81,632.62,31,22,58,41,22
Donegal,215,108,107,929.22,58,27,62,36,32
Donegal,251,114,137,474.23,50,31,70,61,39
Donegal,185,95,90,127.93,45,26,57,42,15
Donegal,264,130,134,1156.98,46,52,71,52,43
Donegal,413,190,223,66.55,90,30,98,87,108
Donegal,291,144,147,570.43,83,41,92,58,17
Donegal,247,131,116,3917.22,23,27,55,89,53
Donegal,197,86,111,286.91,15,18,41,59,64
Donegal,180,82,98,539.71,14,22,43,69,32
Donegal,216,103,113,652.46,28,35,49,70,34
Donegal,149,81,68,37.59,33,15,32,46,23
Donegal,129,70,59,49.78,19,12,21,42,35
Donegal,150,78,72,32.85,26,22,39,39,24
Donegal,203,97,106,134.57,47,27,58,50,21
Donegal,180,98,82,42.18,41,18,56,42,23
Donegal,165,88,77,20.35,25,21,54,44,21
Donegal,179,82,97,127.64,47,17,57,35,23
Donegal,325,171,154,94.99,84,36,98,73,34
Donegal,114,57,57,294.04,21,4,36,27,26
Donegal,305,158,147,8.94,69,30,84,74,48
Donegal,128,71,57,1.6,20,19,27,38,24
Donegal,228,109,119,20.05,67,21,62,59,19
Donegal,227,116,111,35.49,60,24,79,52,12
Donegal,195,104,91,19.41,43,28,48,55,21
Donegal,299,158,141,32.17,84,40,102,53,20
Donegal,230,114,116,17.15,55,29,67,41,38
Donegal,262,144,118,8.33,63,34,79,49,37
Donegal,262,123,139,21.13,67,27,72,59,37
Donegal,193,94,99,41.9,58,12,52,46,25
Donegal,269,138,131,23.48,71,27,83,66,22
Donegal,114,64,50,5.4,20,15,29,33,17
Donegal,274,137,137,22.42,78,22,96,49,29
Donegal,278,146,132,40.69,66,29,100,57,26
Donegal,212,108,104,31.4,43,29,62,58,20
Donegal,217,111,106,9.32,59,21,62,50,25
Donegal,170,84,86,28.46,38,22,46,42,22
Donegal,151,78,73,11.52,21,20,33,39,38
Donegal,161,75,86,12.6,15,21,34,53,38
Donegal,315,166,149,25.58,83,47,99,55,31
Donegal,303,155,148,43.14,70,36,91,66,40
Donegal,269,136,133,29.26,70,30,77,61,31
Donegal,308,142,166,316.23,91,41,83,65,28
Donegal,169,85,84,12.74,30,23,35,51,30
Donegal,332,172,160,59.41,92,45,102,68,25
Galway,300,154,146,22.98,62,42,78,76,42
Galway,370,179,191,42.18,64,47,86,82,91
Galway,301,164,137,43.25,75,32,90,68,36
Galway,157,78,79,70.01,31,21,72,25,8
Galway,252,132,120,36.57,58,22,96,44,32
Galway,231,114,117,17.47,55,29,65,60,22
Galway,185,96,89,13.79,30,22,53,51,29
Galway,280,132,148,14.88,63,21,61,88,47
Galway,159,88,71,18.19,19,25,38,48,29
Galway,184,99,85,18.2,36,24,43,53,28
Galway,207,102,105,34.18,45,23,52,56,31
Galway,215,111,104,138.58,46,37,54,41,37
Galway,184,94,90,8.36,34,25,47,56,22
Galway,238,128,110,24.09,54,28,65,57,34
Galway,178,95,83,6.48,40,24,46,35,33
Galway,211,116,95,41.06,29,47,37,77,21
Galway,183,90,93,19.48,42,22,48,44,27
Galway,192,105,87,14.05,41,22,47,49,33
Galway,345,186,159,65.36,87,39,126,58,35
Galway,279,150,129,25.49,65,27,85,72,30
Galway,287,161,126,90.51,80,29,82,72,24
Galway,220,119,101,13.15,53,24,65,51,27
Galway,225,115,110,41,48,42,44,68,23
Galway,265,137,128,136.91,42,49,62,93,19
Galway,239,128,111,56.24,56,22,87,56,18
Galway,251,130,121,103.85,66,31,73,60,21
Galway,460,233,227,84.93,122,39,160,91,48
Galway,293,152,141,42.21,67,30,86,78,32
Galway,377,192,185,48.99,87,68,91,104,27
Galway,215,115,100,12.85,35,20,71,55,34
Galway,200,106,94,13.09,42,26,52,56,24
Galway,172,95,77,17.52,42,20,48,43,19
Galway,374,203,171,71.27,87,36,97,75,79
Galway,166,79,87,36.57,30,19,43,44,30
Galway,431,202,229,53.69,88,43,140,88,72
Galway,206,93,113,2653.31,63,16,105,21,1
Galway,285,131,154,4193.03,76,23,137,31,18
Galway,338,161,177,1518.43,102,17,162,28,29
Galway,273,135,138,3621.84,65,54,74,63,17
Galway,268,124,144,769.07,82,14,117,39,16
Galway,226,116,110,3064.12,57,19,63,57,30
Galway,162,79,83,715.2,21,21,77,23,20
Galway,308,143,165,1168.58,112,22,111,41,22
Galway,242,119,123,831.86,38,24,105,42,33
Galway,350,184,166,1332.82,86,24,171,49,20
Galway,290,143,147,67.43,69,46,115,45,15
Galway,214,103,111,62.38,61,16,77,41,19
Galway,258,141,117,45.49,88,21,75,45,29
Galway,167,80,87,391.28,29,33,47,37,21
Galway,134,70,64,3343.23,29,9,83,8,5
Galway,200,98,102,3657.11,55,23,93,21,8
Galway,173,85,88,3531.84,56,6,94,13,4
Galway,134,72,62,1651.32,17,15,40,41,21
Galway,169,84,85,114.76,24,19,48,40,38
Galway,286,148,138,48.42,81,34,82,59,30
Galway,231,126,105,28.34,66,20,80,48,17
Galway,213,110,103,27.91,52,16,65,50,30
Galway,259,134,125,50.32,62,34,67,74,22
Galway,226,119,107,33.68,71,18,79,36,22
Galway,310,150,160,39.94,68,44,64,71,63
Galway,285,153,132,16.74,50,37,56,95,47
Galway,305,146,159,50.17,54,58,38,106,49
Galway,294,155,139,22.67,56,39,96,67,36
Galway,205,103,102,127.37,51,23,69,43,19
Galway,186,100,86,3839.01,30,15,46,61,34
Galway,429,173,256,1541,67,38,82,104,138
Galway,268,137,131,1803.16,105,28,117,16,2
Galway,193,81,112,3450.99,36,29,59,52,17
Galway,181,80,101,540.59,36,18,40,42,45
Galway,413,214,199,125.33,115,44,156,63,35
Galway,247,128,119,6578.07,53,27,119,39,9
Galway,347,161,186,281.05,64,38,79,79,87
Galway,211,111,100,4154.85,65,32,59,41,14
Galway,237,118,119,536.64,68,34,60,45,30
Galway,173,76,97,1469.79,14,17,32,61,49
Galway,186,83,103,1799.73,57,14,82,24,9
Galway,191,88,103,1748.54,43,27,47,51,23
Galway,207,96,111,521.24,56,28,57,39,27
Galway,226,123,103,274.8,14,20,51,65,76
Galway,182,85,97,52.53,32,18,34,57,41
Galway,123,72,51,344.58,20,15,52,27,9
Galway,89,47,42,470.32,10,18,38,14,9
Galway,274,137,137,5585.79,92,34,82,48,18
Galway,207,100,107,6163.47,48,30,54,51,24
Galway,81,37,44,2137.2,18,13,28,10,12
Galway,162,88,74,2022.52,13,18,51,47,33
Galway,134,73,61,2114.77,11,13,53,31,26
Galway,281,146,135,226.04,33,27,51,78,92
Galway,440,235,205,215.55,92,53,93,127,75
Galway,196,96,100,1657.08,47,18,75,43,13
Galway,201,90,111,739.13,68,22,72,29,10
Galway,179,83,96,3251.47,48,15,58,38,20
Galway,324,161,163,19.37,66,26,82,91,59
Galway,304,140,164,27.1,84,27,98,69,26
Galway,164,86,78,93.24,42,12,53,43,14
Galway,265,141,124,43.73,73,21,84,66,21
Galway,440,211,229,49.97,143,41,111,98,47
Galway,291,155,136,65.58,64,27,83,79,38
Galway,283,145,138,70.16,52,48,62,95,26
Galway,240,120,120,64.78,51,28,61,65,35
Galway,304,155,149,111.4,56,54,76,87,31
Galway,344,170,174,1828.57,97,24,188,32,3
Galway,222,118,104,7.41,50,29,51,63,29
Galway,162,81,81,11.48,27,20,30,55,30
Galway,315,173,142,18.02,57,45,84,79,50
Galway,132,67,65,25.4,24,13,33,44,18
Galway,267,131,136,16.09,57,32,56,74,48
Galway,218,107,111,125.71,44,46,30,80,18
Galway,299,145,154,86.55,66,52,55,98,28
Galway,307,155,152,84.07,73,44,73,96,21
Galway,195,101,94,8.36,37,27,39,54,38
Galway,282,144,138,18.34,48,28,70,81,55
Galway,310,153,157,16.97,75,34,82,74,45
Galway,253,172,81,11.25,29,96,57,51,20
Galway,157,84,73,10.77,30,20,40,48,19
Galway,144,72,72,15.27,17,24,36,42,25
Galway,275,139,136,13.48,47,45,62,76,45
Galway,262,119,143,47.96,57,12,71,53,69
Galway,258,143,115,93.47,75,25,79,62,17
Galway,232,119,113,34.04,69,18,83,42,20
Galway,238,125,113,42.99,59,26,77,62,14
Galway,361,179,182,57.11,100,45,94,85,37
Galway,349,173,176,311.77,96,46,77,104,26
Galway,341,169,172,3486.39,114,17,146,58,6
Galway,256,130,126,247.74,45,53,30,92,36
Galway,257,129,128,287.23,58,45,49,74,31
Galway,334,168,166,163.38,100,29,87,69,49
Galway,148,71,77,237.25,33,12,29,44,30
Galway,295,134,161,4509.6,82,10,161,28,14
Galway,260,135,125,445.26,54,18,85,69,34
Galway,386,201,185,88.18,79,70,72,128,37
Galway,265,138,127,109.19,77,29,66,70,23
Galway,378,177,201,104.59,96,60,84,112,26
Galway,252,119,133,19.02,63,26,60,74,29
Galway,261,115,146,17.19,68,24,69,75,25
Galway,205,100,105,27.65,49,25,58,52,21
Galway,331,173,158,17.66,80,29,106,77,39
Galway,337,162,175,27.81,63,60,85,93,36
Galway,258,148,110,38.93,66,20,77,70,25
Galway,199,109,90,32.56,50,22,62,34,31
Galway,347,169,178,23.55,75,32,119,75,46
Galway,229,120,109,36.82,63,19,72,58,17
Galway,252,124,128,2.35,32,28,71,80,41
Galway,257,134,123,16.24,56,35,49,80,37
Galway,230,121,109,24.48,70,17,59,47,37
Galway,230,131,99,12.8,49,23,63,58,37
Galway,254,134,120,18.65,66,29,79,50,30
Galway,182,94,88,10.31,33,19,40,60,30
Galway,253,133,120,17.23,66,22,81,57,27
Galway,262,135,127,36.87,81,21,92,51,17
Galway,196,106,90,25.72,42,17,45,57,35
Galway,169,88,81,22.4,41,22,41,49,16
Galway,177,92,85,16.7,31,26,39,51,30
Galway,181,95,86,7.15,28,23,51,48,31
Galway,384,195,189,12.83,88,44,109,88,55
Galway,99,56,43,6.91,21,10,25,32,11
Galway,435,225,210,125.95,131,60,131,93,20
Galway,418,207,211,121.83,90,74,90,140,24
Galway,275,139,136,279.97,75,33,114,41,12
Galway,240,117,123,537.53,62,24,98,30,26
Galway,292,151,141,110.06,42,54,68,97,31
Galway,287,135,152,4082.16,94,16,149,25,3
Galway,284,158,126,77.49,58,40,85,69,32
Galway,378,197,181,82.27,85,64,92,115,22
Galway,299,158,141,54.04,63,56,73,92,15
Galway,212,104,108,116.3,57,20,68,40,27
Galway,407,212,195,57.52,113,53,110,91,40
Galway,236,123,113,13.4,67,22,64,45,38
Galway,209,115,94,17.2,55,28,50,44,32
Galway,214,114,100,26.93,57,27,55,46,29
Galway,243,120,123,19.23,44,28,72,60,39
Galway,302,162,140,29.02,63,40,76,83,40
Galway,224,107,117,49.78,49,28,58,55,34
Galway,309,153,156,28.45,75,42,71,78,43
Galway,241,131,110,17.28,64,30,66,61,20
Galway,246,124,122,15.8,58,17,80,48,43
Galway,278,143,135,14.73,80,33,67,63,35
Galway,255,134,121,52.37,69,24,71,69,22
Galway,319,159,160,31,103,21,121,54,20
Galway,291,142,149,50.55,64,42,86,73,26
Galway,356,182,174,106.6,82,39,113,96,26
Galway,279,116,163,86.71,61,27,49,68,74
Galway,404,208,196,135.1,96,43,128,103,34
Galway,262,143,119,22.14,68,29,83,53,29
Galway,185,90,95,2960.47,45,13,99,23,5
Galway,265,125,140,5666.15,75,18,143,28,1
Galway,341,180,161,44.08,69,48,100,91,33
Galway,341,173,168,32.25,73,42,93,87,46
Galway,350,180,170,31.73,73,36,99,90,52
Galway,184,96,88,646.59,40,6,110,20,8
Galway,248,124,124,305.15,79,4,155,7,3
Galway,281,130,151,1888.5,76,4,185,16,0
Galway,250,128,122,739.49,49,17,75,55,54
Galway,231,121,110,1942.34,57,13,138,19,4
Galway,142,78,64,573.46,15,8,95,19,5
Galway,190,97,93,44.55,47,22,43,60,18
Galway,352,185,167,83.73,102,43,85,87,35
Galway,357,187,170,63.55,79,50,90,98,40
Galway,395,208,187,77.32,105,43,109,106,32
Galway,296,144,152,66.54,68,25,67,105,31
Galway,114,49,65,43.44,15,12,30,50,7
Galway,149,76,73,8.99,29,16,34,41,29
Galway,166,86,80,27.23,32,14,45,43,32
Galway,249,125,124,14.95,47,32,75,66,29
Galway,169,79,90,68.13,21,22,35,50,41
Galway,219,113,106,589.03,38,19,67,54,41
Galway,346,162,184,568.62,109,32,99,60,46
Galway,231,101,130,1660.02,54,32,68,63,14
Galway,200,103,97,1402.33,31,23,55,43,48
Galway,276,146,130,8779.74,50,18,147,45,16
Galway,143,78,65,5218.41,17,12,67,35,12
Galway,95,52,43,1427.07,9,13,30,31,12
Galway,261,124,137,1438.21,27,17,100,67,50
Galway,199,106,93,13.09,38,28,47,50,36
Galway,197,103,94,18.77,54,32,41,51,19
Galway,301,162,139,12.95,72,31,80,83,35
Galway,252,137,115,24.21,40,26,86,65,35
Galway,225,120,105,14.16,34,31,56,72,32
Galway,232,123,109,15.14,51,40,51,54,36
Galway,212,120,92,11.79,27,25,45,69,46
Galway,199,97,102,15.95,39,20,45,61,34
Galway,274,120,154,13.24,38,78,50,69,39
Galway,180,94,86,27.42,41,23,36,58,22
Galway,86,46,40,14.53,8,13,16,22,27
Galway,359,178,181,25.98,56,27,106,115,55
Galway,310,146,164,14.64,60,32,86,74,58
Galway,198,100,98,15.53,51,20,59,43,25
Galway,231,125,106,28.46,72,15,72,41,31
Galway,240,131,109,20.49,49,27,49,42,73
Galway,220,110,110,25.24,39,19,46,54,62
Galway,120,58,62,12.12,19,13,43,32,13
Galway,228,114,114,9.36,44,17,60,85,22
Galway,169,84,85,3.04,33,14,36,51,35
Galway,164,87,77,13.5,34,9,43,47,31
Galway,317,166,151,20.02,74,42,81,76,44
Galway,225,118,107,18.66,53,27,56,55,34
Galway,111,57,54,3.12,12,18,20,39,22
Galway,308,153,155,351.87,111,22,115,48,12
Galway,302,150,152,58.8,59,39,76,83,45
Galway,301,140,161,92.13,86,25,105,66,19
Galway,249,121,128,83.76,90,24,61,59,15
Galway,236,126,110,32.08,51,41,61,61,22
Galway,244,117,127,55.41,72,28,73,49,22
Galway,201,105,96,8.74,39,27,46,53,36
Galway,166,82,84,15.47,27,25,36,47,31
Galway,188,106,82,63.38,31,23,50,49,35
Galway,271,132,139,181.34,58,35,71,76,31
Galway,205,98,107,277,25,25,32,51,72
Galway,185,87,98,100.14,36,21,57,39,32
Galway,137,75,62,134.17,37,13,36,30,21
Galway,123,65,58,85.57,12,14,37,44,16
Galway,154,81,73,92.34,40,15,42,32,25
Galway,231,117,114,125.33,42,33,48,76,32
Galway,222,109,113,96.8,42,29,57,61,33
Galway,152,75,77,471.67,49,12,45,36,10
Galway,196,97,99,34.2,46,19,66,39,26
Galway,315,162,153,37.13,53,55,66,77,64
Galway,271,125,146,77.25,64,25,91,62,29
Galway,239,118,121,400.81,77,11,111,31,9
Galway,254,127,127,85.73,82,27,73,39,33
Galway,155,77,78,3.4,14,18,38,51,34
Galway,158,84,74,7.71,32,20,37,47,22
Galway,351,185,166,89.77,91,40,121,74,25
Galway,286,156,130,63.51,73,37,84,67,25
Galway,245,125,120,67.77,55,24,83,66,17
Galway,432,239,193,66.86,103,33,159,100,37
Galway,166,86,80,10.97,35,19,47,40,25
Galway,179,85,94,28.34,34,21,44,52,28
Galway,204,105,99,50.5,47,30,56,49,22
Galway,247,127,120,29.48,56,19,76,60,36
Galway,237,122,115,25.02,56,25,74,54,28
Galway,108,56,52,2.64,28,7,28,31,14
Galway,338,170,168,38.91,87,45,89,86,31
Galway,225,117,108,30.13,45,30,63,59,28
Galway,163,84,79,30.9,54,7,53,22,27
Galway,196,110,86,14.79,45,26,58,42,25
Galway,221,110,111,19.96,44,32,51,56,38
Galway,189,87,102,100.1,44,21,48,64,12
Galway,195,99,96,70.77,49,17,59,56,14
Galway,207,105,102,51.91,40,26,54,64,23
Galway,262,133,129,57.12,71,22,81,59,29
Galway,257,128,129,172.65,88,12,93,50,14
Galway,237,117,120,54.3,48,39,48,55,47
Galway,189,92,97,21.14,38,25,46,52,28
Galway,223,128,95,29.95,34,40,50,75,24
Galway,161,84,77,20.92,35,9,54,34,29
Galway,200,105,95,9.65,34,17,58,59,32
Galway,169,89,80,9.3,38,19,45,38,29
Galway,362,189,173,22.95,63,55,93,103,48
Galway,235,125,110,24.5,43,35,53,60,44
Galway,222,118,104,294.45,58,26,75,41,22
Galway,352,188,164,27.91,75,44,75,98,60
Galway,114,54,60,1076.77,11,10,35,28,30
Galway,124,54,70,155.81,33,14,24,30,23
Galway,114,58,56,8.82,11,14,21,43,25
Galway,115,51,64,15.02,19,6,28,27,35
Galway,289,142,147,16.88,54,35,77,78,45
Galway,165,70,95,347.31,24,16,34,40,51
Galway,219,103,116,18.48,50,16,69,55,29
Galway,164,80,84,21.33,35,18,44,35,32
Galway,208,117,91,16.31,40,22,54,54,38
Galway,284,134,150,112.99,53,49,55,88,39
Galway,282,142,140,260.86,77,33,75,67,30
Galway,154,81,73,132.43,30,21,39,49,15
Galway,247,121,126,13.87,68,20,88,46,25
Galway,183,101,82,66.02,42,22,53,49,17
Galway,162,86,76,68.01,33,20,45,46,18
Galway,126,66,60,11.8,27,12,31,39,17
Galway,224,106,118,388.23,44,30,64,55,31
Galway,172,85,87,12.6,28,21,39,58,26
Galway,208,99,109,23.87,39,28,47,61,33
Galway,263,127,136,30.99,53,32,73,59,46
Galway,232,110,122,5814.39,55,30,75,45,27
Galway,185,80,105,2927.12,43,27,64,33,18
Galway,191,105,86,4157.42,50,24,91,22,4
Galway,198,90,108,1228.55,55,23,79,25,16
Galway,158,73,85,1446.67,22,21,49,34,32
Galway,205,100,105,2257.34,32,31,96,27,19
Galway,208,113,95,64.3,33,25,68,51,31
Galway,270,134,136,2343.59,48,28,86,58,50
Galway,276,127,149,235.61,51,35,76,72,42
Galway,289,153,136,264.87,86,28,125,34,16
Galway,238,121,117,114.39,45,20,92,54,27
Galway,221,107,114,73.52,34,27,50,57,53
Galway,319,161,158,31.08,54,46,84,90,45
Galway,242,127,115,62.59,59,36,67,54,26
Galway,193,92,101,70.12,37,30,35,66,25
Galway,304,155,149,38.82,57,39,54,103,51
Galway,393,194,199,30.72,116,35,131,88,23
Galway,305,150,155,25.38,62,47,78,75,43
Galway,251,131,120,25.2,73,28,70,39,41
Galway,183,99,84,13.58,42,24,43,48,26
Galway,386,191,195,60.37,124,26,124,59,53
Galway,232,128,104,40.82,58,27,76,48,23
Galway,302,150,152,27.23,64,41,76,91,30
Galway,301,167,134,37.13,67,35,77,79,43
Galway,208,97,111,1203.86,33,30,73,44,28
Galway,182,87,95,791.02,54,22,66,30,10
Galway,166,79,87,378.68,30,22,39,50,25
Galway,248,134,114,69.79,57,38,76,51,26
Galway,184,83,101,252.03,39,8,81,34,22
Galway,200,89,111,29.52,34,27,38,69,32
Galway,314,160,154,51.92,81,50,83,71,29
Galway,378,191,187,21.72,79,54,104,92,49
Galway,103,63,40,2.83,23,7,30,27,16
Galway,157,79,78,16.34,18,13,19,67,40
Galway,158,78,80,21.46,26,10,42,46,34
Galway,159,75,84,23.32,30,25,34,53,17
Galway,301,162,139,124.56,37,60,82,88,34
Galway,249,135,114,41.7,41,19,56,87,46
Galway,286,154,132,14.5,67,37,51,90,41
Galway,387,200,187,16.59,86,54,73,120,54
Galway,318,164,154,17.36,83,38,75,97,25
Galway,189,112,77,29.7,47,17,58,39,28
Galway,187,95,92,24.25,36,23,47,53,28
Galway,312,152,160,13.26,73,35,71,79,54
Galway,221,109,112,46.42,70,14,75,42,20
Galway,229,114,115,46.03,58,25,63,53,30
Galway,205,102,103,34.73,60,18,62,44,21
Galway,304,159,145,23.24,66,34,101,69,34
Galway,223,114,109,34.9,65,15,75,40,28
Galway,297,154,143,15.56,71,17,85,75,49
Galway,373,180,193,39,73,43,74,100,83
Galway,334,165,169,28.56,82,37,102,78,35
Galway,285,147,138,34.5,77,25,91,58,34
Galway,206,102,104,104.94,44,35,60,45,22
Galway,156,79,77,13.95,26,17,35,42,36
Galway,199,96,103,22.51,56,27,48,35,33
Galway,162,89,73,2.69,34,16,47,43,22
Galway,308,173,135,11.91,53,27,84,88,56
Galway,166,98,68,25.14,25,23,45,50,23
Galway,243,125,118,26.71,56,36,60,62,29
Galway,169,91,78,54.04,37,15,54,39,24
Galway,221,110,111,32.99,48,32,51,71,19
Galway,254,130,124,14.07,38,34,58,78,46
Galway,246,120,126,15.68,43,26,80,54,43
Galway,201,116,85,24.63,44,28,58,40,31
Galway,235,121,114,9.93,43,33,60,62,37
Galway,248,123,125,4.21,47,27,77,56,41
Galway,248,124,124,32.94,54,28,75,65,26
Galway,258,123,135,126.95,51,28,75,70,34
Galway,246,127,119,143.4,42,26,70,65,43
Galway,253,123,130,24.39,72,21,75,67,18
Galway,357,175,182,37.64,87,44,102,80,44
Galway,237,126,111,55.69,86,16,62,55,18
Galway,191,94,97,36.31,38,15,61,57,20
Galway,397,205,192,73.62,113,36,115,89,44
Galway,266,136,130,76.28,88,25,82,55,16
Galway,238,126,112,86.55,70,28,74,53,13
Galway,267,134,133,46.9,90,28,78,52,19
Galway,305,148,157,29.84,81,28,76,84,36
Galway,353,180,173,28.49,73,46,95,91,48
Galway,418,209,209,27.47,120,36,133,84,45
Galway,328,159,169,32.87,85,34,97,87,25
Galway,285,144,141,38.39,64,39,66,95,21
Galway,184,98,86,28.57,38,28,47,51,20
Galway,263,124,139,31.3,60,33,70,72,28
Galway,204,103,101,309.52,51,16,58,58,21
Galway,125,57,68,1680.18,29,21,40,16,19
Galway,234,119,115,209.46,41,46,53,43,51
Galway,129,69,60,19.27,16,12,40,34,27
Galway,186,89,97,14.95,44,16,51,50,25
Galway,218,121,97,8.59,34,29,68,56,31
Galway,193,87,106,21.29,39,28,36,67,23
Galway,175,90,85,8.95,40,19,36,49,31
Galway,165,87,78,23.31,33,22,42,47,21
Galway,262,131,131,19.99,59,37,64,55,47
Galway,170,88,82,20.2,31,16,40,47,36
Galway,266,136,130,91.54,48,24,59,63,72
Galway,331,171,160,12.57,63,41,93,78,56
Galway,200,104,96,10.98,48,13,64,49,26
Galway,229,119,110,14.81,46,34,51,75,23
Galway,299,148,151,25.09,71,33,96,67,32
Galway,266,131,135,54.69,101,11,91,45,18
Galway,253,127,126,29.95,78,14,85,49,27
Galway,279,145,134,14.49,59,43,58,73,46
Galway,415,206,209,41.06,111,58,117,88,41
Galway,196,110,86,19.5,48,14,64,46,24
Galway,240,119,121,18.81,68,30,66,63,13
Galway,294,142,152,46.66,53,41,68,71,61
Galway,318,149,169,27.72,98,51,78,68,23
Galway,190,101,89,10.05,33,34,39,63,21
Galway,248,133,115,22.67,63,12,72,58,43
Galway,166,84,82,10.57,39,11,58,39,19
Galway,241,124,117,48.64,65,12,90,53,21
Galway,251,134,117,37.94,69,25,61,76,20
Galway,170,92,78,39.18,48,6,47,42,27
Galway,245,121,124,8.09,60,20,81,46,38
Galway,218,104,114,10.83,45,15,51,60,47
Galway,281,134,147,17.76,50,55,69,72,35
Galway,350,174,176,24.21,81,44,83,104,38
Galway,349,175,174,41.14,90,37,111,75,36
Galway,385,199,186,60.99,114,30,125,89,27
Galway,306,155,151,39.53,78,31,93,79,25
Galway,318,168,150,14.5,70,42,72,87,47
Galway,325,154,171,14.46,70,44,80,91,40
Galway,225,114,111,30.5,49,25,59,61,31
Galway,169,90,79,12.72,36,24,42,39,28
Galway,236,128,108,15.69,51,26,69,47,43
Galway,333,165,168,35.76,85,38,82,87,41
Galway,174,88,86,23.13,47,12,60,32,23
Galway,368,186,182,17.77,88,46,117,90,27
Galway,83,40,43,3.88,7,12,23,24,17
Galway,313,153,160,27.08,42,46,59,99,67
Galway,218,116,102,14.84,32,47,45,62,32
Galway,350,175,175,40.11,91,51,102,80,26
Galway,352,176,176,29.93,98,31,101,65,57
Galway,198,105,93,12.42,35,25,50,49,39
Galway,303,136,167,34.09,100,27,88,59,29
Galway,170,92,78,13.87,45,12,55,44,14
Galway,183,91,92,214.71,42,12,63,44,22
Galway,192,90,102,106.81,42,29,60,40,21
Galway,105,48,57,1571.34,15,7,38,19,26
Galway,174,77,97,1629.47,36,19,53,54,12
Galway,173,85,88,30.9,32,21,38,53,29
Galway,301,148,153,34.65,51,34,67,72,77
Galway,224,111,113,12.96,40,21,52,73,38
Galway,155,72,83,34.24,39,19,31,49,17
Galway,161,81,80,6.31,22,25,28,54,32
Galway,416,210,206,55.6,110,40,135,91,40
Galway,268,143,125,88.42,65,25,84,59,35
Galway,171,88,83,37.17,43,14,48,50,16
Galway,265,131,134,3812.46,94,12,132,23,4
Galway,283,141,142,59.59,86,29,92,55,21
Galway,383,190,193,30.87,137,36,113,76,21
Galway,188,99,89,9.87,29,25,49,61,24
Galway,163,87,76,65.58,21,15,48,51,28
Galway,220,108,112,27.26,62,16,58,56,28
Galway,237,114,123,25.89,58,29,73,57,20
Galway,89,47,42,3.07,11,2,23,31,22
Galway,161,81,80,5.52,14,17,56,39,35
Galway,155,80,75,1.9,22,25,45,44,19
Galway,151,78,73,17.01,15,12,40,50,34
Galway,219,103,116,53.78,46,25,49,62,37
Galway,163,79,84,32.21,23,23,38,58,21
Galway,385,209,176,94.03,78,49,103,93,62
Galway,141,72,69,99.88,27,21,37,40,16
Galway,186,100,86,16.89,37,29,52,45,23
Galway,174,88,86,18.79,46,10,55,34,29
Galway,290,151,139,87.43,62,28,96,60,44
Galway,265,135,130,37.32,68,32,67,64,34
Galway,199,103,96,89.98,57,16,80,24,22
Galway,255,140,115,112.95,60,28,60,57,50
Galway,187,97,90,55.78,41,21,45,54,26
Galway,236,115,121,75.99,39,40,64,71,22
Galway,213,113,100,53.54,50,26,63,55,19
Galway,344,177,167,35.35,95,50,97,82,20
Galway,448,228,220,119.76,141,52,130,96,29
Galway,239,131,108,10.76,52,27,57,61,42
Galway,299,136,163,34.2,62,43,84,79,31
Galway,339,164,175,33.8,88,40,69,91,51
Galway,235,118,117,27.02,64,32,56,57,26
Galway,258,126,132,838.38,52,23,70,70,43
Galway,310,153,157,1845.67,68,36,142,46,18
Galway,247,116,131,532.86,53,22,98,38,36
Galway,184,79,105,976.54,31,27,43,49,34
Galway,205,92,113,2019.47,67,31,63,31,13
Galway,172,76,96,1759.86,31,7,64,36,34
Galway,210,110,100,4863.02,48,22,65,46,29
Galway,152,70,82,2817.21,30,8,48,41,25
Galway,165,79,86,600.42,44,24,51,37,9
Galway,206,86,120,2514.1,38,37,45,57,29
Galway,210,100,110,2297.72,59,31,84,30,6
Galway,179,87,92,295.32,15,18,36,56,54
Galway,303,142,161,317.38,25,22,37,53,166
Galway,91,47,44,3627.38,4,21,30,14,22
Galway,104,55,49,246.56,8,9,24,26,37
Galway,188,92,96,6145.4,54,24,89,20,1
Galway,200,98,102,2853.72,56,14,121,9,0
Galway,173,90,83,1548.78,29,31,93,17,3
Galway,122,66,56,800.15,38,10,66,8,0
Galway,257,120,137,1056.02,61,30,137,26,3
Galway,240,107,133,3015.34,69,27,80,54,10
Galway,239,124,115,3247.9,49,36,93,49,12
Galway,222,113,109,725.25,63,14,102,27,16
Galway,101,53,48,1184.46,6,14,29,30,22
Galway,166,71,95,1297.13,26,15,56,31,38
Galway,278,149,129,10.61,70,23,72,67,46
Galway,251,119,132,12.91,50,31,57,71,42
Galway,196,98,98,196.02,38,21,74,42,21
Galway,186,101,85,24.89,30,18,55,52,31
Galway,176,95,81,15.74,54,11,44,39,28
Galway,285,131,154,76.49,48,50,65,98,24
Galway,370,179,191,21.75,94,42,93,99,42
Galway,305,157,148,57.12,61,48,56,95,45
Galway,211,101,110,1769.12,53,36,60,47,15
Galway,271,137,134,269.47,75,38,77,57,24
Galway,173,80,93,80.17,42,21,81,19,10
Galway,292,149,143,16.37,77,34,78,73,30
Galway,244,128,116,17.37,60,32,56,66,30
Galway,147,72,75,450.08,19,6,48,33,41
Galway,231,107,124,77.84,51,25,66,61,28
Galway,307,155,152,12.57,78,37,73,95,24
Galway,319,154,165,15.27,75,32,86,74,52
Galway,177,89,88,18.51,42,13,53,38,31
Galway,334,171,163,39.17,87,45,87,85,30
Galway,327,163,164,195.08,81,26,128,61,31
Galway,301,145,156,122.78,70,33,69,98,31
Galway,350,167,183,2644.1,106,40,120,76,8
Galway,216,102,114,193.16,48,25,64,57,22
Galway,285,147,138,27.24,82,41,65,67,30
Galway,195,99,96,65.32,51,31,53,50,10
Galway,379,198,181,28.77,87,47,96,89,60
Galway,299,159,140,40.44,71,38,87,70,33
Galway,254,134,120,19.29,75,15,83,50,31
Galway,83,44,39,8.93,14,3,25,27,14
Galway,141,69,72,2.75,23,15,36,42,25
Galway,250,133,117,25.78,72,25,71,56,26
Galway,185,88,97,14.14,35,31,47,41,31
Galway,215,99,116,4817.6,43,8,149,7,8
Galway,236,109,127,894.42,72,15,129,18,2
Galway,233,110,123,8393.67,37,21,154,16,5
Galway,178,94,84,2757.3,33,6,126,11,2
Galway,269,123,146,2036.31,55,26,147,32,9
Galway,268,144,124,3992.85,79,14,121,48,6
Galway,294,146,148,637.14,103,28,99,56,8
Galway,256,127,129,56.18,53,26,52,65,60
Galway,312,151,161,60.08,80,41,74,89,28
Galway,132,65,67,709.12,12,12,60,25,23
Galway,170,82,88,2103.39,28,16,56,40,30
Galway,148,76,72,7241.06,29,15,87,17,0
Galway,199,93,106,2943.7,55,21,90,18,15
Galway,275,135,140,1465.79,47,31,126,52,19
Galway,355,184,171,63.47,71,52,98,100,34
Galway,212,98,114,3522.77,68,18,79,38,9
Galway,199,102,97,4240.63,45,24,62,57,11
Galway,374,180,194,70.23,65,44,89,113,63
Galway,139,81,58,2.29,15,24,29,45,26
Galway,220,110,110,10.63,46,24,50,65,35
Galway,254,125,129,67.28,33,29,60,86,46
Galway,230,118,112,29.53,52,22,58,63,35
Galway,317,155,162,30.9,62,32,83,93,47
Galway,196,97,99,66.94,33,27,47,50,39
Galway,250,113,137,172.43,66,27,97,45,15
Galway,191,91,100,33.43,51,22,56,43,19
Galway,272,140,132,49.55,38,37,61,77,59
Galway,226,112,114,1264.94,54,29,79,45,19
Galway,159,63,96,2653.1,34,30,35,47,13
Galway,150,70,80,298.15,37,21,44,35,13
Galway,140,72,68,5.66,18,14,28,47,33
Galway,160,87,73,17.82,42,17,37,40,24
Galway,241,126,115,20.58,54,29,52,59,47
Galway,193,99,94,201.16,23,26,55,51,38
Galway,271,125,146,154.56,39,24,63,56,89
Galway,216,120,96,21.94,56,19,50,65,26
Galway,156,79,77,19.61,23,24,37,43,29
Galway,186,99,87,36.94,51,21,47,48,19
Galway,128,59,69,1522.63,19,7,47,32,23
Galway,102,57,45,1664.36,17,10,46,15,14
Galway,194,100,94,978.51,71,19,63,26,15
Galway,79,35,44,341.78,18,9,30,10,12
Galway,339,192,147,23.44,59,19,129,101,31
Galway,113,51,62,17.84,26,12,27,33,15
Galway,164,80,84,978.82,30,11,69,37,17
Galway,186,90,96,140.21,38,26,63,38,21
Galway,223,119,104,24.26,57,28,70,50,18
Galway,217,112,105,33.18,48,18,83,48,20
Galway,329,180,149,20.9,85,39,94,82,29
Galway,283,143,140,23.79,70,20,74,68,51
Galway,209,97,112,18.93,44,14,62,48,41
Galway,155,83,72,27.08,25,14,56,44,16
Galway,223,114,109,65.69,38,40,55,60,30
Galway,197,95,102,34.51,38,28,53,53,25
Galway,163,85,78,19.58,41,10,58,43,11
Galway,139,61,78,6.52,32,18,32,35,22
Galway,94,50,44,1.85,16,9,16,31,22
Galway,101,49,52,301.81,21,6,29,27,18
Galway,142,77,65,276.02,26,18,29,45,24
Galway,90,49,41,9.91,12,13,29,20,16
Galway,378,206,172,33.77,85,37,137,87,32
Galway,329,171,158,52.85,96,36,107,65,25
Galway,236,118,118,12.18,58,21,70,54,33
Galway,269,142,127,4.98,62,32,68,77,30
Galway,208,95,113,141.18,52,29,59,45,23
Galway,255,127,128,170.49,53,30,55,79,38
Galway,195,98,97,34.42,47,30,43,50,25
Galway,255,124,131,62.3,54,34,81,70,16
Galway,266,126,140,163.75,65,36,66,62,37
Galway,287,139,148,15.23,48,27,79,79,54
Galway,211,104,107,18.37,34,29,42,59,47
Galway,124,63,61,31.2,17,8,31,49,19
Galway,286,133,153,30.9,62,38,67,77,42
Galway,275,131,144,36.17,74,26,90,59,26
Galway,202,106,96,24.31,34,28,51,60,29
Galway,259,129,130,25.29,60,37,70,70,22
Galway,217,116,101,5.2,40,25,61,61,30
Galway,287,140,147,47.6,61,32,80,80,34
Galway,243,108,135,613.8,52,27,78,55,31
Galway,296,145,151,75.05,55,39,66,103,33
Galway,410,198,212,15.96,78,51,107,94,80
Galway,288,138,150,59.2,59,26,80,85,38
Galway,213,112,101,326.31,46,20,63,56,28
Galway,417,209,208,60.57,124,57,118,95,23
Galway,237,117,120,66.79,69,31,59,57,21
Galway,211,114,97,74.92,52,29,72,44,14
Galway,342,170,172,110.17,123,40,87,78,14
Galway,228,114,114,8.77,44,40,46,70,28
Galway,247,136,111,16.45,43,41,47,73,43
Galway,146,76,70,15.04,25,28,29,41,23
Galway,264,136,128,19.1,67,28,85,55,29
Galway,396,194,202,46.46,125,27,155,62,27
Galway,174,88,86,14.66,43,18,35,49,29
Galway,219,107,112,17.7,53,25,59,53,29
Galway,163,83,80,21.76,38,22,28,43,32
Galway,162,81,81,19.69,34,22,39,47,20
Galway,159,86,73,11.22,42,14,39,47,17
Galway,244,126,118,37.99,60,33,55,58,38
Galway,235,120,115,5490.4,65,16,128,21,5
Galway,212,94,118,5239.74,47,29,105,29,2
Galway,307,154,153,5229.27,84,59,85,60,19
Galway,280,139,141,4880.43,94,27,128,28,3
Galway,265,127,138,3513.05,69,31,95,40,30
Galway,182,88,94,506.21,44,21,89,25,3
Galway,241,105,136,3299.7,89,22,112,17,1
Galway,262,128,134,388.64,70,28,95,42,27
Galway,216,106,110,341.25,43,23,61,59,30
Galway,215,113,102,4071.04,50,36,68,50,11
Galway,163,87,76,901.05,31,18,30,57,27
Galway,130,61,69,15.21,36,12,47,25,10
Galway,321,150,171,45.45,78,40,66,92,45
Galway,264,135,129,1072.36,82,26,109,42,5
Galway,282,136,146,272.25,72,17,138,33,22
Galway,270,138,132,36.81,51,38,57,76,48
Galway,299,146,153,3264.98,67,27,164,32,9
Galway,145,70,75,3250.39,34,7,87,11,6
Galway,112,50,62,903.45,26,4,76,5,1
Galway,232,104,128,560.49,25,24,52,88,43
Galway,283,123,160,5994.24,71,33,59,85,35
Galway,233,110,123,7376.92,79,19,125,8,2
Galway,191,93,98,2476.05,38,20,67,33,33
Galway,181,90,91,1422.88,37,30,41,55,18
Galway,234,111,123,2374.02,64,24,97,38,11
Galway,98,46,52,1760.28,11,10,32,18,27
Galway,225,108,117,3866.11,28,24,54,59,60
Galway,134,66,68,564.67,8,12,41,34,39
Galway,189,94,95,4340.24,50,15,98,16,10
Galway,222,116,106,1320.07,49,29,59,54,31
Galway,149,70,79,1376.01,22,9,35,45,38
Galway,97,52,45,2883.21,9,15,59,12,2
Galway,215,108,107,844.83,47,16,66,48,38
Galway,196,99,97,612.96,41,20,63,50,22
Galway,196,85,111,2472.03,57,20,41,42,36
Galway,106,55,51,4401.45,8,13,50,22,13
Galway,121,48,73,1953.98,12,10,23,32,44
Galway,158,71,87,1087.69,12,10,53,41,42
Galway,137,54,83,753.94,8,12,21,21,75
Galway,117,69,48,664.04,8,15,23,39,32
Galway,105,51,54,1273.17,5,5,15,37,43
Galway,234,106,128,1265.6,61,19,79,52,23
Galway,178,86,92,2453.75,23,38,44,67,6
Galway,191,93,98,1760.66,54,15,85,29,8
Galway,466,221,245,117.77,136,60,94,116,60
Galway,231,113,118,52.84,68,33,61,54,15
Galway,246,123,123,51.92,37,29,60,63,57
Galway,208,103,105,16.35,55,16,62,60,15
Galway,231,119,112,88.31,66,30,60,59,16
Galway,116,66,50,2.33,22,7,26,38,23
Galway,142,75,67,64.13,42,20,34,23,23
Galway,236,115,121,27.68,68,19,58,57,34
Galway,206,98,108,38.87,55,18,66,31,36
Galway,300,146,154,14.95,57,38,67,86,52
Galway,193,100,93,56.14,32,19,41,57,44
Galway,326,165,161,84.26,100,43,88,81,14
Galway,293,165,128,21.11,74,37,74,75,33
Galway,263,130,133,21.01,63,32,69,74,25
Galway,319,164,155,26.91,79,30,95,77,38
Galway,357,176,181,44.76,110,42,91,77,37
Galway,403,205,198,86.46,111,45,113,100,34
Galway,354,168,186,63.68,99,31,104,100,20
Galway,249,126,123,1832.92,32,23,148,30,16
Galway,355,169,186,5021.78,90,25,198,30,12
Galway,308,129,179,10719.38,85,23,177,22,1
Galway,364,169,195,5208.33,139,25,159,38,3
Galway,305,145,160,7377.31,135,32,106,32,0
Galway,175,107,68,2975.03,8,115,15,29,8
Galway,251,128,123,6227.05,53,59,65,58,16
Galway,177,82,95,8027.21,79,15,63,20,0
Galway,320,153,167,7556.44,130,29,125,28,8
Galway,319,162,157,2297.56,133,56,93,34,3
Galway,208,109,99,7237.55,76,19,89,23,1
Galway,303,148,155,8185.43,63,15,214,6,5
Galway,414,201,213,154.46,64,49,94,113,94
Galway,274,138,136,6561.3,58,26,175,13,2
Galway,284,133,151,7998.42,63,20,190,11,0
Galway,326,161,165,2939.27,117,35,147,26,1
Galway,200,92,108,9608.92,63,14,112,10,1
Galway,233,129,104,8456.74,48,28,145,12,0
Galway,224,112,112,651,28,33,135,17,11
Galway,291,137,154,5540.75,93,33,108,46,11
Galway,314,168,146,1940.55,66,78,109,54,7
Galway,285,139,146,6300.57,46,47,85,81,26
Galway,221,121,100,3907.01,7,161,29,14,10
Galway,571,268,303,657.11,179,17,185,64,126
Galway,243,125,118,5330.7,57,24,150,12,0
Galway,206,99,107,4528.07,47,16,129,13,1
Galway,221,110,111,6765.65,48,28,125,18,2
Galway,224,120,104,2251.35,38,25,145,15,1
Galway,122,59,63,4891.15,14,12,82,11,3
Galway,133,62,71,5815.73,15,14,89,14,1
Galway,175,84,91,7861.99,40,9,103,21,2
Galway,184,88,96,2141.45,28,15,130,11,0
Galway,215,112,103,6089.96,53,27,123,11,1
Galway,290,141,149,8033.46,84,7,183,15,1
Galway,249,116,133,700.78,56,15,146,30,2
Galway,189,83,106,1442.88,20,9,143,10,7
Galway,137,64,73,3320.49,22,6,102,6,1
Galway,168,70,98,1515.88,35,20,104,8,1
Galway,104,50,54,339.17,18,10,61,12,3
Galway,376,164,212,6702.8,125,75,105,69,2
Galway,218,99,119,2834.52,32,29,96,51,10
Galway,358,176,182,7557.05,72,64,97,106,19
Galway,300,161,139,4122.52,59,52,92,80,17
Galway,256,124,132,5582.21,54,47,76,69,10
Galway,228,94,134,6050.79,36,42,61,73,16
Galway,219,101,118,1969.71,43,35,80,40,21
Galway,290,147,143,1500.69,110,9,149,21,1
Galway,222,101,121,9498.95,94,16,82,30,0
Galway,274,135,139,6299,50,38,115,65,6
Galway,361,172,189,151.12,28,61,150,89,33
Galway,263,141,122,8003.65,51,70,96,46,0
Galway,258,119,139,4753.92,61,29,78,69,21
Galway,241,104,137,4589.17,68,17,125,24,7
Galway,313,133,180,4658.5,56,57,111,75,14
Galway,286,129,157,680.73,77,34,102,62,11
Galway,217,101,116,3222.02,47,21,71,63,15
Galway,364,189,175,149.19,112,42,104,80,26
Galway,146,60,86,5341.72,30,11,76,23,6
Galway,100,38,62,3465.12,19,9,46,21,5
Galway,231,102,129,3150.36,72,10,124,20,5
Galway,344,169,175,3892.06,54,58,59,139,34
Galway,333,161,172,6527.62,96,27,136,57,17
Galway,207,88,119,4277.57,22,41,30,81,33
Galway,315,153,162,5590.36,93,42,94,66,20
Galway,227,108,119,3251.68,43,44,57,65,18
Galway,313,155,158,4938,65,54,71,98,25
Galway,194,95,99,6615.06,49,32,55,51,7
Galway,304,141,163,4511.46,38,40,65,106,55
Galway,254,116,138,5642.94,63,28,73,68,22
Galway,264,118,146,4945.95,70,25,77,67,25
Galway,317,143,174,5783.19,89,30,119,65,14
Galway,272,114,158,2190.63,51,34,90,68,29
Galway,318,153,165,2715.88,48,34,108,72,56
Galway,293,140,153,1493.47,57,36,66,69,65
Galway,223,95,128,7080.49,31,18,165,9,0
Galway,203,96,107,5543.72,52,27,52,55,17
Galway,190,96,94,5104.92,38,17,96,31,8
Galway,215,101,114,4167.56,41,33,51,71,19
Galway,244,124,120,3329.47,59,39,88,41,17
Galway,169,71,98,4146.93,28,29,53,41,18
Galway,209,106,103,4273.94,36,12,136,22,3
Galway,349,147,202,7274.32,119,50,100,68,12
Galway,240,104,136,5195.14,63,16,136,21,4
Galway,327,161,166,6716.23,84,38,141,59,5
Galway,292,141,151,3854.02,53,48,82,95,14
Galway,368,184,184,2946.48,90,38,168,61,11
Galway,212,99,113,3820.16,45,12,102,45,8
Galway,269,135,134,2028.54,63,29,120,48,9
Galway,248,123,125,7601.07,70,32,86,55,5
Galway,369,163,206,7217.18,114,30,166,50,9
Galway,164,69,95,4192.76,23,15,117,8,1
Galway,233,98,135,7468.43,62,19,130,19,3
Galway,191,93,98,5192.9,50,22,68,43,8
Galway,171,78,93,5553.21,35,17,93,23,3
Galway,300,150,150,5944.83,100,26,148,25,1
Galway,397,193,204,2593.7,124,44,132,83,14
Galway,285,122,163,4467.64,55,42,129,51,8
Galway,332,156,176,6978.02,112,35,154,29,2
Galway,248,104,144,3384.74,80,29,113,23,3
Galway,214,100,114,4668.31,56,10,122,24,2
Galway,246,122,124,6513.45,96,15,107,24,4
Galway,287,135,152,5555.56,95,18,151,17,6
Galway,201,92,109,602.29,45,31,95,28,2
Galway,272,133,139,3885.16,103,29,96,34,10
Galway,213,96,117,908.92,55,14,97,31,16
Galway,225,109,116,1245.95,44,37,129,12,3
Galway,167,82,85,3386.26,38,23,72,28,6
Galway,315,152,163,1210.3,76,51,96,80,12
Galway,289,140,149,1710.4,29,41,204,13,2
Galway,290,173,117,2574.51,25,52,105,73,35
Galway,228,97,131,1799.53,24,21,73,75,35
Galway,343,190,153,3360.7,35,47,135,77,49
Galway,409,225,184,359.16,41,67,145,103,53
Galway,191,85,106,9993.72,69,17,70,32,3
Galway,256,117,139,8192,77,32,98,38,11
Galway,239,111,128,578.27,71,17,141,10,0
Galway,208,102,106,4181.49,46,20,131,10,1
Galway,151,74,77,4665.1,9,12,114,14,2
Galway,245,120,125,10653.1,46,34,154,11,0
Galway,343,161,182,326.92,90,48,138,51,16
Galway,468,220,248,1533.45,106,129,200,23,10
Galway,160,87,73,7317.63,7,56,94,3,0
Galway,243,128,115,1382.87,16,27,66,73,61
Galway,193,92,101,6243.33,13,20,70,63,27
Galway,291,136,155,5420.61,27,45,106,76,37
Galway,156,78,78,5084.08,10,28,55,29,34
Galway,231,102,129,4276.43,20,34,63,68,46
Galway,257,110,147,3504.66,29,25,77,64,62
Galway,169,82,87,4098.56,19,20,50,46,34
Galway,221,96,125,4324.09,12,31,93,45,40
Galway,226,124,102,5233.9,13,34,133,28,18
Galway,95,54,41,5168.38,0,29,55,5,6
Galway,194,112,82,8451.69,5,95,77,13,4
Galway,228,106,122,4735.5,67,43,62,44,12
Galway,205,105,100,2234.33,31,52,71,40,11
Galway,258,116,142,3266.94,52,46,87,52,21
Galway,392,182,210,8300.69,79,70,91,119,33
Galway,160,80,80,2213.09,33,33,59,28,7
Galway,304,149,155,3882.5,56,58,82,86,22
Galway,209,107,102,3585.15,16,100,42,34,17
Galway,192,96,96,3079.84,19,47,49,50,27
Galway,215,112,103,3398.24,17,58,48,56,36
Galway,231,120,111,4800.6,19,75,58,49,30
Galway,303,146,157,4519.62,43,68,77,97,18
Galway,349,151,198,3644.53,52,79,85,109,24
Galway,183,78,105,5978.44,0,178,5,0,0
Galway,150,71,79,244.84,9,107,14,10,10
Galway,307,168,139,2303.65,54,55,105,76,17
Galway,173,78,95,5702.98,1,57,73,11,31
Galway,276,142,134,2700.19,15,68,137,38,18
Galway,201,113,88,6966.35,27,30,73,44,27
Galway,245,116,129,5019.05,1,97,104,27,16
Galway,179,78,101,3496.5,2,84,71,19,3
Galway,364,174,190,13373.99,0,92,178,70,24
Galway,123,67,56,5520.15,8,48,52,8,7
Galway,400,201,199,10018.53,16,93,209,65,17
Galway,725,465,260,6672.43,9,115,372,185,44
Galway,273,157,116,6621.71,12,49,123,58,31
Galway,340,153,187,2824.27,23,122,125,47,23
Galway,188,85,103,1859.53,1,74,100,9,4
Galway,183,93,90,20582.61,1,60,109,9,4
Galway,120,58,62,8961.91,1,50,53,13,3
Galway,254,112,142,5678.26,3,127,69,36,19
Galway,302,147,155,2356.72,5,46,213,25,13
Galway,115,58,57,7765.55,2,44,53,7,9
Galway,173,94,79,147.63,9,10,76,43,35
Galway,407,188,219,3707.96,70,52,100,120,65
Galway,169,74,95,4126.58,14,6,105,24,20
Galway,254,115,139,438.96,24,39,99,73,19
Galway,229,98,131,2731.46,31,29,65,50,54
Galway,283,140,143,3480.68,25,75,36,92,55
Galway,237,103,134,3457.38,24,25,59,46,83
Galway,264,125,139,341.73,29,39,75,78,43
Galway,236,116,120,5987.57,33,28,77,52,46
Galway,183,83,100,527.36,22,20,45,47,49
Galway,425,206,219,5393.33,139,55,208,19,4
Galway,266,134,132,6614.12,73,47,68,69,9
Galway,249,121,128,1361.18,22,50,62,95,20
Galway,259,116,143,6173.13,47,42,117,42,11
Galway,210,96,114,4494.96,37,32,83,53,5
Galway,201,85,116,5137.77,37,30,58,54,22
Galway,335,161,174,117.83,56,35,73,87,84
Galway,384,200,184,5057.02,73,82,124,95,10
Galway,229,112,117,4420.68,26,44,91,48,20
Galway,220,80,140,3349.52,4,167,43,5,1
Galway,220,111,109,9070.67,1,141,77,0,1
Galway,171,57,114,10567.95,0,170,1,0,0
Galway,202,96,106,365,18,43,82,47,12
Galway,150,69,81,2270.53,2,73,68,7,0
Galway,177,93,84,8761.08,2,88,84,3,0
Galway,222,114,108,161.78,34,27,60,73,28
Galway,261,133,128,110.71,54,45,57,89,16
Galway,240,120,120,4137.86,43,40,101,47,9
Galway,256,129,127,4800.39,28,40,79,75,34
Galway,313,142,171,1332.49,28,123,75,63,24
Galway,324,170,154,3446.77,23,32,110,70,89
Galway,192,102,90,1447.78,13,50,51,49,29
Galway,241,110,131,3430.36,25,34,60,60,62
Galway,287,138,149,5513.82,45,37,97,90,18
Galway,195,97,98,683.91,20,27,50,60,38
Galway,143,61,82,3009.13,13,18,32,45,35
Galway,200,105,95,1363.03,9,31,62,47,51
Galway,214,106,108,2918.51,15,31,62,50,56
Galway,154,86,68,6815.06,22,80,49,3,0
Galway,235,126,109,4769.83,32,65,66,65,7
Galway,262,140,122,5260.2,44,110,86,18,4
Galway,375,197,178,4655.03,47,130,84,102,12
Galway,158,75,83,7436.69,34,43,66,14,1
Galway,154,72,82,3108.16,17,44,76,11,6
Galway,370,189,181,4772.9,51,75,118,110,16
Galway,323,143,180,1965.25,22,57,93,79,72
Galway,209,93,116,1934.31,6,81,51,33,38
Galway,244,129,115,5585.44,15,41,60,74,54
Galway,216,105,111,4095.72,33,17,59,78,29
Galway,201,89,112,983.25,35,33,49,71,13
Galway,183,83,100,7162.43,17,26,45,48,47
Galway,244,106,138,6579.66,27,46,50,58,63
Galway,308,128,180,1389.39,17,122,59,44,66
Galway,215,98,117,4164.73,16,60,40,75,24
Galway,160,82,78,3064.61,8,12,76,39,25
Galway,135,60,75,7461.04,9,31,54,27,14
Galway,167,71,96,400.23,2,40,56,38,31
Galway,75,47,28,3855.45,3,16,50,5,1
Galway,191,71,120,4630.86,10,53,48,38,42
Galway,131,67,64,7731.81,10,15,47,32,27
Galway,148,91,57,3607.47,11,34,53,31,19
Galway,139,90,49,4975.12,9,29,69,15,17
Galway,147,69,78,3736.08,9,43,54,14,27
Galway,358,175,183,8128.05,131,69,100,50,8
Galway,272,139,133,5519.93,89,34,131,17,1
Galway,222,113,109,6211.88,32,27,150,13,0
Galway,204,91,113,3580.96,38,24,84,43,15
Galway,290,140,150,5717.21,45,49,101,82,13
Galway,200,88,112,3391.21,37,44,56,53,10
Galway,264,130,134,5823.32,39,22,190,12,1
Galway,298,147,151,8356.23,70,30,162,32,4
Galway,273,121,152,155.77,36,29,147,40,21
Galway,298,154,144,230.32,46,51,68,77,56
Galway,330,167,163,226.08,53,53,66,108,50
Galway,279,137,142,1707.86,28,61,72,85,33
Galway,217,118,99,1800.23,24,22,68,38,65
Galway,287,129,158,2674.2,36,33,76,67,75
Galway,222,114,108,2993.2,27,24,56,59,56
Galway,173,79,94,787.24,6,26,42,31,68
Galway,256,133,123,2687.33,48,28,48,72,60
Galway,212,116,96,1993.53,27,27,69,52,37
Galway,251,127,124,3989.95,30,23,75,66,57
Galway,478,237,241,2243.69,35,21,140,178,104
Galway,456,193,263,3255.89,74,28,94,120,140
Galway,269,117,152,2567.87,53,22,60,61,73
Galway,354,159,195,3264.18,61,47,85,109,52
Galway,247,112,135,6373.21,23,41,129,34,20
Galway,257,130,127,3163.97,24,27,134,53,19
Galway,250,120,130,3726.45,41,32,78,54,45
Galway,109,56,53,8690.11,2,14,74,13,6
Galway,166,69,97,6573.48,8,22,78,16,42
Galway,153,81,72,9242.48,16,16,99,14,8
Galway,133,66,67,22770.07,9,25,87,12,0
Galway,289,133,156,2044.12,41,45,72,81,50
Galway,272,120,152,6317.79,28,52,105,62,25
Galway,159,67,92,12226.07,9,28,104,15,3
Galway,337,157,180,3292.24,35,35,89,104,74
Galway,396,158,238,7164.7,103,41,173,49,30
Galway,191,86,105,4788.65,19,20,74,43,35
Galway,169,77,92,3540.97,19,22,58,34,36
Galway,171,80,91,5571.85,21,21,51,45,33
Galway,237,120,117,6537.39,19,48,51,70,49
Galway,191,101,90,4997.65,26,35,45,61,24
Galway,201,99,102,1830.25,19,55,46,51,30
Galway,168,82,86,5623.81,17,28,52,46,25
Galway,140,65,75,5686.66,7,42,46,24,21
Galway,677,341,336,2374.18,55,115,110,142,255
Galway,194,99,95,3387.17,11,55,69,37,22
Galway,240,119,121,816.52,13,80,94,28,25
Galway,237,135,102,1483.27,6,63,99,30,39
Galway,165,79,86,2808.42,6,51,53,22,33
Galway,121,59,62,8323.02,4,57,40,10,10
Galway,225,104,121,11230.91,9,40,170,6,0
Galway,253,120,133,1946.48,12,35,157,31,18
Galway,140,61,79,12671.98,3,49,82,4,2
Galway,212,98,114,7226.62,31,26,58,52,45
Galway,176,92,84,8124.08,34,25,46,46,25
Galway,201,104,97,6349.31,9,61,95,30,6
Galway,227,100,127,10372.4,10,147,46,9,15
Galway,111,54,57,2086.51,3,40,33,19,16
Galway,96,50,46,3073.67,1,48,26,13,8
Galway,301,142,159,2715.19,45,52,93,83,28
Galway,359,171,188,7310.12,125,63,109,53,9
Galway,228,119,109,4568.86,54,74,77,17,6
Galway,178,88,90,3271.76,33,22,48,44,31
Galway,153,74,79,778.05,18,25,29,50,31
Galway,274,127,147,3767.31,52,36,76,50,60
Galway,205,94,111,5368.32,30,37,64,43,31
Galway,211,106,105,3174.6,27,21,59,42,62
Galway,209,94,115,3233.34,52,20,62,39,36
Galway,116,42,74,6843.66,1,113,1,0,1
Galway,223,123,100,5035.68,55,70,80,17,1
Galway,360,184,176,4977.39,13,66,225,45,11
Galway,300,156,144,4640.8,40,45,118,67,30
Galway,304,164,140,654.05,28,70,153,41,12
Galway,580,289,291,4813.68,33,94,233,143,77
Galway,101,48,53,1516.36,8,10,23,39,21
Galway,198,91,107,6648.53,18,9,45,41,85
Kerry,230,120,110,29.95,32,26,47,64,61
Kerry,344,171,173,46.15,75,35,103,91,40
Kerry,236,125,111,23.34,60,14,77,56,29
Kerry,175,91,84,458.05,38,22,51,34,30
Kerry,199,88,111,748.76,51,24,93,21,10
Kerry,313,159,154,101.76,52,57,88,77,39
Kerry,300,147,153,70.35,92,26,90,65,27
Kerry,259,134,125,83.23,58,30,61,80,30
Kerry,197,112,85,30.16,52,20,50,50,25
Kerry,238,125,113,106.05,55,23,78,58,24
Kerry,224,112,112,67.1,43,23,66,60,32
Kerry,236,110,126,57.56,50,25,69,59,33
Kerry,313,163,150,54.84,71,30,85,85,42
Kerry,321,167,154,39.04,77,47,80,80,37
Kerry,196,99,97,34.94,35,17,55,55,34
Kerry,209,105,104,27.69,36,25,54,72,22
Kerry,264,151,113,59.65,65,20,65,79,35
Kerry,237,132,105,67.42,57,33,56,60,31
Kerry,104,54,50,7.62,17,7,25,38,17
Kerry,101,56,45,4.92,13,8,20,38,22
Kerry,318,165,153,462.09,58,45,87,90,38
Kerry,237,111,126,1158.01,84,25,75,38,15
Kerry,210,102,108,56.42,48,26,65,47,24
Kerry,232,111,121,69.04,43,30,52,75,32
Kerry,225,115,110,20.49,39,20,63,65,38
Kerry,256,123,133,8.85,44,20,64,66,62
Kerry,199,100,99,5.08,33,18,49,58,41
Kerry,233,118,115,38.75,56,28,51,64,34
Kerry,227,113,114,35.49,38,28,59,68,34
Kerry,112,59,53,5.69,21,12,19,42,18
Kerry,191,104,87,13.73,38,16,59,51,27
Kerry,209,101,108,68.94,54,12,57,59,27
Kerry,130,68,62,16.76,25,15,33,39,18
Kerry,93,45,48,2.9,11,14,16,28,24
Kerry,162,88,74,29.55,28,15,34,46,39
Kerry,280,140,140,48.42,56,37,75,63,49
Kerry,222,117,105,109.61,39,29,47,70,37
Kerry,225,113,112,32.72,48,12,71,48,46
Kerry,263,127,136,68.35,52,26,62,80,43
Kerry,158,78,80,474.71,36,13,52,28,29
Kerry,131,66,65,3.97,21,26,13,57,14
Kerry,374,183,191,26.34,102,36,119,78,39
Kerry,105,48,57,7.9,24,14,18,37,12
Kerry,180,95,85,20.72,38,14,51,54,23
Kerry,108,45,63,129.61,25,12,26,27,18
Kerry,144,75,69,695.15,18,17,29,57,23
Kerry,92,41,51,582.26,25,8,17,23,19
Kerry,178,87,91,43.15,29,20,51,60,18
Kerry,232,115,117,1452.07,43,35,54,77,23
Kerry,221,115,106,47.5,50,22,61,58,30
Kerry,233,122,111,46.23,45,31,53,70,34
Kerry,184,94,90,32.84,42,22,38,50,32
Kerry,239,124,115,18.89,60,22,82,42,33
Kerry,139,74,65,11.79,29,6,45,30,29
Kerry,135,73,62,12.84,27,10,36,38,24
Kerry,146,67,79,43.58,42,17,28,43,16
Kerry,319,163,156,88.85,70,42,65,104,38
Kerry,203,89,114,625.45,47,18,50,41,47
Kerry,214,107,107,84.55,36,28,59,63,28
Kerry,225,110,115,117.77,53,19,83,49,21
Kerry,337,162,175,109.61,82,42,63,109,41
Kerry,156,87,69,34.59,36,15,27,52,26
Kerry,223,123,100,29.21,38,36,52,69,28
Kerry,289,144,145,28.28,63,24,89,71,42
Kerry,234,115,119,152.64,63,33,52,72,14
Kerry,329,153,176,66.1,58,45,53,88,85
Kerry,320,157,163,82.02,60,37,103,78,42
Kerry,394,205,189,38.77,97,45,110,104,38
Kerry,255,119,136,5687.65,80,27,127,19,2
Kerry,207,99,108,2273.85,72,20,66,31,18
Kerry,222,113,109,3.35,51,16,54,67,34
Kerry,114,57,57,17.85,23,18,22,43,8
Kerry,203,105,98,40.22,40,23,59,54,27
Kerry,240,116,124,14.47,43,20,56,50,71
Kerry,191,98,93,20.47,25,37,38,63,28
Kerry,162,81,81,7.22,28,22,37,50,25
Kerry,234,118,116,82.07,52,27,55,72,28
Kerry,285,143,142,55.3,48,43,61,101,32
Kerry,198,100,98,17.88,39,21,68,41,29
Kerry,280,138,142,26,66,23,94,64,33
Kerry,152,83,69,6.51,30,15,31,49,27
Kerry,247,119,128,97.87,69,29,90,43,16
Kerry,291,151,140,63.56,73,39,85,74,20
Kerry,253,124,129,12,67,24,72,67,23
Kerry,260,136,124,29.05,49,31,62,76,42
Kerry,184,99,85,20.96,22,22,43,61,36
Kerry,125,55,70,114.95,15,19,21,42,28
Kerry,187,89,98,38.84,32,15,52,61,27
Kerry,163,73,90,61.52,34,14,36,46,33
Kerry,211,105,106,47.64,47,30,45,64,25
Kerry,166,94,72,23.7,37,28,31,46,24
Kerry,200,98,102,9.29,50,16,60,46,28
Kerry,118,56,62,223.02,17,7,42,29,23
Kerry,139,78,61,1446.11,21,17,38,37,26
Kerry,193,85,108,1217.7,20,22,46,71,34
Kerry,186,89,97,227.34,37,20,50,47,32
Kerry,237,129,108,2898.66,54,30,64,59,30
Kerry,113,61,52,1386.28,11,6,36,39,21
Kerry,91,49,42,16.29,18,4,17,36,16
Kerry,188,86,102,6.05,41,11,63,49,24
Kerry,179,99,80,19.01,48,13,47,48,23
Kerry,221,110,111,23.7,52,25,54,58,32
Kerry,213,114,99,17.31,37,21,60,57,38
Kerry,111,60,51,8.06,20,12,27,27,25
Kerry,81,40,41,27.28,13,5,25,23,15
Kerry,94,44,50,16.28,18,6,27,25,18
Kerry,173,88,85,65.98,39,21,47,45,21
Kerry,100,54,46,36.18,24,10,26,29,11
Kerry,149,74,75,35.7,34,14,57,17,27
Kerry,173,88,85,43.72,39,11,47,44,32
Kerry,193,93,100,28.7,44,15,47,60,27
Kerry,204,97,107,18.43,28,25,26,82,43
Kerry,176,95,81,3.68,45,7,36,53,35
Kerry,136,67,69,71.87,26,8,45,38,19
Kerry,116,56,60,204.76,17,17,35,35,12
Kerry,133,62,71,29.95,26,12,27,41,27
Kerry,119,61,58,17.26,19,14,25,32,29
Kerry,109,57,52,51.4,26,8,31,30,14
Kerry,171,94,77,25.94,42,21,45,44,19
Kerry,229,117,112,24.18,41,25,57,69,37
Kerry,239,119,120,27.12,44,22,69,67,37
Kerry,276,134,142,3552.86,46,37,67,101,25
Kerry,149,71,78,1231.39,16,11,43,35,44
Kerry,215,104,111,558.9,28,17,56,56,58
Kerry,241,122,119,101.65,33,32,57,88,31
Kerry,300,149,151,52.91,55,36,67,107,35
Kerry,217,109,108,1024.91,33,24,64,52,44
Kerry,342,155,187,4131.78,100,44,103,58,37
Kerry,345,170,175,55.62,67,33,140,82,23
Kerry,221,102,119,143.36,46,31,56,42,46
Kerry,213,106,107,374.22,41,25,52,59,36
Kerry,215,104,111,557.55,64,17,92,28,14
Kerry,224,107,117,516,54,19,79,38,34
Kerry,211,114,97,21.92,39,32,46,67,27
Kerry,232,114,118,7.8,50,20,50,72,40
Kerry,215,98,117,106.59,44,24,67,52,28
Kerry,184,97,87,71.27,25,27,51,54,27
Kerry,248,132,116,36.1,42,39,61,75,31
Kerry,175,82,93,9.31,44,20,49,48,14
Kerry,343,182,161,41.85,93,36,85,89,40
Kerry,175,76,99,5.63,31,55,33,36,20
Kerry,229,115,114,53.65,40,30,65,65,29
Kerry,237,124,113,40,43,30,63,70,31
Kerry,335,165,170,136.63,66,51,50,118,50
Kerry,267,132,135,63.5,61,39,56,83,28
Kerry,290,148,142,84.66,73,41,58,91,27
Kerry,287,142,145,124.17,65,27,63,83,49
Kerry,72,34,38,2.36,13,7,13,17,22
Kerry,335,171,164,26.51,63,29,85,73,85
Kerry,128,70,58,2.12,28,13,30,38,19
Kerry,280,152,128,12.12,77,30,100,46,27
Kerry,286,147,139,58.82,70,29,71,83,33
Kerry,245,109,136,131.41,77,29,71,56,12
Kerry,166,88,78,25.05,26,14,51,45,30
Kerry,291,147,144,22.29,70,27,82,70,42
Kerry,391,206,185,29.26,72,46,113,112,48
Kerry,230,127,103,16.5,33,28,69,67,33
Kerry,305,160,145,25.37,71,35,73,87,39
Kerry,353,178,175,241.92,74,37,125,85,32
Kerry,247,119,128,23.64,57,29,57,65,39
Kerry,283,144,139,11.91,38,38,75,94,38
Kerry,325,164,161,19.4,57,33,93,102,40
Kerry,171,79,92,4.75,29,26,37,58,21
Kerry,133,66,67,3.48,25,20,34,41,13
Kerry,194,101,93,13.41,42,15,60,52,25
Kerry,283,152,131,27.93,52,31,75,81,44
Kerry,93,48,45,5.69,12,7,20,30,24
Kerry,175,85,90,6.71,45,17,46,54,13
Kerry,169,81,88,90.32,30,16,24,56,43
Kerry,176,92,84,6.54,28,13,55,46,34
Kerry,163,82,81,24.55,25,14,47,48,29
Kerry,193,99,94,8.96,34,17,71,47,24
Kerry,210,111,99,2.19,43,17,50,54,46
Kerry,164,72,92,503.92,21,3,52,60,28
Kerry,164,84,80,559.13,11,5,29,45,74
Kerry,134,72,62,2613.51,12,19,45,39,19
Kerry,190,90,100,555.75,26,25,72,47,20
Kerry,283,131,152,858.94,46,35,84,78,40
Kerry,226,106,120,2865.15,53,25,73,58,17
Kerry,86,43,43,1514.99,5,5,34,16,26
Kerry,173,95,78,603.43,16,17,53,58,29
Kerry,118,61,57,333.05,16,13,45,30,14
Kerry,235,111,124,53.39,72,14,79,44,26
Kerry,175,94,81,9.16,41,13,48,50,23
Kerry,188,93,95,12.56,32,19,64,46,27
Kerry,232,116,116,60.42,56,32,58,66,20
Kerry,277,142,135,69.64,82,24,90,60,21
Kerry,186,102,84,70.63,28,28,41,72,17
Kerry,262,144,118,90.42,71,20,75,68,28
Kerry,330,159,171,27.21,98,20,113,62,37
Kerry,172,86,86,28.83,33,19,50,42,28
Kerry,301,154,147,36.05,75,22,98,61,45
Kerry,218,124,94,22.98,47,24,55,56,36
Kerry,136,67,69,28.07,37,9,26,39,25
Kerry,197,106,91,133.14,44,22,70,44,17
Kerry,144,82,62,19.59,20,15,35,56,18
Kerry,234,126,108,7.02,44,22,69,64,35
Kerry,209,105,104,45.76,50,18,55,51,35
Kerry,165,82,83,67.45,36,21,51,40,17
Kerry,151,73,78,169.73,28,13,43,47,20
Kerry,88,41,47,19.88,16,11,20,30,11
Kerry,105,57,48,14.95,21,13,25,29,17
Kerry,196,100,96,38.09,42,17,49,59,29
Kerry,173,88,85,12.53,40,12,47,45,29
Kerry,110,54,56,16.66,16,10,22,42,20
Kerry,78,40,38,163.25,13,7,22,16,20
Kerry,89,41,48,68.33,12,10,18,33,16
Kerry,216,93,123,598.81,64,17,62,47,26
Kerry,174,91,83,19.31,40,13,44,39,38
Kerry,86,43,43,20.13,12,7,27,24,16
Kerry,213,110,103,34.09,50,18,48,69,28
Kerry,179,82,97,34.12,34,22,43,56,24
Kerry,220,116,104,33.9,57,21,55,61,26
Kerry,205,102,103,5.24,63,22,55,47,18
Kerry,197,110,87,10.21,32,28,42,63,32
Kerry,137,71,66,30.31,22,24,36,37,18
Kerry,145,72,73,6.61,40,11,44,34,16
Kerry,78,35,43,53.8,12,8,12,24,22
Kerry,120,55,65,374.83,27,15,29,40,9
Kerry,125,67,58,79.93,21,14,29,38,23
Kerry,118,60,58,24.43,16,10,40,31,21
Kerry,90,43,47,19.71,24,8,21,21,16
Kerry,195,98,97,3.16,49,19,41,53,33
Kerry,164,82,82,3.9,38,21,35,50,20
Kerry,159,78,81,4.24,40,15,32,41,31
Kerry,116,57,59,30.14,17,10,33,42,14
Kerry,108,52,56,33.1,15,6,24,43,20
Kerry,214,59,155,38.57,56,71,27,38,22
Kerry,282,135,147,56.57,81,42,100,45,14
Kerry,236,130,106,14.53,56,23,66,62,29
Kerry,196,103,93,31.94,44,13,57,63,19
Kerry,194,88,106,147.68,37,23,53,61,20
Kerry,215,119,96,32.39,41,23,50,68,33
Kerry,262,132,130,18.15,55,25,91,64,27
Kerry,194,103,91,14.84,44,14,67,48,21
Kerry,171,97,74,14.61,24,17,44,52,34
Kerry,169,86,83,5.85,34,18,43,45,29
Kerry,77,37,40,27.22,17,6,18,20,16
Kerry,247,132,115,15.93,39,22,71,72,43
Kerry,170,86,84,18.83,33,21,40,50,26
Kerry,195,99,96,25.48,40,22,54,44,35
Kerry,328,174,154,29.95,79,42,88,82,37
Kerry,370,190,180,50.28,91,35,114,92,38
Kerry,151,73,78,7.25,20,16,33,46,36
Kerry,155,82,73,9.63,29,19,34,48,25
Kerry,99,50,49,1086.18,29,1,39,11,19
Kerry,115,61,54,645.29,18,18,39,18,22
Kerry,230,108,122,2025.91,55,20,114,34,7
Kerry,122,59,63,1851.18,15,7,31,41,28
Kerry,229,124,105,59.01,47,25,62,66,29
Kerry,284,127,157,112.77,75,25,90,53,41
Kerry,194,102,92,9.1,48,20,62,48,16
Kerry,219,109,110,293.53,62,33,57,54,13
Kerry,99,47,52,168.3,18,10,38,24,9
Kerry,126,58,68,1229.51,6,13,27,43,37
Kerry,199,99,100,257.32,44,19,49,39,48
Kerry,209,100,109,812.94,35,16,62,65,31
Kerry,173,87,86,125.64,32,15,47,48,31
Kerry,133,62,71,1020.47,31,17,47,20,18
Kerry,126,62,64,24.44,36,16,26,38,10
Kerry,235,119,116,26.53,44,23,67,65,36
Kerry,176,93,83,19.74,29,20,54,33,40
Kerry,206,109,97,51.11,39,22,63,49,33
Kerry,328,170,158,35.58,69,40,106,81,32
Kerry,242,131,111,35.7,64,21,81,53,23
Kerry,217,114,103,33.1,53,17,71,47,29
Kerry,190,110,80,35.21,42,28,53,47,20
Kerry,293,129,164,85.57,64,32,78,72,47
Kerry,255,122,133,111.2,59,25,75,68,28
Kerry,235,121,114,44.93,57,30,73,59,16
Kerry,260,127,133,26.24,63,33,75,56,33
Kerry,202,102,100,52.8,42,30,57,60,13
Kerry,374,192,182,193.59,94,24,164,37,55
Kerry,223,109,114,64.06,46,30,76,57,14
Kerry,220,114,106,45.27,54,17,71,48,30
Kerry,214,114,100,12.39,44,22,53,61,34
Kerry,287,149,138,25.19,66,25,85,71,40
Kerry,244,118,126,21.07,58,19,66,66,35
Kerry,264,143,121,13.88,48,27,74,74,41
Kerry,120,63,57,8.47,18,15,26,34,27
Kerry,248,121,127,21.77,34,34,67,78,35
Kerry,298,158,140,37.21,60,36,95,76,31
Kerry,137,76,61,3.41,24,10,45,35,23
Kerry,189,95,94,11.32,50,24,43,39,33
Kerry,145,81,64,17.48,38,17,35,35,20
Kerry,293,156,137,8.83,46,45,71,96,35
Kerry,176,99,77,37.46,40,17,52,52,15
Kerry,200,108,92,17.86,45,19,47,53,36
Kerry,221,105,116,32.26,56,26,63,53,23
Kerry,280,144,136,46.51,38,34,107,71,30
Kerry,185,93,92,20.04,36,19,56,41,33
Kerry,150,81,69,26.51,34,9,40,46,21
Kerry,285,146,139,107.24,56,35,80,79,35
Kerry,366,180,186,26.71,57,33,111,113,52
Kerry,243,119,124,175.56,73,11,84,45,30
Kerry,198,86,112,163.27,25,18,71,61,23
Kerry,204,99,105,79.47,39,26,34,79,26
Kerry,281,134,147,98.21,69,27,72,77,36
Kerry,167,93,74,608.39,40,21,56,40,10
Kerry,268,122,146,725.06,67,13,142,24,22
Kerry,499,255,244,758.09,164,38,236,53,8
Kerry,254,123,131,59.97,61,45,78,52,18
Kerry,202,110,92,42.35,38,21,57,60,26
Kerry,203,103,100,48.38,62,13,57,44,27
Kerry,209,105,104,45.75,42,20,64,61,22
Kerry,333,177,156,149.67,68,31,78,109,47
Kerry,250,130,120,53.88,58,32,58,72,30
Kerry,252,128,124,89.5,64,23,63,73,29
Kerry,349,180,169,372.59,62,20,77,110,80
Kerry,199,100,99,59,48,22,55,55,19
Kerry,359,181,178,72.99,82,44,83,126,24
Kerry,243,118,125,3398.46,59,40,65,64,15
Kerry,289,141,148,6366.06,67,50,88,76,8
Kerry,375,180,195,2922.86,94,75,118,77,11
Kerry,302,137,165,2945.85,42,29,106,94,31
Kerry,142,64,78,2871.7,21,10,46,44,21
Kerry,208,111,97,14271.01,30,50,101,21,6
Kerry,319,154,165,2481.02,100,49,107,52,11
Kerry,344,178,166,4466.2,69,26,183,50,16
Kerry,246,119,127,2712.81,50,36,112,28,20
Kerry,224,118,106,2787.66,34,17,69,54,50
Kerry,132,67,65,3488.46,10,9,60,31,22
Kerry,383,161,222,6468.17,17,34,113,96,123
Kerry,224,116,108,86.67,27,23,60,84,30
Kerry,309,142,167,1538.93,12,12,39,68,178
Kerry,140,78,62,5139.88,16,10,87,17,10
Kerry,237,114,123,1510.48,11,14,81,30,101
Kerry,184,96,88,3404.63,16,18,51,51,48
Kerry,225,91,134,2836.65,27,17,65,53,63
Kerry,166,76,90,4499.74,16,8,54,43,45
Kerry,235,112,123,2245.3,29,22,55,76,53
Kerry,676,286,390,3104.66,25,27,142,211,271
Kerry,131,55,76,948.73,12,18,49,25,27
Kerry,106,52,54,3093.36,16,12,54,16,8
Kerry,176,83,93,2168.26,13,34,52,46,31
Kerry,257,130,127,2009.3,32,23,80,85,37
Kerry,109,60,49,4637.11,18,7,38,17,29
Kerry,117,59,58,4818.38,19,12,68,14,4
Kerry,146,63,83,1221.11,18,18,43,43,24
Kerry,265,131,134,1596.65,22,39,105,54,45
Kerry,298,163,135,1004.58,51,22,86,82,57
Kerry,422,211,211,3142.64,82,25,192,51,72
Kerry,313,158,155,1471.07,46,31,77,94,65
Kerry,247,118,129,1173.62,58,25,85,61,18
Kerry,264,146,118,4758.04,62,25,149,21,7
Kerry,153,71,82,2270.16,32,13,56,39,13
Kerry,234,117,117,439.91,52,22,72,62,26
Kerry,230,110,120,2999.99,48,15,89,49,29
Kerry,284,133,151,961.19,75,20,126,42,21
Kerry,165,86,79,8308.99,25,18,106,12,4
Kerry,168,81,87,3704.28,25,11,57,38,37
Kerry,207,101,106,8086.57,31,19,60,68,29
Kerry,222,94,128,1753.14,56,23,92,35,16
Kerry,114,75,39,864.23,16,13,66,10,9
Kerry,193,91,102,1557.87,30,21,51,37,54
Kerry,237,117,120,4566.39,48,20,104,42,23
Kerry,136,67,69,577.4,27,15,60,30,4
Kerry,217,112,105,1377.26,41,17,63,56,40
Kerry,212,103,109,14.88,29,24,66,56,37
Kerry,260,126,134,52.9,55,35,64,86,20
Kerry,232,113,119,44.87,58,28,56,66,24
Kerry,209,120,89,22.16,43,22,69,47,28
Kerry,143,77,66,28.41,21,16,31,47,28
Kerry,90,43,47,697,8,13,17,25,27
Kerry,124,63,61,314.49,7,16,26,56,19
Kerry,163,83,80,89.51,34,16,37,51,25
Kerry,97,44,53,467.33,15,9,29,22,22
Kerry,154,80,74,23.42,21,23,40,45,25
Kerry,210,112,98,517.93,40,25,50,65,30
Kerry,132,68,64,211.02,19,12,35,32,34
Kerry,163,87,76,46.24,22,15,29,60,37
Kerry,227,104,123,189.45,67,38,64,45,13
Kerry,136,78,58,3.37,12,16,29,56,23
Kerry,119,65,54,10.53,21,7,33,29,29
Kerry,232,110,122,101.47,51,33,53,57,38
Kerry,265,136,129,48.07,53,24,63,76,49
Kerry,129,61,68,1732.45,36,3,74,9,7
Kerry,127,54,73,521.09,16,20,39,27,25
Kerry,134,69,65,1723.38,12,22,51,32,17
Kerry,90,48,42,872.84,7,14,22,34,13
Kerry,224,117,107,87.46,45,23,64,61,31
Kerry,286,140,146,89.42,71,34,72,79,30
Kerry,223,106,117,811.55,38,24,69,42,50
Kerry,167,83,84,158.55,20,19,58,36,34
Kerry,232,98,134,184.44,83,38,70,36,5
Kerry,275,130,145,582.45,72,22,97,56,28
Kerry,300,136,164,45.78,50,20,75,76,79
Kerry,192,92,100,89.47,43,27,45,57,20
Kerry,371,184,187,69.59,89,41,94,98,49
Kerry,136,66,70,3654.83,16,14,37,44,25
Kerry,101,52,49,2272.52,3,12,38,27,21
Kerry,222,93,129,210.48,44,32,96,41,9
Kerry,250,113,137,1812.24,56,42,74,49,29
Kerry,229,122,107,61.86,50,28,61,64,26
Kerry,250,132,118,23.88,43,31,66,69,41
Kerry,140,78,62,34.23,16,22,23,62,17
Kerry,164,92,72,12.97,28,16,40,42,38
Kerry,95,52,43,52.26,19,10,21,37,8
Kerry,295,151,144,24.56,61,38,69,82,45
Kerry,194,93,101,55.56,48,20,62,47,17
Kerry,282,144,138,27.59,69,33,69,75,36
Kerry,326,166,160,13.16,63,42,78,111,32
Kerry,236,124,112,23.33,66,15,84,46,25
Kerry,189,96,93,21.21,43,12,54,43,37
Kerry,184,95,89,20.53,44,16,49,53,22
Kerry,212,99,113,34.27,53,20,62,55,22
Kerry,190,85,105,66.16,53,15,57,39,26
Kerry,167,91,76,10.27,30,27,42,53,15
Kerry,149,76,73,8.64,23,17,42,45,22
Kerry,255,133,122,7.62,37,23,61,82,52
Kerry,315,176,139,19.46,70,23,90,80,52
Kerry,182,94,88,18.31,38,18,48,55,23
Kerry,263,134,129,38.66,52,29,77,61,44
Kerry,142,84,58,8.33,12,14,42,47,27
Kerry,215,111,104,18.14,43,29,53,67,23
Kerry,206,89,117,32.7,42,21,44,44,55
Kerry,128,63,65,46.88,28,8,37,32,23
Kerry,192,107,85,11.4,22,23,52,64,31
Kerry,266,137,129,31.12,52,35,69,76,34
Kerry,239,118,121,15.1,60,19,61,56,43
Kerry,302,163,139,17.92,71,36,94,65,36
Kerry,119,52,67,13.64,17,18,20,42,22
Kerry,193,103,90,13.48,46,22,49,52,24
Kerry,240,119,121,30.5,63,32,51,66,28
Kerry,214,110,104,10.04,31,36,46,76,25
Kerry,252,122,130,42.39,60,22,72,65,33
Kerry,286,143,143,39.09,65,47,63,85,26
Kerry,171,91,80,29.07,47,19,37,50,18
Kerry,274,139,135,28.1,65,21,85,60,43
Kerry,238,123,115,23.87,42,30,55,78,33
Kerry,106,57,49,3.03,31,8,26,27,14
Kerry,246,125,121,21.18,44,31,54,82,35
Kerry,184,82,102,89.49,30,16,42,58,38
Kerry,197,102,95,16.48,38,35,45,47,32
Kerry,204,96,108,20.54,46,23,43,60,32
Kerry,149,75,74,13.49,41,10,42,38,18
Kerry,169,86,83,24.68,22,15,48,42,42
Kerry,252,115,137,98.76,44,25,60,77,46
Kerry,229,108,121,43.84,43,18,57,66,45
Kerry,154,72,82,200.99,33,15,67,21,18
Kerry,303,151,152,71.21,49,24,75,74,81
Kerry,222,119,103,43.74,47,15,64,56,40
Kerry,238,115,123,69.25,59,23,73,55,28
Kerry,105,56,49,3122.12,15,11,18,32,29
Kerry,132,63,69,730.13,13,14,24,43,38
Kerry,102,43,59,1861.86,17,8,24,27,26
Kerry,363,185,178,966.59,87,49,122,73,32
Kerry,263,117,146,470.07,48,21,86,59,49
Kerry,269,108,161,4183.58,95,40,80,47,7
Kerry,329,160,169,373.12,89,41,99,67,33
Kerry,252,110,142,568.69,23,18,42,48,121
Kerry,94,48,46,897.7,14,9,26,25,20
Kerry,189,97,92,4121.96,22,26,41,71,29
Kerry,270,139,131,239.33,58,40,63,75,34
Kerry,119,56,63,2269.13,13,12,34,33,27
Kerry,91,45,46,2624.75,6,8,25,21,31
Kerry,87,47,40,2248.18,7,11,26,26,17
Kerry,316,139,177,2861.88,134,36,90,37,19
Kerry,298,141,157,1940.45,42,29,87,97,43
Kerry,136,66,70,2877.03,23,13,50,32,18
Kerry,153,66,87,3928.62,33,25,73,17,5
Kerry,125,63,62,85.06,13,11,36,33,32
Kerry,169,84,85,2094.02,39,21,82,22,5
Kerry,164,76,88,351.89,35,14,56,40,19
Kerry,179,88,91,1319.96,22,23,34,50,50
Kerry,277,131,146,118.5,79,38,76,53,31
Kerry,234,118,116,33.26,58,24,69,52,31
Kerry,169,82,87,3186.88,60,13,76,15,5
Kerry,96,46,50,162.5,24,6,35,16,15
Kerry,89,47,42,95.95,21,13,33,17,5
Kerry,151,72,79,196.6,43,16,52,27,13
Kerry,163,85,78,2.6,34,20,35,42,32
Kerry,147,80,67,5.49,21,12,39,43,32
Kerry,85,49,36,36.41,16,7,20,30,12
Kerry,161,81,80,13.58,29,12,35,49,36
Kerry,270,132,138,6.6,48,36,61,82,43
Kerry,274,153,121,13.52,47,25,88,73,41
Kerry,177,86,91,15.68,32,15,46,62,22
Kerry,122,57,65,663.54,20,9,55,25,13
Kerry,247,112,135,2480.67,71,10,91,46,29
Kerry,316,166,150,101.59,67,23,125,26,75
Kerry,260,139,121,44.04,42,23,87,62,46
Kerry,174,96,78,47.55,41,27,45,43,18
Kerry,136,63,73,437.13,38,13,59,15,11
Kerry,163,77,86,441.91,43,8,82,27,3
Kerry,138,66,72,26.04,22,12,38,45,21
Kerry,207,101,106,32.87,53,28,49,59,18
Kerry,176,80,96,49.69,33,24,44,47,28
Kerry,232,113,119,21.65,42,35,52,75,28
Kerry,156,83,73,11.15,25,20,44,47,20
Kerry,193,99,94,70.45,41,22,43,65,22
Kerry,211,106,105,400.64,69,15,88,23,16
Kerry,164,81,83,295.92,50,14,70,24,6
Kerry,239,115,124,41.02,65,22,95,37,20
Kerry,147,71,76,22.01,26,15,32,35,39
Kerry,267,128,139,24.66,57,26,84,69,31
Kerry,269,137,132,30.99,58,28,86,63,34
Kerry,171,89,82,4.66,41,11,40,52,27
Kerry,269,141,128,40.35,55,35,73,73,33
Kerry,244,130,114,18.06,36,31,66,75,36
Kerry,195,97,98,1.89,30,44,26,54,41
Kerry,216,100,116,50.35,39,22,50,72,33
Kerry,365,175,190,720.15,90,17,161,58,39
Kerry,286,148,138,16.58,46,32,64,92,52
Kerry,209,112,97,23.42,38,26,52,64,29
Kerry,203,102,101,2726.08,36,31,62,58,16
Kerry,165,89,76,102.68,14,19,46,50,36
Kerry,209,108,101,22.05,34,23,64,59,29
Kerry,184,98,86,9.5,40,19,46,54,25
Kerry,190,95,95,34.03,40,22,55,55,18
Kerry,252,123,129,27.79,64,25,74,71,18
Kerry,256,127,129,12.55,72,22,81,57,24
Kerry,170,86,84,70.9,24,12,59,48,27
Kerry,330,161,169,39.73,54,46,90,110,30
Kerry,230,101,129,269.5,30,65,42,57,36
Kerry,262,134,128,88.17,72,30,66,71,23
Kerry,270,134,136,62.97,65,31,55,92,27
Kerry,217,107,110,14.19,41,26,48,66,36
Kerry,204,107,97,23.97,36,20,54,50,44
Kerry,269,136,133,30.65,76,25,89,58,21
Kerry,188,95,93,20.3,37,23,50,49,29
Kerry,233,120,113,29.44,50,33,66,65,19
Kerry,181,82,99,57,19,19,29,47,67
Kerry,159,83,76,78.8,24,15,37,47,36
Kerry,287,161,126,798.27,71,23,159,30,4
Kerry,300,151,149,402.43,68,36,103,64,29
Kerry,221,110,111,30.94,40,22,58,71,30
Kerry,407,209,198,42.38,100,52,134,83,38
Kerry,221,112,109,33,39,28,61,63,30
Kerry,237,122,115,28.44,56,30,51,70,30
Kerry,204,105,99,36.27,55,27,57,48,17
Kerry,239,126,113,15.68,37,31,46,81,44
Kerry,108,60,48,76.13,17,6,33,31,21
Kerry,159,74,85,336.13,26,15,48,36,34
Kerry,189,102,87,3.27,36,17,50,48,38
Kerry,229,118,111,12.23,44,23,68,57,37
Kerry,238,108,130,9.71,38,20,55,76,49
Kerry,181,93,88,93.69,29,22,43,58,29
Kerry,192,102,90,1422.53,40,15,56,50,31
Kerry,168,91,77,30.25,19,25,33,50,41
Kerry,265,136,129,22.17,58,24,65,61,57
Kerry,256,134,122,30.94,54,26,66,60,50
Kerry,138,85,53,11.78,30,16,32,41,19
Kerry,134,78,56,9.13,17,17,30,55,15
Kerry,249,116,133,5104.97,45,49,62,84,9
Kerry,158,72,86,1923.15,9,18,31,39,61
Kerry,300,144,156,3281.99,71,37,94,63,35
Kerry,357,157,200,4883.65,124,35,159,37,2
Kerry,193,91,102,860.8,59,18,79,30,7
Kerry,188,92,96,2149.82,33,28,50,50,27
Kerry,256,128,128,69.62,51,34,32,95,44
Kerry,213,103,110,333.39,65,16,56,52,24
Kerry,175,73,102,466.25,42,14,78,27,14
Kerry,208,91,117,3040.58,33,29,58,71,17
Kerry,294,145,149,1987.31,47,43,69,73,62
Kerry,237,111,126,2669.16,66,23,106,34,8
Kerry,243,114,129,4283.22,30,54,42,99,18
Kerry,297,146,151,145.72,54,34,51,96,62
Kerry,261,126,135,2596.27,49,41,63,86,22
Kerry,179,75,104,186.48,33,11,60,31,44
Kerry,146,70,76,2062.5,34,12,81,17,2
Kerry,143,66,77,2269.99,39,8,79,16,1
Kerry,323,155,168,3741.24,52,50,70,102,49
Kerry,161,83,78,2775.14,41,18,72,20,10
Kerry,196,92,104,5019.46,59,17,97,18,5
Kerry,147,75,72,4338.97,17,12,41,35,42
Kerry,176,87,89,4723.82,25,9,40,44,58
Kerry,276,125,151,323.28,92,23,92,55,14
Kerry,396,208,188,41.86,108,50,83,113,42
Kerry,176,79,97,2328.17,27,11,45,56,37
Kerry,338,176,162,3739.52,63,54,89,96,36
Kerry,325,147,178,3383.34,125,18,132,44,6
Kerry,339,161,178,215.74,112,32,105,78,12
Kerry,415,210,205,705.07,131,57,98,110,19
Kerry,125,58,67,4721.61,12,13,31,34,35
Kerry,179,86,93,1942.46,26,24,40,47,42
Kerry,322,156,166,3166.11,85,44,117,60,16
Kerry,219,101,118,255.25,47,36,62,66,8
Kerry,185,87,98,3756.65,40,22,76,36,11
Kerry,348,164,184,4223.97,129,33,156,26,4
Kerry,335,167,168,1598.83,61,46,107,94,27
Kerry,310,134,176,1449.27,113,28,147,19,3
Kerry,388,177,211,1820.64,133,43,129,69,14
Kerry,456,208,248,1595.95,49,32,93,86,196
Kerry,222,98,124,2269.4,60,33,56,47,26
Kerry,184,83,101,5011.44,22,18,53,44,47
Kerry,308,165,143,923.9,38,37,50,94,89
Kerry,302,153,149,1076.58,57,38,107,67,33
Kerry,268,133,135,3105.99,64,28,86,60,30
Kerry,314,147,167,4069.52,81,93,83,41,16
Kerry,293,135,158,1938.77,91,48,120,28,6
Kerry,253,119,134,3804.68,74,28,80,43,28
Kerry,288,149,139,2393.84,62,34,101,59,32
Kerry,254,127,127,2019.17,58,46,61,83,6
Kerry,207,102,105,424.67,35,50,64,49,9
Kerry,143,63,80,3539.34,23,5,37,26,52
Kerry,175,83,92,3793.05,23,20,50,51,31
Kerry,277,147,130,1719.71,65,79,120,13,0
Kerry,288,137,151,5863.67,83,29,146,30,0
Kerry,155,75,80,13720.46,2,144,7,0,2
Kerry,136,57,79,953.57,25,41,37,23,10
Kerry,185,85,100,835.15,14,12,32,37,90
Kerry,198,87,111,1914.17,29,19,57,47,46
Kerry,194,99,95,4853.03,29,36,46,50,33
Kerry,164,81,83,4058,19,21,46,40,38
Kerry,270,136,134,5385.24,45,45,61,108,11
Kerry,335,144,191,2764.78,78,57,86,98,16
Kerry,255,122,133,735.2,56,67,65,44,23
Kerry,251,129,122,3982.29,84,37,99,30,1
Kerry,150,73,77,2858.5,37,22,39,43,9
Kerry,165,83,82,1952.76,39,26,63,31,6
Kerry,237,114,123,4813.16,92,18,90,26,11
Kerry,178,84,94,1390.02,50,37,52,33,6
Kerry,176,77,99,2442.75,24,24,47,60,21
Kerry,213,93,120,2739.66,17,43,34,25,94
Kerry,180,90,90,3074.98,28,21,52,48,31
Kerry,168,79,89,2670.06,13,20,36,57,42
Kerry,130,65,65,2498.08,25,22,51,29,3
Kerry,204,109,95,8739.61,34,28,57,62,23
Kerry,165,82,83,2877.22,5,18,44,50,48
Kerry,233,104,129,4243.54,47,46,58,54,28
Kerry,136,68,68,2348.11,5,14,28,57,32
Kerry,247,123,124,1414.85,28,19,69,53,78
Kerry,165,88,77,2765.35,29,33,70,15,18
Kerry,118,68,50,3626.31,12,7,39,32,28
Kerry,113,64,49,2933.77,4,43,39,21,6
Kerry,237,112,125,7502.37,33,51,58,49,46
Kerry,206,110,96,2143.47,26,23,70,38,49
Kerry,192,105,87,2289.07,22,39,105,23,3
Kerry,243,109,134,630.01,20,25,75,46,77
Kerry,199,109,90,8113.18,27,21,54,60,37
Kerry,151,80,71,4462.83,27,12,39,44,29
Kerry,226,102,124,4805.55,36,23,55,62,50
Kerry,235,110,125,1651.44,25,23,60,53,74
Kerry,154,71,83,608.46,21,13,59,37,24
Kerry,247,115,132,2541.13,53,18,74,38,64
Kerry,108,55,53,5892.94,11,15,29,30,23
Kerry,201,147,54,2439.53,10,35,123,26,7
Kerry,135,69,66,1621.72,16,8,33,40,38
Kerry,160,81,79,4011.83,25,13,44,50,28
Kerry,108,50,58,2080.28,14,11,28,37,18
Kerry,117,60,57,3208.29,3,10,23,42,39
Kerry,180,93,87,4375.73,24,24,42,53,37
Kerry,87,49,38,3451.7,19,9,21,24,14
Kerry,152,87,65,1357.09,1,117,18,11,5
Kerry,134,62,72,19126.46,27,15,72,17,3
Kerry,88,44,44,1682.18,8,4,34,23,19
Kerry,240,127,113,11.79,42,20,63,72,43
Kerry,253,128,125,24.86,59,21,78,61,34
Kerry,358,182,176,36.25,92,36,98,84,48
Kerry,258,129,129,26.69,44,22,74,70,48
Kerry,201,99,102,37.9,35,34,41,62,29
Kerry,178,86,92,27.95,38,16,45,44,35
Kerry,191,97,94,30.48,31,19,43,61,37
Kerry,115,66,49,17.71,25,12,18,37,23
Kerry,150,84,66,50.44,38,26,38,33,15
Kerry,99,45,54,9.2,9,13,20,36,21
Kerry,161,82,79,29.29,31,9,35,44,42
Kerry,113,52,61,19.54,21,11,26,39,16
Kerry,105,47,58,34.34,20,9,23,29,24
Kerry,115,64,51,11.86,8,12,28,51,16
Kerry,90,44,46,21.32,16,10,23,26,15
Kildare,491,245,246,2265.56,187,38,210,51,5
Kildare,318,155,163,5435.25,105,17,163,29,4
Kildare,249,115,134,43.12,34,25,58,77,55
Kildare,455,280,175,36.77,52,43,146,140,74
Kildare,232,118,114,4972.78,72,20,122,17,1
Kildare,318,155,163,5080.44,117,23,154,21,3
Kildare,197,95,102,1546.21,23,27,45,71,31
Kildare,241,119,122,7574.57,77,18,127,17,2
Kildare,241,114,127,3598.73,92,17,109,21,2
Kildare,269,128,141,121.71,68,25,85,54,37
Kildare,305,158,147,33.41,67,34,72,85,47
Kildare,186,85,101,302.76,43,19,96,26,2
Kildare,169,85,84,49,46,20,46,47,10
Kildare,453,218,235,5645.21,188,33,190,37,5
Kildare,89,55,34,876.21,8,11,38,20,12
Kildare,295,146,149,2512.65,69,37,92,80,17
Kildare,206,95,111,2665.53,23,21,49,61,52
Kildare,159,79,80,261.19,25,15,41,48,30
Kildare,292,149,143,6201.42,122,25,122,19,4
Kildare,213,100,113,5915.52,85,19,81,21,7
Kildare,342,145,197,1363.61,32,21,61,53,175
Kildare,185,89,96,2881.89,12,17,50,49,57
Kildare,283,135,148,2789.17,116,36,83,42,6
Kildare,184,92,92,2144.97,48,27,54,45,10
Kildare,243,113,130,2091.31,55,37,66,60,25
Kildare,193,101,92,17.7,39,21,40,64,29
Kildare,304,156,148,121.46,57,42,75,78,52
Kildare,193,102,91,43.25,50,23,40,50,30
Kildare,257,130,127,45,66,33,76,60,22
Kildare,272,133,139,2798.84,93,26,124,23,6
Kildare,301,161,140,26.8,50,38,105,81,27
Kildare,247,122,125,212.3,54,26,83,61,23
Kildare,327,155,172,64.38,87,49,81,88,22
Kildare,278,140,138,41.37,56,32,73,82,35
Kildare,393,203,190,140.7,85,63,97,114,34
Kildare,229,114,115,102.67,45,10,68,62,44
Kildare,248,115,133,996.43,37,32,59,80,40
Kildare,323,171,152,25.46,66,46,95,80,36
Kildare,261,135,126,37.78,47,28,68,74,44
Kildare,273,127,146,147.84,59,39,80,66,29
Kildare,310,169,141,61.71,69,33,88,82,38
Kildare,369,179,190,90.81,116,34,130,63,26
Kildare,573,318,255,66.38,94,117,165,160,37
Kildare,168,88,80,2888.73,29,23,45,62,9
Kildare,244,125,119,223.34,31,32,54,83,44
Kildare,350,192,158,730.68,49,40,103,87,71
Kildare,285,150,135,103.14,60,45,60,96,24
Kildare,179,87,92,73.05,29,25,54,44,27
Kildare,257,131,126,29.31,60,41,68,66,22
Kildare,442,218,224,53.33,134,59,133,89,27
Kildare,395,197,198,37.63,112,54,96,102,31
Kildare,366,179,187,87.93,93,53,101,90,29
Kildare,338,173,165,123.05,114,31,105,64,24
Kildare,211,108,103,475.21,76,20,67,44,4
Kildare,741,571,170,124.51,231,279,82,100,49
Kildare,338,159,179,97.37,105,47,95,75,16
Kildare,314,168,146,48.5,92,42,68,89,23
Kildare,264,137,127,41.9,72,27,82,62,21
Kildare,344,175,169,60.92,83,41,101,86,33
Kildare,244,122,122,44.68,69,38,49,67,21
Kildare,270,145,125,24.94,57,32,88,63,30
Kildare,156,85,71,14.37,24,18,42,44,28
Kildare,420,216,204,5424.18,164,47,132,71,6
Kildare,194,102,92,10038.81,44,12,125,11,2
Kildare,260,120,140,1644.76,46,33,152,26,3
Kildare,302,155,147,4544.16,103,40,78,69,12
Kildare,229,119,110,620.82,48,37,98,38,8
Kildare,287,143,144,47.87,63,38,88,86,12
Kildare,364,183,181,48.05,81,39,121,91,32
Kildare,346,181,165,44.69,84,39,93,105,25
Kildare,570,279,291,718.3,249,72,176,66,7
Kildare,339,157,182,68.02,75,32,92,101,39
Kildare,265,129,136,6164.37,92,9,128,36,0
Kildare,309,148,161,5320.52,91,28,137,44,9
Kildare,232,117,115,4817.88,48,23,72,56,33
Kildare,280,133,147,5785.84,113,29,97,39,2
Kildare,246,126,120,5014.68,78,24,94,38,12
Kildare,361,186,175,17.5,87,33,101,85,55
Kildare,253,129,124,33.98,65,25,83,46,34
Kildare,355,178,177,31.5,73,41,104,103,34
Kildare,296,147,149,738.46,85,26,121,51,13
Kildare,361,165,196,287.41,114,40,112,74,21
Kildare,294,150,144,16.47,65,39,70,81,39
Kildare,238,123,115,23.2,43,32,48,80,35
Kildare,307,151,156,49.71,83,23,111,73,17
Kildare,263,137,126,572.81,64,39,76,64,20
Kildare,350,172,178,38.51,91,38,105,89,27
Kildare,398,196,202,456.85,119,57,146,66,10
Kildare,330,160,170,3923.71,102,40,114,58,16
Kildare,293,138,155,29.91,91,32,84,63,23
Kildare,216,105,111,475.32,28,27,104,32,25
Kildare,355,171,184,2371.9,85,42,104,83,41
Kildare,344,157,187,27.04,83,44,93,90,34
Kildare,376,197,179,51.56,95,43,96,96,46
Kildare,370,199,171,89.84,97,51,98,94,30
Kildare,376,197,179,525.67,171,22,141,34,8
Kildare,363,192,171,58,89,50,96,100,28
Kildare,289,157,132,3251.65,98,32,91,49,19
Kildare,327,178,149,184.83,126,22,109,57,13
Kildare,265,136,129,17.15,83,20,82,60,20
Kildare,255,124,131,15.72,52,27,67,55,54
Kildare,369,191,178,26.53,103,34,108,85,39
Kildare,292,146,146,1991.56,43,29,72,99,49
Kildare,167,88,79,723.42,32,26,42,45,22
Kildare,205,103,102,1960.11,69,14,102,20,0
Kildare,316,156,160,25.58,57,47,75,103,34
Kildare,402,193,209,172.86,126,30,166,61,19
Kildare,227,115,112,54.87,58,30,72,34,33
Kildare,240,117,123,34.44,52,38,53,78,19
Kildare,317,156,161,5393.72,113,21,121,50,12
Kildare,470,232,238,6187.96,155,89,122,103,1
Kildare,498,261,237,6261,195,32,209,51,11
Kildare,321,162,159,2105.35,65,45,100,91,20
Kildare,275,145,130,6298.96,94,23,117,38,3
Kildare,393,196,197,1592.21,108,84,86,107,8
Kildare,316,165,151,8163.05,93,46,115,56,6
Kildare,222,117,105,1893.76,32,20,72,50,48
Kildare,316,155,161,1364.53,57,59,62,117,21
Kildare,310,147,163,6766.64,92,12,179,18,9
Kildare,337,160,177,4408.92,104,28,185,18,2
Kildare,283,131,152,6339.04,57,36,100,77,13
Kildare,280,132,148,5853.21,40,57,84,91,8
Kildare,283,135,148,9583.8,55,51,78,84,15
Kildare,282,159,123,6743.51,54,53,74,87,14
Kildare,272,132,140,2032.73,55,14,94,77,32
Kildare,346,164,182,6458,111,25,188,20,2
Kildare,406,193,213,4260.41,101,76,97,114,18
Kildare,301,146,155,2794.98,52,70,46,122,11
Kildare,274,152,122,4679.6,66,57,59,88,4
Kildare,472,223,249,6668.17,83,104,97,180,8
Kildare,176,82,94,8327.02,33,16,84,33,10
Kildare,275,130,145,9749.7,48,40,96,78,13
Kildare,321,205,116,1129.38,33,28,98,126,36
Kildare,260,141,119,7179.94,47,21,81,58,53
Kildare,280,132,148,6306.73,45,41,64,103,27
Kildare,228,117,111,8063.66,49,39,77,56,7
Kildare,250,127,123,3218.25,55,43,80,61,11
Kildare,306,151,155,7018.99,119,33,109,39,6
Kildare,273,132,141,7126.08,107,25,94,43,4
Kildare,304,155,149,6205.22,56,49,77,102,20
Kildare,178,78,100,7048.11,51,13,100,13,1
Kildare,217,100,117,4235.8,64,7,127,19,0
Kildare,259,125,134,6186.11,83,54,76,44,2
Kildare,347,174,173,6658.48,148,42,112,45,0
Kildare,247,128,119,5527.33,59,47,47,77,17
Kildare,239,116,123,5352.98,59,34,75,53,18
Kildare,311,149,162,6247.36,80,31,88,88,24
Kildare,213,103,110,3896.32,44,26,63,64,16
Kildare,310,154,156,6874.38,113,23,122,43,9
Kildare,321,159,162,3897.85,116,28,125,34,18
Kildare,320,140,180,6394.63,130,28,125,34,3
Kildare,358,167,191,521.25,106,33,114,58,47
Kildare,447,222,225,271.61,78,82,94,155,38
Kildare,324,166,158,7639.89,59,59,75,122,9
Kildare,370,170,200,7864.81,79,62,120,91,18
Kildare,354,167,187,2957.62,51,53,92,105,53
Kildare,353,174,179,643.08,57,103,70,111,12
Kildare,268,141,127,59.56,40,53,62,80,33
Kildare,249,131,118,29.59,49,24,73,79,24
Kildare,278,131,147,26.92,68,34,68,86,22
Kildare,254,123,131,4769.42,70,19,101,50,14
Kildare,354,183,171,4948.21,129,21,160,35,9
Kildare,323,149,174,2571.49,100,18,184,19,2
Kildare,340,166,174,42.47,73,57,84,105,21
Kildare,244,123,121,49.15,56,36,58,65,29
Kildare,509,246,263,363.99,107,82,112,138,70
Kildare,349,170,179,201.2,93,41,87,97,31
Kildare,356,177,179,1102.23,84,44,128,72,28
Kildare,303,145,158,2687.39,79,19,176,27,2
Kildare,270,130,140,3333.5,71,27,80,58,34
Kildare,304,138,166,1980.55,63,27,161,45,8
Kildare,191,100,91,6111.02,53,10,112,15,1
Kildare,203,110,93,1934.48,49,18,111,23,2
Kildare,224,107,117,2531.87,47,33,68,45,31
Kildare,264,122,142,2964.09,52,41,107,49,15
Kildare,321,155,166,5284.56,95,40,111,67,8
Kildare,132,69,63,4287.8,19,12,84,15,2
Kildare,191,99,92,1831.38,28,30,52,59,22
Kildare,161,84,77,297.12,41,9,94,13,4
Kildare,179,83,96,1093.55,53,13,86,27,0
Kildare,353,163,190,5895.81,134,55,101,53,10
Kildare,232,123,109,3299.16,56,21,83,52,20
Kildare,295,146,149,6857.28,112,27,108,41,7
Kildare,147,77,70,9004.59,25,13,87,17,5
Kildare,406,207,199,4287.04,116,76,88,115,11
Kildare,159,75,84,5380.35,26,18,92,16,7
Kildare,185,98,87,1148.88,33,23,49,52,28
Kildare,278,132,146,1626.53,60,25,89,75,29
Kildare,313,152,161,40.21,93,51,66,86,17
Kildare,357,183,174,39.12,105,39,107,81,25
Kildare,421,213,208,41.94,103,53,129,100,36
Kildare,404,202,202,57.16,116,46,122,88,32
Kildare,388,192,196,24.68,99,36,136,92,25
Kildare,378,190,188,37.8,99,42,98,113,26
Kildare,372,182,190,35.12,92,58,86,111,25
Kildare,393,193,200,33.46,65,46,101,139,42
Kildare,324,161,163,73.4,66,49,69,107,33
Kildare,239,117,122,217.12,37,34,59,74,35
Kildare,235,113,122,2091.23,33,30,70,69,33
Kildare,277,150,127,4515.37,28,52,63,111,23
Kildare,336,154,182,5340.62,36,74,69,140,17
Kildare,245,121,124,4175.4,80,14,95,44,12
Kildare,361,170,191,7826.05,121,14,196,25,5
Kildare,356,187,169,4815.24,119,55,70,104,8
Kildare,313,163,150,182.98,54,36,72,103,48
Kildare,242,100,142,62.75,28,18,41,53,102
Kildare,295,143,152,434.89,68,26,159,32,10
Kildare,365,178,187,6566.17,133,27,155,42,8
Kildare,212,101,111,3106.05,52,13,111,24,12
Kildare,216,101,115,7423.19,59,15,129,12,1
Kildare,247,115,132,9316.89,79,21,134,12,1
Kildare,210,102,108,5812.51,68,17,109,16,0
Kildare,239,126,113,2780.56,66,16,142,14,1
Kildare,155,79,76,2493.52,44,19,88,4,0
Kildare,211,110,101,8305.45,70,10,114,14,3
Kildare,239,116,123,8072.69,69,21,128,19,2
Kildare,281,145,136,80.68,75,42,84,67,13
Kildare,280,135,145,31.47,58,45,78,72,27
Kildare,232,102,130,29.84,65,29,54,62,22
Kildare,406,206,200,4307.92,119,52,127,76,32
Kildare,246,115,131,2873.26,46,22,75,57,46
Kildare,477,239,238,86.9,134,55,143,107,38
Kildare,240,115,125,5084.1,110,17,77,28,8
Kildare,305,153,152,7213.98,123,27,125,27,3
Kildare,246,122,124,565.83,44,32,74,59,37
Kildare,258,131,127,130.02,59,31,74,73,21
Kildare,262,130,132,231.33,50,27,70,85,30
Kildare,258,134,124,16.57,59,32,76,67,24
Kildare,420,217,203,1214.37,173,20,169,44,14
Kildare,332,167,165,1644.97,132,14,159,22,5
Kildare,336,172,164,56.44,84,24,111,72,45
Kildare,318,175,143,142.02,66,32,97,88,35
Kildare,213,98,115,873.81,69,17,92,29,6
Kildare,451,217,234,298.4,156,43,147,89,16
Kildare,458,222,236,52.45,116,59,108,130,45
Kildare,380,189,191,3165.3,45,41,94,121,79
Kildare,317,152,165,4936.46,90,33,162,26,6
Kildare,263,130,133,5830.97,84,30,99,44,6
Kildare,377,184,193,3471.55,99,54,110,91,23
Kildare,252,131,121,3200.33,58,36,74,67,17
Kildare,408,191,217,2979.47,78,98,92,121,19
Kildare,252,117,135,2903.06,55,46,61,76,14
Kildare,261,121,140,5373.8,44,35,65,70,47
Kildare,362,177,185,3113.18,68,37,77,104,76
Kildare,325,167,158,4106.96,46,40,68,101,70
Kildare,302,156,146,2946.11,56,54,74,85,33
Kildare,398,199,199,6148.43,108,58,131,87,14
Kildare,186,86,100,654.25,18,22,33,41,72
Kildare,248,123,125,6412.25,78,30,121,17,2
Kildare,207,105,102,6096.48,59,14,112,18,4
Kildare,150,67,83,957.55,14,8,25,36,67
Kildare,176,89,87,3701.6,23,19,41,42,51
Kildare,188,83,105,18871.71,40,23,94,28,3
Kildare,106,59,47,3783.82,7,12,53,23,11
Kildare,115,72,43,6084.33,10,16,59,20,10
Kildare,101,65,36,3355.04,14,11,58,16,2
Kildare,142,69,73,3319.93,26,21,59,26,10
Kildare,136,67,69,999.68,20,25,56,21,14
Kildare,301,153,148,1572.57,109,28,109,51,4
Kildare,251,119,132,3487.42,52,46,40,79,34
Kildare,216,115,101,6470.17,43,20,55,43,55
Kildare,214,110,104,10081.97,42,23,51,54,44
Kildare,138,78,60,1363.37,5,17,31,57,28
Kildare,238,109,129,8069.71,42,45,61,67,23
Kildare,250,121,129,8876.9,67,38,71,48,26
Kildare,303,137,166,662.94,59,31,162,33,18
Kildare,317,164,153,37.28,77,42,93,80,25
Kildare,434,236,198,31.16,87,52,133,123,39
Kildare,254,139,115,37.78,48,43,59,77,27
Kildare,224,106,118,28.73,51,31,58,64,20
Kildare,440,201,239,27.31,89,58,95,111,87
Kildare,260,134,126,32.33,50,29,73,75,33
Kildare,326,153,173,109.66,70,47,80,99,30
Kildare,413,209,204,22.47,98,59,112,104,40
Kildare,300,154,146,24.39,71,42,74,88,25
Kildare,290,142,148,40.77,53,31,63,86,57
Kildare,354,182,172,27.44,95,29,95,107,28
Kildare,180,87,93,197.23,40,16,80,28,16
Kildare,302,160,142,16.08,63,56,69,82,32
Kildare,253,115,138,36.48,63,37,64,58,31
Kildare,203,105,98,29.37,57,15,57,49,25
Kildare,395,194,201,34.53,106,49,98,109,33
Kildare,205,102,103,16.75,43,19,74,49,20
Kildare,179,99,80,20.63,43,23,49,42,22
Kildare,531,267,264,52.17,121,62,115,130,103
Kildare,354,160,194,128.74,85,28,105,59,77
Kildare,205,105,100,100.23,38,38,80,37,12
Kildare,460,216,244,4880.9,159,57,121,104,19
Kildare,432,221,211,3443.47,81,84,128,113,26
Kildare,255,97,158,2235.43,37,29,111,25,53
Kildare,135,73,62,1537.31,19,14,64,28,10
Kildare,352,183,169,5254.67,114,10,210,14,4
Kildare,194,90,104,6086.27,40,28,47,52,27
Kildare,219,93,126,3766.19,80,37,56,38,8
Kildare,353,183,170,5500.58,107,61,93,87,5
Kildare,159,83,76,7548.07,43,12,95,8,1
Kildare,209,99,110,6344.29,47,21,116,22,3
Kildare,395,194,201,3670.7,132,31,180,47,5
Kildare,198,94,104,3279.39,55,7,125,7,4
Kildare,312,149,163,3515.26,91,25,100,62,34
Kildare,351,160,191,7109.29,107,13,191,37,3
Kildare,204,96,108,4158.94,49,17,109,21,8
Kildare,126,61,65,3272.05,42,9,71,4,0
Kildare,117,52,65,662.35,16,13,82,6,0
Kildare,291,136,155,3743.58,98,22,111,45,15
Kildare,241,119,122,9763.41,77,10,140,14,0
Kildare,265,121,144,928.55,48,45,68,87,17
Kildare,270,133,137,93.46,64,40,57,76,33
Kildare,300,142,158,42.74,68,30,89,74,39
Kildare,299,141,158,63.52,61,36,68,72,62
Kildare,255,131,124,2570.77,27,10,67,63,88
Kildare,128,64,64,637.25,10,14,65,21,18
Kildare,309,153,156,7835.28,109,32,112,47,9
Kildare,335,171,164,180.02,127,23,141,34,10
Kildare,272,123,149,3308.48,101,17,140,14,0
Kildare,208,95,113,5242.99,76,18,89,22,3
Kildare,234,122,112,7614.96,70,21,119,20,4
Kildare,198,96,102,4261.46,59,10,100,21,8
Kildare,223,104,119,387.04,64,19,92,36,12
Kildare,357,175,182,32.55,92,32,108,91,34
Kildare,336,160,176,82.28,119,29,115,57,16
Kildare,315,155,160,51.28,66,24,89,69,67
Kildare,392,189,203,75.34,86,46,117,101,42
Kildare,248,128,120,75.87,54,36,86,54,18
Kildare,400,203,197,235.69,101,43,145,82,29
Kildare,298,147,151,32.99,37,36,71,56,98
Kildare,398,176,222,868.08,148,70,122,50,8
Kildare,492,256,236,5817.12,172,67,200,53,0
Kildare,306,143,163,5271.68,101,19,135,39,12
Kildare,362,189,173,6441.17,52,56,110,122,22
Kildare,393,192,201,6681.86,84,52,111,100,46
Kildare,180,99,81,3571.92,24,24,54,47,31
Kildare,276,138,138,2703.44,44,26,73,79,54
Kildare,163,87,76,1744.38,19,19,49,52,24
Kildare,380,198,182,9412.93,120,47,180,31,2
Kildare,301,149,152,6753.42,106,19,154,18,4
Kildare,231,108,123,7715.17,68,18,134,10,1
Kildare,379,185,194,1548.96,73,45,117,111,33
Kildare,177,94,83,3525.26,15,25,94,29,14
Kildare,394,194,200,6296.24,138,22,209,24,1
Kildare,278,138,140,4207.59,97,22,113,35,11
Kildare,242,117,125,4999.9,75,60,55,44,8
Kildare,277,146,131,5579.28,55,67,78,69,8
Kildare,201,95,106,4852.03,30,26,49,56,40
Kildare,206,113,93,565.22,38,16,74,44,34
Kildare,170,90,80,543.93,25,16,81,31,17
Kildare,103,53,50,2444.41,16,14,45,15,13
Kildare,176,99,77,949.04,31,29,55,34,27
Kildare,241,115,126,1030.07,45,26,102,50,18
Kildare,176,87,89,1955.97,34,18,40,59,25
Kildare,411,224,187,6547.19,130,51,183,45,2
Kildare,265,134,131,4835.06,89,23,133,19,1
Kildare,494,241,253,56.43,157,79,149,71,38
Kildare,205,107,98,16.22,57,19,56,49,24
Kildare,183,88,95,32.61,33,14,58,51,27
Kildare,311,157,154,6321.78,96,39,83,74,19
Kildare,202,89,113,1371.29,45,13,115,25,4
Kildare,290,134,156,2356.19,57,44,94,57,38
Kildare,239,122,117,36.65,63,13,96,48,19
Kildare,284,142,142,2953.78,36,30,64,111,43
Kildare,228,113,115,4287.97,39,31,41,90,27
Kildare,355,178,177,6157.1,68,48,87,98,54
Kildare,122,61,61,5051.55,14,14,68,17,9
Kildare,201,91,110,3613.68,68,9,99,23,2
Kildare,292,139,153,3257.73,88,31,91,60,22
Kildare,286,144,142,3586.16,88,41,91,59,7
Kildare,364,184,180,526.29,104,13,204,34,9
Kildare,250,120,130,25.32,44,30,80,59,37
Kildare,312,157,155,2866.44,118,26,104,56,8
Kildare,290,157,133,639.5,114,27,84,63,2
Kildare,279,131,148,317.77,107,16,91,50,15
Kildare,144,70,74,1396.97,23,9,55,34,23
Kildare,309,146,163,22.25,34,35,72,107,61
Kildare,321,159,162,21.33,79,48,83,84,27
Kildare,412,209,203,47.65,86,50,125,122,29
Kildare,352,185,167,202.22,92,49,103,76,32
Kildare,275,143,132,83.24,69,39,74,74,19
Kildare,184,90,94,144.91,37,24,56,43,24
Kildare,316,152,164,2240.94,105,29,126,41,15
Kildare,286,148,138,410.84,79,32,95,58,22
Kildare,255,129,126,37.53,55,42,80,62,16
Kildare,342,165,177,46.1,85,37,108,85,27
Kildare,274,139,135,181.25,92,9,107,46,20
Kildare,312,151,161,763.74,78,42,108,69,15
Kildare,380,187,193,957.8,142,49,131,45,13
Kildare,321,161,160,64.2,67,51,100,74,29
Kildare,374,184,190,129.19,116,30,137,72,19
Kildare,376,195,181,39.77,88,46,112,90,40
Kildare,490,227,263,44.06,116,61,149,115,49
Kildare,404,197,207,46.57,131,40,122,82,29
Kildare,336,169,167,26.06,94,34,99,75,34
Kildare,286,144,142,23.45,82,27,81,70,26
Kildare,369,188,181,63.74,101,41,131,74,22
Kildare,322,163,159,38.69,78,37,80,85,42
Kildare,255,136,119,27.81,46,41,59,75,34
Kildare,398,192,206,59.15,127,36,127,81,27
Kildare,392,208,184,20.8,92,43,127,94,36
Kildare,266,143,123,34.39,56,42,74,72,22
Kildare,320,162,158,30.73,96,47,73,79,25
Kildare,355,175,180,180,120,40,91,66,38
Kildare,387,193,194,3961.43,61,76,101,138,11
Kildare,272,134,138,6396.54,23,32,76,97,44
Kildare,211,94,117,4888.9,42,14,50,52,53
Kildare,433,226,207,4523.99,164,48,126,91,4
Kildare,274,136,138,4949.42,45,46,71,96,16
Kildare,345,174,171,5042.9,45,49,81,150,20
Kildare,291,147,144,4414.78,46,36,72,105,32
Kildare,303,150,153,3330.07,40,45,96,98,24
Kildare,493,234,259,1888.82,189,38,196,65,5
Kildare,262,129,133,7109.33,80,15,152,14,1
Kildare,271,130,141,157.15,54,17,174,20,6
Kildare,174,81,93,5003.74,14,19,43,49,49
Kildare,297,152,145,4852.39,49,54,84,101,9
Kildare,223,119,104,5295.4,41,45,75,54,8
Kildare,424,196,228,3894.62,197,37,146,36,8
Kildare,344,174,170,4472.53,64,74,92,105,9
Kildare,223,109,114,2038.61,47,32,68,66,10
Kildare,404,214,190,4336.16,108,69,107,114,6
Kildare,262,124,138,7816.7,57,55,69,81,0
Kildare,246,127,119,7384.5,53,52,66,74,1
Kildare,335,168,167,5790.64,49,73,79,125,9
Kildare,288,145,143,7060.73,55,62,88,78,5
Kildare,383,193,190,7144.59,160,22,163,37,1
Kildare,276,138,138,5343.35,91,27,116,36,6
Kildare,244,122,122,13165.7,36,43,154,10,1
Kildare,507,234,273,3635.92,205,78,147,65,12
Kildare,368,177,191,4860.01,43,59,94,98,74
Kildare,243,119,124,6652.8,30,48,52,95,18
Kildare,325,167,158,4127.72,33,90,38,147,17
Kildare,244,129,115,4413.01,35,30,64,93,22
Kildare,252,116,136,5148.85,26,37,53,116,20
Kildare,332,168,164,568.3,40,38,96,96,62
Kildare,224,107,117,3299.89,20,30,45,107,22
Kildare,360,179,181,3544.32,82,30,111,83,54
Kildare,246,123,123,1925.67,62,28,129,20,7
Kildare,254,126,128,4953.2,29,28,58,88,51
Kildare,239,122,117,8059.89,39,32,67,58,43
Kildare,243,120,123,5350.3,14,25,81,69,54
Kildare,192,96,96,4216.35,26,29,45,50,42
Kildare,362,189,173,6039.37,135,33,118,63,13
Kildare,293,153,140,6105.57,91,30,121,50,1
Kildare,282,134,148,10375.66,48,47,75,101,11
Kildare,324,159,165,6054.04,68,35,119,87,15
Kildare,481,230,251,3618.66,64,29,135,94,159
Kildare,220,106,114,5107.25,39,27,54,82,18
Kildare,266,160,106,510.36,21,28,88,86,43
Kildare,267,131,136,5360.05,57,51,67,84,8
Kildare,256,126,130,1635.75,52,52,53,90,9
Kildare,306,151,155,73.11,70,50,87,85,14
Kildare,258,129,129,7783.51,42,57,57,95,7
Kildare,401,183,218,1182.67,158,30,190,21,2
Kildare,187,96,91,215.71,24,17,45,47,54
Kildare,191,91,100,8.88,46,17,61,42,25
Kildare,248,114,134,2473.91,51,41,76,58,22
Kildare,202,107,95,746.14,44,42,87,24,5
Kildare,291,142,149,3865.36,79,39,102,60,11
Kildare,308,177,131,2342.22,51,102,105,49,1
Kildare,410,210,200,4104.68,121,53,124,90,22
Kildare,274,137,137,1035.87,25,81,75,76,17
Kildare,269,146,123,6385.45,90,35,69,63,12
Kildare,320,163,157,5810.58,87,49,99,76,9
Kildare,383,205,178,7094.04,40,155,109,67,12
Kildare,310,149,161,7542.4,57,97,119,36,1
Kildare,194,92,102,4586.51,24,57,60,46,7
Kildare,314,157,157,5405.31,48,98,66,92,10
Kildare,331,161,170,5329.08,60,55,97,82,37
Kildare,212,104,108,6537.96,35,63,72,38,4
Kildare,300,139,161,6564.26,66,78,110,42,4
Kildare,270,132,138,3638.57,48,37,80,79,26
Kildare,244,123,121,3308.97,30,34,61,77,42
Kildare,265,141,124,4759.34,67,37,147,14,0
Kildare,341,171,170,6104.33,123,43,106,64,5
Kildare,365,182,183,2911.34,71,57,104,96,37
Kildare,181,84,97,4068.97,17,47,55,33,29
Kildare,232,121,111,4511.78,37,40,64,66,25
Kildare,298,147,151,3822.87,43,64,74,75,42
Kildare,273,133,140,436.18,40,47,79,69,38
Kildare,210,105,105,7766.27,31,20,154,5,0
Kildare,293,145,148,3411.74,61,21,196,11,4
Kildare,282,139,143,2074.2,65,51,99,60,7
Kildare,288,146,142,2476.48,85,43,90,58,12
Kildare,234,106,128,3567.56,45,20,149,19,1
Kildare,290,157,133,915.35,84,43,89,71,3
Kildare,189,106,83,1821.7,12,47,99,23,8
Kildare,134,58,76,1165.77,6,29,25,26,48
Kildare,118,61,57,15943.79,10,22,75,9,2
Kildare,274,147,127,11720.92,29,61,169,14,1
Kildare,223,114,109,2456.89,60,39,105,16,3
Kildare,223,112,111,67.45,52,15,71,56,29
Kildare,352,163,189,38.38,38,48,79,74,113
Kildare,308,200,108,46.4,37,56,96,91,28
Kildare,222,105,117,705.67,1,193,18,9,1
Kildare,463,247,216,6592.62,144,71,160,79,9
Kildare,288,137,151,951.65,76,35,162,15,0
Kildare,176,90,86,3958.08,42,13,43,23,55
Kildare,321,158,163,1676.3,77,23,204,17,0
Kildare,255,133,122,6160.02,34,39,153,23,6
Kildare,280,136,144,935.92,54,61,81,69,15
Kildare,210,122,88,284.95,18,55,76,42,19
Kildare,381,147,234,1605.54,1,349,29,2,0
Kildare,326,151,175,5193.48,53,104,70,87,12
Kildare,442,221,221,50.92,140,26,169,87,20
Kildare,363,152,211,54.7,65,36,77,119,66
Kildare,196,98,98,3660.2,63,16,73,33,11
Kildare,302,149,153,1830.39,74,51,93,71,13
Kildare,241,126,115,6173.16,45,17,78,57,44
Kildare,292,141,151,4765.64,87,23,156,24,2
Kildare,238,123,115,2793.33,53,39,82,52,12
Kildare,388,185,203,1751.65,88,58,105,101,36
Kildare,347,177,170,63.63,68,54,86,92,47
Kildare,100,44,56,585.47,16,6,29,33,16
Kildare,114,59,55,1762.11,10,19,51,28,6
Kildare,146,79,67,951.91,17,21,49,36,23
Kildare,136,58,78,1488.93,25,21,38,25,27
Kildare,230,107,123,269.08,85,18,100,21,6
Kildare,153,74,79,205.26,40,20,69,22,2
Kildare,279,150,129,178.24,71,19,105,59,25
Kildare,299,145,154,29.11,64,38,74,76,47
Kildare,300,145,155,4527.14,83,28,152,29,8
Kildare,223,108,115,322.09,57,30,83,44,9
Kildare,471,233,238,26.84,108,55,135,120,53
Kildare,343,171,172,390.32,100,42,85,89,27
Kildare,291,142,149,5774.5,85,28,108,60,10
Kildare,332,167,165,5029.24,49,46,96,120,21
Kildare,287,134,153,236.02,106,23,117,37,4
Kildare,306,147,159,6083.38,63,77,76,84,6
Kildare,237,122,115,322.39,55,14,120,36,12
Kildare,269,128,141,5373.87,70,23,148,21,7
Kildare,277,140,137,89.5,48,31,94,70,34
Kildare,239,122,117,812.22,41,40,47,87,24
Kildare,193,100,93,48.18,33,33,41,61,25
Kildare,303,147,156,5163.16,48,43,88,86,38
Kildare,280,141,139,2916,33,52,101,54,40
Kildare,361,174,187,4434.02,100,48,144,58,11
Kildare,455,221,234,6249.91,164,43,173,70,5
Kildare,295,149,146,3589.72,71,39,80,74,31
Kildare,309,149,160,531.36,91,24,133,45,16
Kildare,299,135,164,4770.64,132,23,113,23,8
Kildare,286,145,141,1316.25,78,32,107,62,7
Kildare,243,127,116,1844.92,30,24,86,59,44
Kildare,256,123,133,5007.73,58,40,65,66,27
Kildare,409,211,198,8817.89,99,55,147,92,16
Kildare,311,152,159,6173.08,72,34,111,62,32
Kildare,372,179,193,6108.47,125,47,140,54,6
Kildare,209,95,114,5630.08,36,28,50,71,24
Kildare,255,118,137,6302.52,94,23,114,20,4
Kildare,269,121,148,6053.24,103,37,97,30,2
Kildare,228,105,123,5655.6,62,31,87,37,11
Kildare,243,120,123,902.14,60,31,95,44,13
Kildare,245,120,125,5835.28,80,18,122,21,4
Kildare,297,140,157,4585.88,102,20,156,14,5
Kildare,232,120,112,7586.91,47,26,73,55,31
Kildare,206,99,107,5378.73,22,34,55,68,27
Kildare,419,203,216,4782.94,146,27,207,35,4
Kildare,218,111,107,9710.47,45,22,136,13,2
Kildare,201,91,110,3094.4,36,23,43,72,27
Kildare,260,138,122,8332.8,74,28,135,20,3
Kildare,151,70,81,1748.62,20,18,32,47,34
Kildare,345,163,182,3867.71,96,48,116,78,7
Kildare,238,104,134,2951.24,85,14,110,25,4
Kildare,256,126,130,3756.14,77,17,148,14,0
Kildare,258,121,137,4428.2,45,52,57,80,24
Kildare,253,129,124,2235.08,80,23,107,31,12
Kildare,243,124,119,1119.23,74,22,99,42,6
Kildare,252,126,126,4382.68,23,27,57,84,61
Kildare,253,124,129,3891.05,63,30,67,67,26
Kildare,206,82,124,3438.84,35,26,77,38,30
Kildare,168,83,85,1101.42,7,32,29,71,29
Kildare,237,125,112,7525.48,72,14,141,10,0
Kildare,303,140,163,99.92,61,43,99,75,25
Kildare,454,219,235,3434.09,226,29,169,23,7
Kildare,283,141,142,33.85,54,37,69,81,42
Kildare,208,112,96,50.68,32,32,53,65,26
Kildare,287,149,138,3276.89,53,17,197,13,7
Kildare,318,149,169,2312.05,106,16,163,27,6
Kildare,247,123,124,3321.72,60,24,94,50,19
Kildare,168,87,81,2549.32,16,21,115,9,7
Kildare,326,161,165,3563.78,128,14,166,16,2
Kildare,203,98,105,319,45,16,117,20,5
Kildare,313,154,159,3532.33,100,37,114,59,3
Kildare,392,195,197,6203.22,114,38,156,76,8
Kildare,458,237,221,7835.89,157,37,196,58,10
Kildare,444,209,235,2545.48,138,46,154,90,16
Kildare,265,125,140,2748.14,88,17,85,57,18
Kildare,368,175,193,5637.69,103,40,147,70,8
Kildare,336,165,171,5465.1,105,24,155,48,4
Kildare,356,178,178,3732.67,88,38,137,84,9
Kildare,319,148,171,2627.18,50,47,82,121,19
Kildare,296,140,156,6181.99,77,44,116,55,4
Kildare,269,130,139,5428.31,49,52,84,71,13
Kildare,332,178,154,5378.52,67,63,76,110,16
Kildare,371,172,199,2688.48,75,26,139,50,81
Kildare,317,156,161,2984.03,32,45,79,111,50
Kildare,305,150,155,6885.03,87,42,118,55,3
Kildare,418,207,211,7276.65,133,44,177,58,6
Kildare,402,203,199,6153.94,103,47,184,65,3
Kildare,324,156,168,6669.27,84,37,149,51,3
Kildare,239,100,139,2313.67,65,18,135,21,0
Kildare,215,106,109,492.23,23,21,92,43,36
Kildare,435,191,244,395.77,184,64,153,28,6
Kildare,300,148,152,1570.86,60,40,75,89,36
Kildare,293,144,149,1161.63,47,29,59,101,57
Kildare,274,131,143,107.72,37,31,154,39,13
Kildare,354,174,180,2596.22,64,46,90,128,26
Kildare,260,126,134,3093.65,42,40,64,65,49
Kildare,264,135,129,4321.28,36,56,71,81,20
Kildare,277,149,128,4126.81,57,38,93,73,16
Kildare,257,118,139,2394.51,68,17,150,19,3
Kildare,280,138,142,2154.59,86,25,101,56,12
Kildare,424,216,208,4480.75,121,40,199,56,8
Kildare,266,137,129,4012.79,52,30,102,71,11
Kildare,363,185,178,2742.87,111,37,128,79,8
Kildare,233,122,111,6590.48,72,22,113,19,7
Kildare,401,197,204,3673.24,103,57,140,92,9
Kildare,461,238,223,2975.79,159,40,188,63,11
Kildare,367,180,187,4240.96,104,28,211,23,1
Kildare,208,108,100,5261.83,31,23,61,66,27
Kildare,256,120,136,3661.38,41,35,60,77,43
Kildare,336,170,166,2915.63,54,30,91,100,61
Kildare,218,112,106,5367.48,38,34,59,71,16
Kildare,209,93,116,4185.11,32,26,74,59,18
Kildare,509,261,248,2495.21,45,39,103,151,171
Kildare,153,83,70,1504.99,23,21,68,24,17
Kildare,200,106,94,1519.01,25,24,45,66,40
Kildare,414,206,208,2529.06,114,44,119,114,23
Kildare,428,234,194,7302.76,116,44,169,91,8
Kildare,323,168,155,6086.65,60,53,133,69,8
Kildare,277,129,148,1988.76,44,18,71,73,71
Kildare,200,109,91,4582.22,29,22,79,47,23
Kildare,211,108,103,3788.29,24,32,51,59,45
Kildare,344,177,167,110.89,60,52,61,120,51
Kildare,274,148,126,4515.57,67,33,135,39,0
Kildare,275,124,151,3780.64,52,25,99,40,59
Kildare,271,117,154,239.69,57,12,96,27,79
Kildare,295,148,147,6667.42,92,47,116,36,4
Kildare,453,222,231,2011.46,122,66,127,110,28
Kildare,333,151,182,805.12,28,40,174,71,20
Kildare,252,134,118,2758.74,53,36,75,54,34
Kildare,299,151,148,259.45,52,41,83,80,43
Kildare,296,151,145,2960.92,76,51,56,100,13
Kildare,302,157,145,2250.37,58,39,101,87,17
Kildare,262,125,137,5667.07,60,38,73,82,9
Kildare,215,111,104,2174.13,37,24,56,65,33
Kildare,319,165,154,5668.49,44,48,78,81,68
Kildare,133,68,65,2102.43,8,14,51,26,34
Kildare,180,86,94,5193.61,31,8,46,42,53
Kildare,333,152,181,117.27,62,39,81,98,53
Kildare,254,142,112,77.74,90,24,77,48,15
Kildare,248,138,110,23.6,45,28,70,71,34
Kildare,282,145,137,92.34,100,25,91,54,12
Kildare,412,208,204,22.4,99,42,105,129,37
Kildare,210,96,114,110.68,60,23,87,28,12
Kildare,218,98,120,1607.17,78,11,110,15,4
Kildare,211,104,107,39.9,41,17,69,57,27
Kildare,342,180,162,54.74,106,40,108,73,15
Kildare,257,124,133,367.05,91,27,85,47,7
Kildare,149,80,69,430.04,34,26,67,20,2
Kildare,201,102,99,33.97,33,29,55,47,37
Kildare,441,233,208,103.06,138,37,141,91,34
Kildare,262,136,126,34.38,52,25,74,60,51
Kildare,368,195,173,48.58,100,33,98,91,46
Kildare,358,201,157,42.97,76,46,83,112,41
Kildare,305,163,142,28.13,70,34,94,83,24
Kildare,145,72,73,9.98,29,19,49,38,10
Kildare,304,139,165,35.79,78,42,74,76,34
Kildare,271,133,138,417.95,96,18,105,38,14
Kildare,192,98,94,135.25,44,17,71,36,24
Kildare,157,77,80,2559.5,37,7,91,17,5
Kildare,285,139,146,198,78,43,85,62,17
Kildare,213,88,125,1756.22,71,27,66,37,12
Kildare,176,88,88,3018.56,50,17,96,8,5
Kildare,234,117,117,182.63,56,16,113,32,17
Kildare,166,86,80,236.03,23,15,50,42,36
Kildare,274,136,138,1304.66,47,28,79,78,42
Kildare,284,143,141,43.81,77,24,96,60,27
Kildare,330,166,164,30.06,78,37,94,91,30
Kildare,463,221,242,55.12,125,63,120,120,35
Kildare,368,174,194,54.25,87,62,66,128,25
Kildare,326,170,156,35.68,80,40,75,93,38
Kildare,364,182,182,80.12,74,36,119,99,36
Kildare,277,153,124,62.24,60,32,73,84,28
Kildare,200,96,104,1804.22,31,27,41,67,34
Kildare,420,199,221,110.77,148,32,152,70,18
Kildare,216,109,107,4624.18,33,32,65,57,29
Kildare,224,113,111,364.4,65,24,63,53,19
Kildare,222,109,113,455.28,75,19,79,35,14
Kildare,259,129,130,19.88,60,22,80,65,32
Kildare,399,189,210,202.56,128,39,134,80,18
Kildare,318,164,154,365.07,61,31,127,73,26
Kildare,193,103,90,578.88,51,21,66,40,15
Kildare,348,175,173,69.9,44,44,97,109,54
Kildare,368,179,189,112.09,87,51,99,95,36
Kildare,479,230,249,28.91,113,63,120,134,49
Kildare,270,130,140,24.59,80,29,83,55,23
Kildare,310,158,152,36.32,87,35,95,61,32
Kildare,288,137,151,518.17,108,29,114,28,9
Kildare,239,116,123,19.77,67,26,71,55,20
Kildare,298,150,148,30.65,70,38,86,81,23
Kildare,346,171,175,43.18,91,40,106,84,25
Kildare,206,111,95,32.74,51,27,55,56,17
Kildare,301,154,147,22.67,70,39,84,84,24
Kildare,471,225,246,127.45,170,35,173,65,28
Kildare,246,123,123,28.49,57,26,70,76,17
Kildare,256,121,135,24.75,60,19,78,54,45
Kildare,366,194,172,30.71,91,43,107,92,33
Kildare,320,155,165,559.84,102,27,121,49,21
Kildare,237,112,125,219.21,76,22,89,36,14
Kildare,214,95,119,524.61,66,16,81,35,16
Kildare,217,113,104,1580.04,36,35,71,38,37
Kildare,202,105,97,1192.36,47,38,57,43,17
Kildare,214,108,106,723.07,42,26,40,69,37
Kildare,153,72,81,1300.26,22,22,34,46,29
Kildare,115,58,57,1431.36,11,12,54,26,12
Kildare,303,154,149,1099.17,51,24,81,83,64
Kildare,155,79,76,2196.18,25,11,36,40,43
Kildare,142,80,62,1332.07,16,14,66,34,12
Kildare,180,82,98,1335.5,45,16,53,37,29
Kildare,247,122,125,966.15,39,36,60,81,31
Kildare,261,126,135,2342.47,101,27,110,23,0
Kildare,264,133,131,6233.03,102,28,111,17,6
Kildare,246,123,123,5901.4,82,24,114,22,4
Kildare,206,99,107,1881.48,67,35,85,17,2
Kildare,184,84,100,4168.55,45,28,50,44,17
Kildare,293,146,147,5515.71,59,38,69,63,64
Kildare,238,106,132,2674.97,61,36,75,53,13
Kildare,247,125,122,4092.79,75,21,100,39,12
Kilkenny,208,101,107,23.11,60,20,60,45,23
Kilkenny,195,103,92,22.64,28,26,57,68,16
Kilkenny,218,108,110,86.39,52,28,56,52,30
Kilkenny,227,128,99,60.38,58,18,69,63,19
Kilkenny,215,119,96,41.12,41,20,54,57,43
Kilkenny,211,110,101,42.34,26,28,49,60,48
Kilkenny,395,190,205,15.72,84,71,81,101,58
Kilkenny,218,116,102,12.91,39,28,66,54,31
Kilkenny,228,117,111,29.85,55,26,56,68,23
Kilkenny,366,188,178,20.96,83,64,90,99,30
Kilkenny,310,164,146,18.25,66,35,93,75,41
Kilkenny,286,151,135,12.67,73,40,82,64,27
Kilkenny,453,243,210,21.54,108,62,106,114,63
Kilkenny,255,132,123,17.08,48,34,67,69,37
Kilkenny,211,111,100,30.14,51,30,52,56,22
Kilkenny,157,68,89,104.97,27,11,57,34,28
Kilkenny,311,148,163,32.88,47,37,73,71,83
Kilkenny,188,95,93,13.13,31,32,39,55,31
Kilkenny,315,152,163,277.37,69,40,79,86,41
Kilkenny,184,90,94,284.18,32,20,56,46,30
Kilkenny,254,124,130,1257.56,88,24,97,37,8
Kilkenny,280,140,140,298.65,39,53,50,102,36
Kilkenny,174,88,86,14.76,38,21,44,57,14
Kilkenny,153,84,69,8.79,25,20,42,40,26
Kilkenny,401,205,196,22.44,97,40,106,103,55
Kilkenny,349,177,172,516.02,83,30,123,86,27
Kilkenny,291,149,142,542.06,41,25,72,93,60
Kilkenny,124,64,60,9.87,24,10,42,28,20
Kilkenny,257,134,123,19.46,93,12,79,43,30
Kilkenny,133,77,56,12.74,32,14,39,29,19
Kilkenny,278,143,135,30.86,79,32,58,80,29
Kilkenny,277,142,135,52.18,95,16,85,60,21
Kilkenny,201,101,100,19.75,39,21,49,64,28
Kilkenny,314,163,151,30.16,69,37,72,87,49
Kilkenny,339,173,166,35.78,79,48,82,91,39
Kilkenny,322,169,153,30.6,78,35,83,88,38
Kilkenny,381,174,207,1191.15,116,20,131,47,67
Kilkenny,338,152,186,546.54,75,31,125,55,52
Kilkenny,224,108,116,2569.46,54,35,61,66,8
Kilkenny,152,69,83,2224.08,32,20,91,8,1
Kilkenny,136,77,59,830.8,13,12,41,33,37
Kilkenny,268,140,128,2410.9,37,38,61,79,53
Kilkenny,152,79,73,1334.64,15,15,33,56,33
Kilkenny,236,110,126,1620.82,57,27,54,41,57
Kilkenny,186,97,89,873.95,55,8,87,29,7
Kilkenny,127,66,61,9.18,33,17,30,37,10
Kilkenny,216,105,111,4030.08,67,32,91,18,8
Kilkenny,287,146,141,31.66,54,53,68,75,37
Kilkenny,295,162,133,34.78,67,41,69,79,39
Kilkenny,266,133,133,84.54,44,40,59,75,48
Kilkenny,299,147,152,51.61,50,55,47,106,41
Kilkenny,239,115,124,2834.74,43,25,44,72,55
Kilkenny,277,128,149,4656.32,65,24,109,46,33
Kilkenny,176,92,84,47.91,38,16,35,48,39
Kilkenny,120,56,64,968.82,10,7,23,37,43
Kilkenny,118,62,56,791,9,14,18,49,28
Kilkenny,124,66,58,10.17,22,14,42,29,17
Kilkenny,232,112,120,21.26,54,30,53,72,23
Kilkenny,392,188,204,37.44,74,57,95,108,58
Kilkenny,382,186,196,20.63,76,54,112,99,41
Kilkenny,296,160,136,90.46,66,23,73,94,40
Kilkenny,331,162,169,50.2,73,60,73,96,29
Kilkenny,267,137,130,41.12,59,28,67,69,44
Kilkenny,237,116,121,15.91,46,30,58,73,30
Kilkenny,290,137,153,15.97,54,35,67,88,46
Kilkenny,412,190,222,15.81,103,47,124,81,57
Kilkenny,249,129,120,29.99,65,23,60,59,42
Kilkenny,272,129,143,20.61,56,33,70,78,35
Kilkenny,288,136,152,17.43,67,37,63,87,34
Kilkenny,221,104,117,41.83,48,32,42,72,27
Kilkenny,247,128,119,25.14,59,24,52,87,25
Kilkenny,283,148,135,28.18,53,35,67,86,42
Kilkenny,241,128,113,17.99,39,26,62,76,38
Kilkenny,237,132,105,347.56,53,21,64,66,33
Kilkenny,247,125,122,50.03,57,20,69,64,37
Kilkenny,286,145,141,62.62,68,34,86,58,40
Kilkenny,288,148,140,43.7,60,34,76,80,38
Kilkenny,426,215,211,33.08,81,72,83,148,42
Kilkenny,135,64,71,208.68,32,12,51,32,8
Kilkenny,394,202,192,21.81,109,39,107,94,45
Kilkenny,268,136,132,24.61,48,29,72,78,41
Kilkenny,221,115,106,17.75,46,31,49,73,22
Kilkenny,236,112,124,229.01,59,22,74,64,17
Kilkenny,309,153,156,29.44,65,42,79,82,41
Kilkenny,318,165,153,17.08,71,40,83,83,41
Kilkenny,297,153,144,21.28,73,28,100,71,25
Kilkenny,270,138,132,45.77,61,37,80,60,32
Kilkenny,276,134,142,28,54,44,65,81,32
Kilkenny,189,97,92,208.91,53,15,64,33,24
Kilkenny,237,121,116,244.26,67,28,107,28,7
Kilkenny,243,124,119,10.65,69,23,66,51,34
Kilkenny,379,202,177,42.79,86,47,107,100,39
Kilkenny,369,185,184,29.39,80,27,98,89,75
Kilkenny,273,139,134,1036.02,30,36,55,61,91
Kilkenny,304,155,149,11.55,67,26,80,78,53
Kilkenny,328,165,163,15.62,72,46,85,84,41
Kilkenny,213,111,102,26.79,40,30,45,69,29
Kilkenny,226,111,115,80.21,40,36,67,60,23
Kilkenny,150,68,82,1341.44,26,19,40,40,25
Kilkenny,390,190,200,34.43,120,42,114,79,35
Kilkenny,358,180,178,26.82,91,44,100,83,40
Kilkenny,229,115,114,588.85,75,26,89,28,11
Kilkenny,212,107,105,1504.84,42,24,77,42,27
Kilkenny,262,112,150,435.22,50,19,62,59,72
Kilkenny,228,123,105,13.13,55,24,65,57,27
Kilkenny,373,190,183,1424.13,95,39,106,81,52
Kilkenny,258,135,123,25.17,75,25,74,51,33
Kilkenny,270,130,140,417.28,47,27,73,58,65
Kilkenny,187,95,92,69,43,20,53,46,25
Kilkenny,206,101,105,321.27,33,18,51,60,44
Kilkenny,126,52,74,1518.02,41,13,53,18,1
Kilkenny,186,97,89,1772.24,40,17,39,40,50
Kilkenny,287,146,141,29.89,79,40,62,79,27
Kilkenny,291,159,132,48.85,68,43,67,89,24
Kilkenny,255,131,124,70.46,59,32,55,78,31
Kilkenny,153,85,68,22.51,31,14,29,57,22
Kilkenny,174,80,94,20.24,32,27,46,56,13
Kilkenny,185,98,87,16.56,45,14,51,46,29
Kilkenny,142,77,65,329.23,23,11,33,42,33
Kilkenny,126,55,71,1237.37,34,10,38,31,13
Kilkenny,375,185,190,26.85,92,56,90,101,36
Kilkenny,249,121,128,201.47,69,20,90,49,21
Kilkenny,261,125,136,184.87,50,32,73,68,38
Kilkenny,259,132,127,11.64,90,15,94,36,24
Kilkenny,375,186,189,27.31,79,29,89,106,72
Kilkenny,216,114,102,238.04,31,25,58,53,49
Kilkenny,303,154,149,58.58,58,51,71,94,29
Kilkenny,292,156,136,24.62,75,24,72,80,41
Kilkenny,353,181,172,49.93,101,41,92,92,27
Kilkenny,194,108,86,14.65,51,17,64,40,22
Kilkenny,427,222,205,32.17,130,41,129,72,55
Kilkenny,254,132,122,18.41,67,33,66,63,25
Kilkenny,325,163,162,59.93,68,43,73,120,21
Kilkenny,356,180,176,5355.64,111,19,190,33,3
Kilkenny,170,89,81,138.58,35,21,82,25,7
Kilkenny,209,98,111,1409.06,38,26,69,53,23
Kilkenny,324,155,169,4544.56,99,28,170,23,4
Kilkenny,311,130,181,6658.82,141,31,113,22,4
Kilkenny,248,119,129,810.09,62,26,111,40,9
Kilkenny,335,162,173,128.96,45,21,90,75,104
Kilkenny,254,126,128,4648.27,74,15,135,26,4
Kilkenny,306,139,167,665.92,121,28,108,45,4
Kilkenny,151,62,89,164.12,44,25,36,35,11
Kilkenny,204,108,96,5046.51,43,19,91,38,13
Kilkenny,185,98,87,4635.43,58,14,97,13,3
Kilkenny,142,67,75,698.43,34,18,74,12,4
Kilkenny,189,92,97,1448.09,55,15,98,14,7
Kilkenny,332,146,186,1727.83,80,33,138,41,40
Kilkenny,358,180,178,6760.07,113,39,179,25,2
Kilkenny,239,117,122,283.48,49,29,127,24,10
Kilkenny,225,108,117,188.11,36,27,64,61,37
Kilkenny,273,133,140,1417.74,48,39,75,81,30
Kilkenny,267,139,128,16.97,63,23,83,61,37
Kilkenny,359,186,173,19.57,95,36,113,88,27
Kilkenny,174,94,80,3184.31,28,17,59,39,31
Kilkenny,240,110,130,3608.97,22,19,86,59,54
Kilkenny,294,146,148,1838.32,39,34,82,86,53
Kilkenny,304,149,155,6254.11,74,39,157,25,9
Kilkenny,445,242,203,2688.06,123,58,224,36,4
Kilkenny,275,129,146,6187.56,18,37,91,61,68
Kilkenny,157,86,71,8618.8,17,25,83,26,6
Kilkenny,172,83,89,4211.87,20,20,41,50,41
Kilkenny,248,123,125,2536.02,29,28,66,67,58
Kilkenny,271,127,144,4557.07,40,34,74,64,59
Kilkenny,130,81,49,2687.45,7,17,70,27,9
Kilkenny,108,51,57,1645.46,11,17,38,17,25
Kilkenny,167,108,59,4076.25,22,14,78,35,18
Kilkenny,170,79,91,4176.19,31,30,36,40,33
Kilkenny,191,102,89,2883.24,23,35,52,58,23
Kilkenny,382,162,220,3778.44,79,56,108,87,52
Kilkenny,191,83,108,2253.58,18,14,58,33,68
Kilkenny,254,124,130,3690.68,53,25,70,72,34
Kilkenny,177,80,97,2863.61,25,29,50,47,26
Kilkenny,243,121,122,1221.54,41,18,77,67,40
Kilkenny,264,142,122,2954.54,67,42,61,65,29
Kilkenny,217,95,122,1530.53,65,11,89,30,22
Kilkenny,137,72,65,1981.86,14,11,31,40,41
Kilkenny,198,95,103,3171.3,29,20,69,49,31
Kilkenny,150,71,79,2991.27,19,8,36,52,35
Kilkenny,163,74,89,4318.91,21,14,42,49,37
Kilkenny,120,72,48,3289.56,17,11,47,18,27
Kilkenny,200,99,101,609.51,9,18,52,72,49
Kilkenny,249,112,137,2605.94,33,17,71,79,49
Kilkenny,160,77,83,3344.55,17,24,40,43,36
Kilkenny,297,142,155,1812.08,37,19,68,99,74
Kilkenny,205,114,91,2774.88,15,30,134,19,7
Kilkenny,317,167,150,1467.82,44,34,82,84,73
Kilkenny,209,94,115,1355.57,32,17,46,58,56
Kilkenny,155,84,71,1853.42,25,22,39,37,32
Kilkenny,124,52,72,2462.71,7,15,30,40,32
Kilkenny,320,153,167,2955.71,37,44,66,130,43
Kilkenny,361,170,191,65.08,43,45,54,107,112
Kilkenny,346,178,168,50.8,62,46,48,133,57
Kilkenny,335,164,171,2532.01,119,43,144,28,1
Kilkenny,276,138,138,1041.82,81,31,95,38,31
Kilkenny,279,128,151,8693.48,80,44,73,68,14
Kilkenny,287,135,152,3535.18,37,48,67,87,48
Kilkenny,197,92,105,7115,45,22,116,14,0
Kilkenny,186,96,90,9043.61,37,19,112,18,0
Kilkenny,255,131,124,2232.65,70,21,141,20,3
Kilkenny,287,142,145,2178.47,52,37,75,75,48
Kilkenny,243,122,121,2202.68,76,28,63,68,8
Kilkenny,323,168,155,344.22,99,17,148,41,18
Kilkenny,222,104,118,46.69,37,29,42,83,31
Kilkenny,272,123,149,3997.82,30,11,58,70,103
Kilkenny,315,148,167,3447.45,84,34,152,39,6
Kilkenny,283,134,149,4323.65,65,40,72,86,20
Kilkenny,353,167,186,2455.24,103,54,97,88,11
Kilkenny,294,141,153,4398.1,65,31,116,64,18
Kilkenny,274,129,145,3830.99,58,21,161,33,1
Kilkenny,296,147,149,2501.5,83,27,119,55,12
Kilkenny,192,93,99,3993.76,49,27,96,16,4
Kilkenny,298,153,145,1152.68,55,49,91,81,22
Kilkenny,227,108,119,4438.45,48,35,73,57,14
Kilkenny,262,127,135,1538.98,30,38,52,112,30
Kilkenny,300,136,164,3484.64,46,60,68,102,24
Kilkenny,222,100,122,4122.41,71,23,83,37,8
Kilkenny,232,113,119,3358.52,30,33,50,98,21
Kilkenny,295,136,159,3584.8,64,44,68,97,22
Kilkenny,209,98,111,2467.01,16,15,48,87,43
Kilkenny,322,148,174,7178.69,39,53,61,136,33
Kilkenny,223,115,108,6181.22,34,20,62,82,25
Kilkenny,227,112,115,3507.47,37,26,107,38,19
Kilkenny,135,62,73,1168.81,37,12,61,20,5
Kilkenny,204,98,106,3490.94,65,12,85,39,3
Kilkenny,290,147,143,203.11,70,19,58,92,51
Kilkenny,203,98,105,1973.67,34,17,49,49,54
Kilkenny,342,157,185,1645.54,133,57,109,35,8
Kilkenny,198,100,98,9270.53,49,22,112,14,1
Kilkenny,201,103,98,2654.31,19,29,43,67,43
Kilkenny,213,103,110,1813.61,40,23,131,16,3
Kilkenny,354,166,188,5284.84,87,34,164,52,17
Kilkenny,173,76,97,2466.43,39,17,98,16,3
Kilkenny,257,135,122,3138.97,73,27,122,33,2
Kilkenny,537,292,245,435.41,142,216,65,71,43
Kilkenny,279,138,141,6808.37,76,30,137,31,5
Kilkenny,304,144,160,6045.78,71,13,201,16,3
Kilkenny,283,142,141,4429.77,74,22,135,46,6
Kilkenny,177,74,103,5586.94,26,26,50,53,22
Kilkenny,301,154,147,925.57,96,35,70,84,16
Kilkenny,163,76,87,2129.19,31,13,59,39,21
Kilkenny,212,98,114,1997.25,35,24,35,76,42
Kilkenny,527,231,296,751.41,93,44,97,119,174
Kilkenny,402,192,210,3021.65,101,30,155,84,32
Kilkenny,219,98,121,1764.73,53,22,92,36,16
Kilkenny,397,197,200,170.45,69,49,156,90,33
Kilkenny,302,153,149,29.62,43,44,68,77,70
Kilkenny,219,115,104,166.7,37,29,56,60,37
Kilkenny,221,105,116,772.02,74,15,88,39,5
Kilkenny,223,103,120,6017.59,47,43,56,62,15
Kilkenny,373,170,203,2463.28,82,70,114,91,16
Kilkenny,231,118,113,6745.71,59,23,120,25,4
Kilkenny,200,98,102,7379.26,50,17,115,18,0
Kilkenny,327,171,156,30.78,111,23,103,59,31
Kilkenny,361,182,179,28.69,115,33,103,76,34
Kilkenny,215,121,94,21.73,39,28,72,54,22
Kilkenny,228,122,106,29.51,53,30,65,47,33
Kilkenny,265,139,126,159.79,43,32,59,79,52
Kilkenny,214,113,101,16.5,48,27,48,59,32
Kilkenny,218,112,106,20.57,50,29,57,54,28
Kilkenny,234,122,112,18.38,49,41,52,67,25
Kilkenny,250,134,116,29.86,52,27,57,67,47
Kilkenny,260,138,122,31.33,59,29,84,60,28
Kilkenny,163,92,71,11.03,27,22,32,52,30
Kilkenny,183,99,84,34.91,36,30,48,44,25
Kilkenny,247,131,116,30.21,60,39,53,63,32
Kilkenny,268,137,131,16.94,59,35,74,61,39
Kilkenny,228,125,103,32.19,45,30,54,72,27
Kilkenny,159,82,77,16.02,57,15,46,26,15
Kilkenny,262,135,127,25.35,66,25,74,61,36
Kilkenny,259,133,126,47.92,55,17,104,60,23
Kilkenny,213,114,99,10.47,50,12,77,47,27
Kilkenny,371,183,188,23.2,87,51,107,88,38
Kilkenny,247,118,129,16.35,41,62,51,59,34
Kilkenny,122,70,52,16.24,27,13,34,29,19
Kilkenny,234,128,106,42.32,44,32,45,69,44
Kilkenny,358,180,178,244.72,84,51,102,87,34
Kilkenny,344,167,177,89.41,58,75,78,99,34
Kilkenny,258,122,136,18.28,65,38,72,52,31
Kilkenny,454,239,215,17.37,96,56,132,107,63
Kilkenny,183,94,89,15.14,48,20,57,32,26
Kilkenny,288,144,144,24.94,75,31,93,50,39
Kilkenny,235,119,116,27.61,60,27,57,60,31
Kilkenny,242,120,122,30.31,56,34,51,72,29
Kilkenny,220,122,98,21.94,52,35,42,60,31
Kilkenny,214,108,106,49.67,46,30,48,66,24
Kilkenny,273,136,137,33.03,46,39,56,105,27
Kilkenny,228,117,111,47.26,43,28,43,88,26
Kilkenny,265,145,120,29.49,67,26,56,82,34
Kilkenny,351,176,175,66.84,104,47,93,75,32
Kilkenny,359,170,189,1778.23,123,30,163,32,11
Kilkenny,218,105,113,38.31,37,25,51,55,50
Kilkenny,246,131,115,49.08,43,38,65,56,44
Kilkenny,176,92,84,880.59,38,27,52,44,15
Kilkenny,217,119,98,42.56,54,21,67,52,23
Kilkenny,222,111,111,108.22,47,21,61,66,27
Kilkenny,229,108,121,361.95,69,16,87,36,21
Kilkenny,254,118,136,3582.06,95,18,114,20,7
Kilkenny,230,117,113,810.62,45,31,56,58,40
Kilkenny,178,83,95,12.05,53,16,47,42,20
Kilkenny,215,105,110,47.24,69,11,69,37,29
Kilkenny,277,133,144,1286.01,56,32,79,63,47
Kilkenny,354,178,176,37.72,83,42,107,81,41
Kilkenny,286,149,137,4079.25,82,28,140,24,12
Kilkenny,274,126,148,89.46,37,33,49,75,80
Kilkenny,364,185,179,73.84,80,42,104,87,51
Kilkenny,293,140,153,475.74,55,52,65,97,24
Kilkenny,256,136,120,32.17,69,34,75,59,19
Kilkenny,215,116,99,56.99,56,21,66,52,20
Kilkenny,231,113,118,22.42,52,35,44,74,26
Kilkenny,242,115,127,25.31,52,30,63,60,37
Kilkenny,262,132,130,20.15,71,28,60,66,37
Kilkenny,252,126,126,27.2,72,25,74,51,30
Kilkenny,254,132,122,16.48,70,34,75,56,19
Kilkenny,214,109,105,16.26,63,19,73,38,21
Kilkenny,218,111,107,76.5,34,34,47,76,27
Kilkenny,211,99,112,313.29,54,24,64,36,33
Kilkenny,341,164,177,206.52,73,52,88,89,39
Kilkenny,370,194,176,27.47,57,47,79,149,38
Kilkenny,255,123,132,138.06,74,28,88,48,17
Kilkenny,191,91,100,46.07,41,23,49,46,32
Kilkenny,217,115,102,40.77,50,25,52,62,28
Kilkenny,422,215,207,57.71,113,48,121,86,54
Kilkenny,354,191,163,31.94,84,53,105,86,26
Kilkenny,166,89,77,11.24,41,16,47,41,21
Kilkenny,241,119,122,27.47,68,21,60,56,36
Kilkenny,220,115,105,27.41,37,29,55,60,39
Kilkenny,199,103,96,23.45,48,18,56,49,28
Kilkenny,232,130,102,17.21,46,30,60,67,29
Kilkenny,320,162,158,63.38,70,42,111,71,26
Kilkenny,300,152,148,21.94,73,37,76,92,22
Kilkenny,276,142,134,37.73,53,30,63,96,34
Kilkenny,210,114,96,23.79,43,17,50,65,35
Kilkenny,236,125,111,24.87,63,23,61,68,21
Kilkenny,198,103,95,25.47,44,24,50,59,21
Kilkenny,298,156,142,34.6,65,38,78,80,37
Kilkenny,272,143,129,21.47,67,27,72,80,26
Kilkenny,228,111,117,28.85,50,25,54,65,34
Kilkenny,234,114,120,130.86,63,29,79,40,23
Kilkenny,308,158,150,46.15,52,62,56,103,35
Kilkenny,186,95,91,64.41,24,23,39,63,37
Kilkenny,297,141,156,1360.43,48,15,87,27,120
Kilkenny,107,56,51,1320.08,10,13,32,31,21
Kilkenny,343,172,171,3615.63,95,45,117,70,16
Kilkenny,153,77,76,3075.5,19,22,42,38,32
Kilkenny,231,108,123,358.88,62,21,91,41,16
Kilkenny,342,167,175,40.42,89,51,117,67,18
Kilkenny,248,132,116,21.12,71,28,77,48,24
Kilkenny,208,112,96,18.61,61,15,75,39,18
Kilkenny,184,94,90,13.65,39,16,48,39,42
Kilkenny,231,118,113,29.56,56,20,68,48,39
Kilkenny,305,158,147,15.4,85,32,71,83,34
Kilkenny,244,122,122,19.67,60,38,61,65,20
Kilkenny,240,124,116,24.53,67,21,75,40,37
Kilkenny,189,104,85,13.94,39,14,59,47,30
Kilkenny,305,158,147,19.35,69,42,88,62,44
Kilkenny,301,151,150,19.74,76,29,81,77,38
Kilkenny,370,187,183,154.76,58,42,73,140,57
Kilkenny,340,163,177,224.49,73,41,114,93,19
Kilkenny,304,169,135,27.27,69,38,84,83,30
Kilkenny,229,126,103,12.88,52,26,62,57,32
Kilkenny,284,134,150,587.86,81,29,109,44,21
Kilkenny,244,122,122,3040.12,55,40,61,56,32
Kilkenny,131,73,58,187.63,17,11,34,36,33
Kilkenny,320,172,148,1765.68,81,51,104,63,21
Kilkenny,242,122,120,31.14,49,30,61,65,37
Kilkenny,216,114,102,21.99,48,22,72,45,29
Laois,197,97,100,12.54,36,23,53,58,27
Laois,259,128,131,49.05,52,30,54,80,43
Laois,266,137,129,47.34,59,35,61,61,50
Laois,238,115,123,70.52,34,27,48,52,77
Laois,244,126,118,1196.1,44,18,64,73,45
Laois,266,137,129,662.5,51,23,67,74,51
Laois,182,85,97,1245.65,61,11,63,30,17
Laois,219,103,116,602.35,62,14,57,47,39
Laois,296,145,151,243.25,90,27,109,47,23
Laois,307,147,160,38.34,85,25,90,66,41
Laois,131,72,59,2155.92,37,13,55,19,7
Laois,232,116,116,801.35,53,38,54,58,29
Laois,361,198,163,19.11,94,39,103,66,59
Laois,232,118,114,9.68,69,31,72,41,19
Laois,343,171,172,19.2,85,44,90,83,41
Laois,421,195,226,26.27,142,36,124,78,41
Laois,374,185,189,64.44,79,50,101,108,36
Laois,241,115,126,29.79,55,32,54,71,29
Laois,282,148,134,35.25,70,31,90,73,18
Laois,292,150,142,428.95,50,44,70,86,42
Laois,218,103,115,19.62,45,39,50,65,19
Laois,412,210,202,23.6,136,37,114,91,34
Laois,234,116,118,37.69,47,39,61,59,28
Laois,290,146,144,627.82,114,15,120,33,8
Laois,323,153,170,440.99,67,25,144,70,17
Laois,358,185,173,43.21,79,44,94,105,36
Laois,300,158,142,29.29,60,32,100,76,32
Laois,350,174,176,15.46,84,28,100,89,49
Laois,283,146,137,22.55,79,31,68,73,32
Laois,174,90,84,26.05,35,22,41,55,21
Laois,243,116,127,3912.54,81,21,108,29,4
Laois,340,162,178,882.35,92,35,138,54,21
Laois,287,154,133,29,55,33,83,82,34
Laois,268,144,124,70.58,64,34,79,65,26
Laois,318,146,172,2539.43,110,28,122,41,17
Laois,373,194,179,22.19,87,50,95,108,33
Laois,220,114,106,402.55,75,15,88,34,8
Laois,187,105,82,65.73,42,22,61,47,15
Laois,189,76,113,88.6,45,18,54,53,19
Laois,219,107,112,29.77,44,19,60,64,32
Laois,230,122,108,40.65,56,28,63,52,31
Laois,318,150,168,15.47,73,36,87,79,43
Laois,385,216,169,22.19,68,72,85,117,43
Laois,303,165,138,7057.84,98,19,153,26,7
Laois,238,122,116,5752.4,68,28,112,19,11
Laois,191,90,101,7624.45,57,23,95,16,0
Laois,163,83,80,5008.3,47,17,90,7,2
Laois,253,120,133,5271.71,72,26,137,16,2
Laois,176,99,77,18.22,25,20,40,56,35
Laois,171,80,91,87.99,31,17,47,47,29
Laois,103,47,56,1228.82,34,15,33,11,10
Laois,201,102,99,23.98,39,28,49,52,33
Laois,154,72,82,199.56,55,12,42,38,7
Laois,105,51,54,12.59,26,7,31,27,14
Laois,343,172,171,20.9,99,31,108,71,34
Laois,176,90,86,6.97,40,27,47,35,27
Laois,393,203,190,13.13,96,47,96,103,51
Laois,372,194,178,16.28,71,39,108,98,56
Laois,369,181,188,267.29,93,42,99,60,75
Laois,366,193,173,24.16,97,39,102,79,49
Laois,256,129,127,11.74,55,43,57,68,33
Laois,360,191,169,18.17,85,34,95,92,54
Laois,279,147,132,863.78,71,37,82,53,36
Laois,251,127,124,32.45,66,36,55,66,28
Laois,301,142,159,71.18,95,35,126,30,15
Laois,374,196,178,136.21,103,44,147,70,10
Laois,140,70,70,394.08,46,11,45,22,16
Laois,232,114,118,2920.66,63,20,130,19,0
Laois,78,36,42,3710.4,36,5,34,3,0
Laois,127,65,62,2875.84,36,26,58,6,1
Laois,233,116,117,17.56,55,33,55,59,31
Laois,349,172,177,27.44,97,43,100,90,19
Laois,337,175,162,24.91,92,42,75,93,35
Laois,208,114,94,13.61,42,18,51,61,36
Laois,187,102,85,18.45,23,34,35,66,29
Laois,308,150,158,25.85,70,31,87,76,44
Laois,297,150,147,15.03,68,34,93,67,35
Laois,359,183,176,21.15,94,48,74,103,40
Laois,141,77,64,11.34,37,11,44,27,22
Laois,229,126,103,17.94,57,23,66,55,28
Laois,194,92,102,498.32,49,31,62,38,14
Laois,388,189,199,3081.32,172,36,142,30,8
Laois,407,185,222,4769.66,143,73,124,64,3
Laois,317,157,160,27.47,68,56,82,83,28
Laois,247,116,131,1026.58,100,21,102,23,1
Laois,255,139,116,18.55,64,19,76,68,28
Laois,251,116,135,22.69,79,31,69,49,23
Laois,235,124,111,19.41,51,27,64,56,37
Laois,298,156,142,82.37,83,23,97,55,40
Laois,245,133,112,24.5,50,33,67,57,38
Laois,208,108,100,480.92,45,24,69,55,15
Laois,238,114,124,22.87,56,24,67,55,36
Laois,196,100,96,24.8,43,19,50,62,22
Laois,260,131,129,22.92,63,25,60,72,40
Laois,176,82,94,817.08,58,20,59,25,14
Laois,197,99,98,31.88,40,16,47,58,36
Laois,187,88,99,1002.78,35,27,47,58,20
Laois,262,130,132,1696.25,50,32,87,63,30
Laois,266,138,128,12.78,68,35,80,52,31
Laois,269,126,143,51.26,68,27,83,55,36
Laois,358,177,181,45.71,113,27,108,77,33
Laois,204,98,106,12.48,42,27,56,43,36
Laois,201,93,108,131.2,52,30,52,47,20
Laois,179,101,78,14.4,30,16,58,41,34
Laois,146,75,71,8.82,42,14,45,32,13
Laois,250,127,123,20.95,96,18,88,26,22
Laois,182,94,88,13.99,32,19,38,65,28
Laois,271,123,148,2939.17,82,25,144,14,6
Laois,260,143,117,202.55,42,33,121,48,16
Laois,255,126,129,1235.44,76,14,119,31,15
Laois,238,113,125,458.33,57,20,134,19,8
Laois,271,127,144,829.04,48,52,70,86,15
Laois,476,208,268,1436.04,214,46,181,31,4
Laois,216,96,120,1800.38,37,33,52,58,36
Laois,197,97,100,3795.18,51,25,65,48,8
Laois,250,120,130,6385.7,79,31,103,32,5
Laois,258,135,123,51.13,54,51,53,73,27
Laois,263,113,150,1763.98,86,40,107,23,7
Laois,306,141,165,5145.02,80,45,105,61,15
Laois,269,133,136,5952.64,81,19,138,30,1
Laois,254,119,135,5808.9,67,25,134,24,4
Laois,240,113,127,2705.9,60,27,121,27,5
Laois,252,125,127,330.82,89,17,118,21,7
Laois,267,144,123,33.26,37,35,68,85,42
Laois,358,185,173,17.22,94,40,94,82,48
Laois,440,221,219,31.03,101,48,132,101,58
Laois,139,77,62,12.8,29,16,39,38,17
Laois,312,153,159,32.91,81,49,70,82,30
Laois,349,184,165,33.07,85,41,94,79,50
Laois,259,133,126,15.13,77,34,76,53,19
Laois,252,134,118,27,47,38,75,58,34
Laois,168,85,83,49.76,42,15,71,29,11
Laois,341,166,175,18.19,64,42,73,113,49
Laois,302,153,149,60.89,59,55,72,86,30
Laois,254,136,118,28.08,71,26,77,67,13
Laois,256,131,125,27.41,60,41,72,62,21
Laois,312,161,151,18.77,62,34,85,78,53
Laois,244,120,124,11.2,54,21,62,69,38
Laois,281,134,147,11.25,54,29,75,75,48
Laois,261,145,116,11.44,59,41,60,71,30
Laois,324,156,168,13.35,87,38,79,80,40
Laois,137,73,64,9.73,24,17,41,38,17
Laois,379,188,191,22.41,96,47,106,86,44
Laois,141,81,60,11.97,29,14,45,34,19
Laois,134,66,68,13.32,27,19,33,33,22
Laois,267,138,129,44.97,60,34,63,80,30
Laois,388,196,192,91.96,95,51,112,98,32
Laois,255,130,125,2742.05,37,30,60,90,38
Laois,162,81,81,881.47,30,14,48,41,29
Laois,228,106,122,555.64,34,20,81,39,54
Laois,252,135,117,1767.9,35,25,71,63,58
Laois,402,181,221,1485.23,80,21,84,70,147
Laois,139,67,72,323.18,13,16,29,49,32
Laois,253,132,121,5230.08,74,31,122,24,2
Laois,274,115,159,2947.79,79,34,78,64,19
Laois,284,134,150,1218.63,59,38,105,54,28
Laois,267,135,132,2455.26,83,16,93,42,33
Laois,272,125,147,1725.02,69,38,95,42,28
Laois,210,103,107,2012.94,40,19,90,31,30
Laois,350,173,177,25.23,84,28,113,81,44
Laois,263,122,141,97.97,58,36,74,54,41
Laois,203,93,110,2700.19,73,18,65,27,20
Laois,179,99,80,903.75,23,19,56,54,27
Laois,149,80,69,4309.35,10,17,27,48,47
Laois,279,139,140,61.7,77,42,74,58,28
Laois,198,99,99,252.64,48,22,56,50,22
Laois,305,144,161,1733.71,67,58,74,80,26
Laois,161,81,80,120.66,49,15,60,20,17
Laois,173,82,91,1305.99,47,22,65,27,12
Laois,347,170,177,20.74,96,32,102,73,44
Laois,90,51,39,4.69,15,13,16,25,21
Laois,319,164,155,28.35,72,34,82,88,43
Laois,240,126,114,34.04,58,25,71,63,23
Laois,223,119,104,16.77,46,36,51,59,31
Laois,214,105,109,72.47,60,29,62,42,21
Laois,291,143,148,3922.57,79,22,147,29,14
Laois,321,157,164,2637.29,110,27,160,24,0
Laois,350,177,173,2688.69,106,50,102,81,11
Laois,293,129,164,1822.98,49,36,70,83,55
Laois,266,122,144,1704.66,73,23,122,43,5
Laois,351,181,170,437.65,119,37,136,50,9
Laois,225,118,107,62.38,52,28,56,66,23
Laois,352,169,183,1021.47,118,32,110,71,21
Laois,201,99,102,3922.87,66,21,68,35,11
Laois,271,135,136,2482.57,71,43,72,62,23
Laois,316,156,160,3007.58,101,22,151,31,11
Laois,347,172,175,1408.06,130,30,156,29,2
Laois,255,124,131,559.39,71,23,76,63,22
Laois,268,133,135,1222.22,69,23,73,64,39
Laois,172,81,91,2649.54,36,20,71,33,12
Laois,327,164,163,623.88,90,33,130,60,14
Laois,215,105,110,1938.49,79,15,102,19,0
Laois,235,118,117,671.35,64,19,91,44,17
Laois,230,119,111,1543.75,47,32,68,53,30
Laois,102,55,47,2339.61,18,10,38,21,15
Laois,293,148,145,2024.94,107,13,146,26,1
Laois,91,48,43,1974.4,13,16,45,15,2
Laois,164,81,83,1185.39,22,16,35,53,38
Laois,325,165,160,282.18,63,44,96,91,31
Laois,299,149,150,561.7,94,30,148,24,3
Laois,319,175,144,64.02,65,42,87,81,44
Laois,265,134,131,2548.42,56,36,66,83,24
Laois,315,158,157,3223.86,57,40,72,114,32
Laois,228,114,114,1385.54,41,22,65,66,34
Laois,299,152,147,3384.42,57,39,78,101,24
Laois,281,149,132,3221.26,74,35,83,66,23
Laois,248,117,131,2415.34,90,18,104,26,10
Laois,305,136,169,6771.16,110,28,145,20,2
Laois,376,192,184,1343.27,113,41,131,72,19
Laois,248,131,117,2549.89,56,32,68,74,18
Laois,255,127,128,3660.37,87,21,118,27,2
Laois,138,62,76,2171.62,21,7,38,44,28
Laois,259,119,140,3618.13,92,16,123,26,2
Laois,502,241,261,189.4,127,64,207,69,35
Laois,231,105,126,2627.9,62,41,65,50,13
Laois,216,107,109,2155.82,56,16,77,42,25
Laois,203,101,102,3194.03,42,23,71,53,14
Laois,"1,374","1,144",230,1814.05,69,268,650,256,131
Laois,265,137,128,1758.24,92,31,95,40,7
Laois,222,104,118,1876.38,46,41,40,77,18
Laois,236,115,121,3624.52,69,26,111,27,3
Laois,268,126,142,2539.71,48,36,74,86,24
Laois,345,163,182,1751.51,105,40,125,65,10
Laois,243,110,133,1595.05,67,41,63,55,17
Laois,257,123,134,5677.8,44,45,64,84,20
Laois,261,135,126,6446.67,104,27,102,26,2
Laois,298,141,157,2254.3,95,18,170,14,1
Laois,277,145,132,5711.34,89,32,115,39,2
Laois,414,194,220,3179.53,119,34,131,69,61
Laois,213,98,115,3747.16,52,20,75,26,40
Laois,420,198,222,2846.45,135,76,103,76,30
Laois,384,180,204,3568.97,112,85,86,78,23
Laois,277,134,143,434.84,78,38,112,44,5
Laois,404,201,203,5765.99,132,29,197,33,13
Laois,374,188,186,4737.18,148,36,131,55,4
Laois,255,123,132,5505.42,72,30,125,26,2
Laois,233,110,123,3792.38,59,24,126,21,3
Laois,223,106,117,4553.9,73,14,108,25,3
Laois,205,93,112,4483.03,64,15,117,7,2
Laois,208,108,100,2072.04,60,24,101,19,4
Laois,236,115,121,4596.54,76,36,92,27,5
Laois,232,110,122,4189.01,69,27,95,34,7
Laois,185,93,92,1916.46,56,21,88,15,5
Laois,206,112,94,2685.79,41,29,82,43,11
Laois,240,118,122,105.86,45,22,114,49,10
Laois,179,87,92,762.91,20,16,50,52,41
Laois,137,72,65,378.01,12,14,38,43,30
Laois,212,109,103,3320.28,20,30,51,68,43
Laois,162,78,84,1317.57,8,15,52,43,44
Laois,193,96,97,6694.42,23,27,109,29,5
Laois,209,108,101,8756.86,45,30,62,46,26
Laois,288,153,135,3293.24,64,30,82,71,41
Laois,180,85,95,1287.02,11,25,52,51,41
Laois,220,99,121,5720.97,56,31,56,37,40
Laois,196,88,108,984.54,30,26,47,58,35
Laois,221,118,103,1695.93,23,28,38,88,44
Laois,193,89,104,1169.42,27,24,55,52,35
Laois,430,206,224,5939.96,135,53,204,36,2
Laois,302,139,163,2468.63,82,33,126,41,20
Laois,267,129,138,8732.05,69,34,137,26,1
Laois,153,72,81,1395.04,26,15,50,30,32
Laois,97,54,43,877.36,7,9,30,33,18
Laois,422,213,209,21.16,129,44,113,98,38
Laois,256,135,121,16.72,54,40,63,65,34
Laois,360,182,178,22.52,88,57,82,89,44
Laois,194,97,97,3027.65,33,27,44,66,24
Laois,154,76,78,146.36,13,17,33,42,49
Laois,255,110,145,1582.04,72,23,98,40,22
Laois,198,108,90,269.22,34,22,53,52,37
Laois,243,121,122,33.85,47,28,82,50,36
Laois,316,158,158,38.16,69,35,81,84,47
Laois,287,151,136,17.13,69,30,88,64,36
Laois,469,240,229,24.47,109,75,133,98,54
Laois,460,235,225,36.68,114,61,109,131,45
Laois,287,147,140,31.26,71,24,94,70,28
Laois,290,148,142,27.58,79,25,87,59,40
Laois,255,124,131,30.97,65,35,64,63,28
Laois,349,187,162,37.13,59,28,90,95,77
Laois,290,157,133,48.73,67,29,84,81,29
Laois,308,162,146,25.44,66,44,82,78,38
Laois,285,130,155,341.95,68,41,64,75,37
Laois,243,132,111,24.73,63,22,72,58,28
Laois,241,115,126,215.55,31,21,42,86,61
Laois,185,97,88,48.77,48,10,41,56,30
Laois,229,110,119,1155.32,70,19,78,34,28
Laois,147,69,78,629.92,34,21,43,41,8
Laois,165,83,82,38.77,20,33,39,51,22
Laois,131,62,69,345.89,22,17,42,24,26
Laois,347,174,173,22.57,106,31,89,80,41
Laois,330,169,161,17.44,95,46,98,63,28
Laois,239,128,111,34.98,35,38,78,68,20
Laois,343,174,169,17.66,85,33,87,88,50
Laois,175,91,84,6.68,35,25,44,44,27
Laois,229,115,114,13.63,43,21,67,58,40
Laois,370,188,182,23.31,73,49,104,100,44
Laois,206,95,111,16.49,44,20,56,59,27
Leitrim,73,36,37,7.15,14,5,17,26,11
Leitrim,141,76,65,15.74,20,13,36,44,28
Leitrim,181,92,89,24.62,47,23,43,43,25
Leitrim,221,108,113,18.52,47,26,53,61,34
Leitrim,216,114,102,7.67,30,36,45,72,33
Leitrim,160,80,80,19.67,45,13,40,49,13
Leitrim,169,85,84,44.97,32,20,31,54,32
Leitrim,201,103,98,426.13,32,13,57,57,42
Leitrim,218,101,117,446.9,51,21,63,53,30
Leitrim,151,80,71,31.11,23,30,26,55,17
Leitrim,87,35,52,2015.29,23,4,25,22,13
Leitrim,110,45,65,235.16,20,19,20,28,23
Leitrim,159,86,73,5.32,36,8,35,56,24
Leitrim,328,176,152,14.71,56,39,87,102,44
Leitrim,145,72,73,13.58,23,8,42,53,19
Leitrim,116,61,55,10.56,25,9,24,30,28
Leitrim,269,135,134,16.19,54,38,48,92,37
Leitrim,169,86,83,12.88,39,20,32,48,30
Leitrim,163,75,88,90.83,30,15,41,56,21
Leitrim,262,125,137,232.36,83,41,64,53,21
Leitrim,374,184,190,96.58,107,40,129,77,21
Leitrim,122,67,55,3187.13,9,9,29,49,26
Leitrim,155,92,63,1572.73,5,19,94,30,7
Leitrim,187,99,88,2774.32,60,21,74,25,7
Leitrim,335,140,195,1434.52,27,23,50,72,163
Leitrim,140,70,70,961.18,12,22,79,20,7
Leitrim,123,66,57,4262.55,21,14,66,17,5
Leitrim,217,114,103,29.08,49,19,64,58,27
Leitrim,174,92,82,24.79,38,14,54,47,21
Leitrim,166,71,95,1669.26,41,13,101,6,5
Leitrim,234,110,124,515.64,44,29,112,33,16
Leitrim,237,120,117,807.47,60,25,92,48,12
Leitrim,150,76,74,4271.44,52,26,56,15,1
Leitrim,116,63,53,1145.78,27,13,59,17,0
Leitrim,167,75,92,509.05,55,17,73,20,2
Leitrim,266,125,141,392.6,78,26,115,38,9
Leitrim,161,87,74,14.09,35,12,38,42,34
Leitrim,140,79,61,53.96,26,16,37,35,26
Leitrim,180,100,80,15.3,37,24,40,47,32
Leitrim,207,105,102,220.21,51,26,61,52,17
Leitrim,138,66,72,45.46,37,13,49,23,16
Leitrim,164,82,82,14.37,34,9,52,44,25
Leitrim,256,126,130,18.17,60,31,52,74,39
Leitrim,260,137,123,15.6,44,39,68,65,44
Leitrim,189,102,87,9.5,41,21,44,54,29
Leitrim,175,90,85,13.98,39,13,44,46,33
Leitrim,158,84,74,28.65,33,14,38,43,30
Leitrim,131,62,69,5.88,19,15,33,50,14
Leitrim,178,89,89,16.12,36,20,44,60,18
Leitrim,151,78,73,14.03,33,17,29,48,24
Leitrim,194,99,95,22.48,43,24,48,52,27
Leitrim,248,131,117,15.68,72,24,65,56,31
Leitrim,149,74,75,12.03,24,20,29,48,28
Leitrim,145,73,72,26.96,33,6,49,36,21
Leitrim,142,77,65,22.47,37,7,36,45,17
Leitrim,149,69,80,2178.04,24,19,43,41,22
Leitrim,156,74,82,70.83,45,10,65,21,15
Leitrim,168,78,90,1282.17,45,6,88,21,8
Leitrim,266,133,133,23.8,43,16,51,63,93
Leitrim,210,112,98,23.96,44,40,48,52,26
Leitrim,117,52,65,1168.31,29,5,54,10,19
Leitrim,153,88,65,805.53,42,7,48,23,33
Leitrim,215,109,106,16.92,32,34,39,75,35
Leitrim,212,106,106,306.74,38,20,45,51,58
Leitrim,169,79,90,13.56,37,22,38,40,32
Leitrim,144,80,64,9.25,28,17,26,56,17
Leitrim,193,92,101,105.04,45,11,70,32,35
Leitrim,191,109,82,33.92,48,21,57,52,13
Leitrim,196,100,96,17.58,51,13,60,45,27
Leitrim,80,37,43,535.25,19,10,22,19,10
Leitrim,116,58,58,34.16,21,6,65,19,5
Leitrim,157,85,72,12.55,28,15,41,47,26
Leitrim,135,72,63,12.55,24,7,36,36,32
Leitrim,137,63,74,26.86,24,10,32,50,21
Leitrim,193,90,103,49.7,63,16,63,32,19
Leitrim,124,51,73,240.2,20,6,32,40,26
Leitrim,169,86,83,81.96,30,18,46,37,38
Leitrim,176,91,85,381.16,38,20,51,43,24
Leitrim,120,60,60,36.22,23,13,32,39,13
Leitrim,156,82,74,575.4,21,16,28,60,31
Leitrim,207,97,110,595.29,79,18,72,32,6
Leitrim,234,112,122,195.25,56,18,86,44,30
Leitrim,289,150,139,21.5,64,26,81,83,35
Leitrim,178,96,82,25.03,42,24,52,36,24
Leitrim,299,144,155,19.23,43,25,51,93,87
Leitrim,228,120,108,23.74,62,14,60,51,41
Leitrim,152,81,71,26.23,35,17,34,43,23
Leitrim,182,94,88,19.03,32,29,36,67,18
Leitrim,183,90,93,14.61,40,22,39,53,29
Leitrim,204,100,104,334.98,32,30,56,57,29
Leitrim,154,75,79,5.39,33,24,39,38,20
Leitrim,175,93,82,5.26,35,16,55,39,30
Leitrim,238,114,124,9.24,67,27,50,71,23
Leitrim,250,137,113,6.75,51,34,52,78,35
Leitrim,147,74,73,7.71,32,20,30,37,28
Leitrim,289,167,122,17.47,51,44,57,92,45
Leitrim,266,142,124,14.57,65,18,72,74,37
Leitrim,173,80,93,20.87,39,19,37,55,23
Leitrim,160,77,83,30.75,31,14,48,40,27
Leitrim,215,105,110,1561.51,67,13,96,30,9
Leitrim,190,101,89,37.12,35,20,52,58,25
Leitrim,190,108,82,10.81,42,20,48,58,22
Leitrim,184,91,93,190.07,36,28,39,58,23
Leitrim,198,101,97,12.94,41,23,40,67,27
Leitrim,310,144,166,45.23,84,40,93,64,29
Leitrim,195,100,95,15.79,53,16,44,59,23
Leitrim,190,97,93,22.5,43,16,65,44,22
Leitrim,88,49,39,2.67,13,17,12,27,19
Leitrim,143,73,70,11.31,21,15,37,49,21
Leitrim,153,85,68,12.49,28,16,37,48,24
Leitrim,233,124,109,7.37,41,26,46,63,57
Leitrim,189,99,90,76.6,69,14,55,35,16
Leitrim,168,80,88,540.94,39,10,55,37,27
Leitrim,192,109,83,12.84,48,25,42,52,25
Leitrim,271,137,134,90.6,84,24,103,40,20
Leitrim,140,63,77,90.78,46,9,48,26,11
Leitrim,205,105,100,35.38,51,12,52,44,46
Leitrim,190,96,94,29.75,45,16,55,48,26
Leitrim,154,77,77,159.29,44,9,69,23,9
Leitrim,104,55,49,281.64,26,9,27,26,16
Leitrim,283,143,140,31.15,81,13,87,71,31
Leitrim,197,101,96,13.82,36,25,51,51,34
Leitrim,197,107,90,9.69,44,19,53,56,25
Leitrim,191,99,92,20.56,46,13,45,58,29
Leitrim,134,68,66,7.47,28,14,39,33,20
Leitrim,181,91,90,11.88,51,23,47,40,20
Leitrim,140,76,64,13.87,22,22,24,44,28
Leitrim,111,57,54,232.41,15,7,30,37,22
Leitrim,119,59,60,575.32,19,7,23,30,40
Leitrim,116,61,55,470.33,3,5,23,24,61
Leitrim,277,136,141,1682.64,84,18,117,36,22
Leitrim,197,105,92,118.67,42,19,43,56,37
Leitrim,207,95,112,22.72,59,27,73,37,11
Leitrim,102,49,53,3087.73,11,8,20,33,30
Leitrim,177,92,85,51.06,47,20,67,29,14
Leitrim,235,121,114,32.27,65,39,49,63,19
Leitrim,101,53,48,113.36,23,8,23,27,20
Leitrim,234,119,115,13.83,53,18,58,72,33
Leitrim,229,115,114,65.68,55,27,61,63,23
Leitrim,198,98,100,31.56,37,28,47,51,35
Leitrim,147,70,77,424.56,43,11,38,30,25
Leitrim,272,134,138,28.64,63,29,57,73,50
Leitrim,135,64,71,69.11,24,17,27,37,30
Leitrim,160,68,92,518.71,12,8,36,35,69
Leitrim,139,79,60,459.13,31,12,41,35,20
Leitrim,98,52,46,574.12,11,11,31,21,24
Leitrim,196,102,94,9.26,44,23,39,56,34
Leitrim,230,116,114,14.1,44,25,83,49,29
Leitrim,89,49,40,8.26,14,11,24,29,11
Leitrim,248,133,115,11.34,44,26,56,68,54
Leitrim,121,61,60,51.27,15,11,28,36,31
Leitrim,214,115,99,16.43,40,14,65,53,42
Leitrim,251,138,113,14.93,63,21,61,61,45
Leitrim,174,85,89,9.38,32,23,46,56,17
Leitrim,196,97,99,17.43,61,12,62,39,22
Leitrim,137,77,60,4.73,22,16,28,55,16
Leitrim,229,127,102,14.1,53,14,73,38,51
Leitrim,90,42,48,124.96,19,10,38,14,9
Leitrim,150,75,75,222.78,34,18,47,35,16
Leitrim,221,109,112,28.37,49,20,65,58,29
Leitrim,121,61,60,14.69,22,16,22,40,21
Leitrim,104,59,45,9.44,10,9,23,35,27
Limerick,282,143,139,43.1,57,37,75,79,34
Limerick,282,145,137,61.51,60,30,85,77,30
Limerick,261,124,137,5345.29,62,38,73,70,18
Limerick,93,42,51,1378.62,8,10,20,26,29
Limerick,114,55,59,142.16,17,18,25,30,24
Limerick,224,93,131,1555.57,44,25,79,31,45
Limerick,162,86,76,406.92,30,18,47,41,26
Limerick,283,135,148,3667.42,74,32,122,35,20
Limerick,150,81,69,653.41,15,24,37,28,46
Limerick,221,105,116,3121.73,74,30,61,40,16
Limerick,169,82,87,607.91,47,12,76,22,12
Limerick,287,143,144,177.1,52,50,52,98,35
Limerick,344,170,174,25.54,83,31,106,90,34
Limerick,281,140,141,43.18,78,30,74,78,21
Limerick,313,149,164,35.3,83,48,73,68,41
Limerick,243,123,120,39.96,79,20,75,44,25
Limerick,214,104,110,5128.7,69,13,123,9,0
Limerick,155,78,77,282.36,37,16,77,16,9
Limerick,301,146,155,25.87,72,35,81,78,35
Limerick,321,158,163,51.02,73,48,75,91,34
Limerick,249,120,129,41.14,34,38,48,93,36
Limerick,338,163,175,806.45,41,25,113,85,74
Limerick,231,106,125,57.64,31,12,41,97,50
Limerick,293,142,151,279.06,41,49,60,76,67
Limerick,300,148,152,78.65,53,31,90,87,39
Limerick,247,131,116,63.47,55,39,64,68,21
Limerick,158,74,84,70.33,20,24,50,35,29
Limerick,212,109,103,421.6,65,13,81,44,9
Limerick,336,178,158,13.44,63,33,88,105,47
Limerick,284,138,146,40.43,80,36,70,70,28
Limerick,257,132,125,25.52,42,36,56,91,32
Limerick,228,119,109,35.31,55,16,57,59,41
Limerick,237,122,115,90.91,47,24,57,67,42
Limerick,182,98,84,16.76,37,17,43,55,30
Limerick,206,103,103,20.35,30,23,60,57,36
Limerick,333,169,164,128.03,80,45,82,72,54
Limerick,326,155,171,27.13,74,46,62,102,42
Limerick,223,113,110,164.3,34,32,55,69,33
Limerick,376,188,188,22.76,91,50,91,100,44
Limerick,293,147,146,4424.98,91,39,113,40,10
Limerick,286,151,135,2860.69,51,24,63,55,93
Limerick,209,111,98,24.32,40,24,61,62,22
Limerick,198,90,108,22.88,40,27,51,48,32
Limerick,213,115,98,7.99,55,22,68,53,15
Limerick,223,109,114,810.47,42,25,59,55,42
Limerick,387,203,184,29.89,91,44,100,100,52
Limerick,320,160,160,72.24,90,17,139,34,40
Limerick,360,190,170,22.81,70,40,100,102,48
Limerick,206,109,97,21.22,39,24,55,60,28
Limerick,301,154,147,43.37,42,36,79,92,52
Limerick,190,104,86,18.11,43,27,43,58,19
Limerick,225,116,109,17.83,52,26,48,67,32
Limerick,421,209,212,420.4,154,40,119,82,26
Limerick,404,213,191,54.26,97,53,104,111,39
Limerick,432,225,207,64.38,108,58,119,111,36
Limerick,243,125,118,26.51,62,22,70,53,36
Limerick,238,113,125,44.41,49,32,51,82,24
Limerick,331,166,165,166.11,74,37,81,92,47
Limerick,271,142,129,58.78,51,43,62,90,25
Limerick,279,137,142,96.91,41,25,108,72,33
Limerick,263,123,140,5596.46,91,18,123,28,3
Limerick,345,180,165,3509.27,90,39,152,55,9
Limerick,306,134,172,5010.64,67,44,100,72,23
Limerick,211,105,106,9882.44,50,17,130,9,5
Limerick,258,109,149,4466.76,24,30,86,87,31
Limerick,140,78,62,4687.29,26,16,85,11,2
Limerick,285,135,150,5180.59,90,23,147,20,5
Limerick,291,138,153,1240.96,71,31,146,31,12
Limerick,298,138,160,4972.72,83,33,124,48,10
Limerick,266,120,146,6248.39,69,30,113,45,9
Limerick,338,166,172,5639.91,80,31,177,45,5
Limerick,320,165,155,4158.44,63,61,97,84,15
Limerick,274,125,149,3734.85,79,30,91,64,10
Limerick,220,110,110,5622.14,70,20,99,28,3
Limerick,239,118,121,4563.07,70,23,116,25,5
Limerick,238,108,130,8017.79,47,44,128,17,2
Limerick,241,118,123,5501.53,57,21,133,29,1
Limerick,238,103,135,5670.99,61,26,103,42,6
Limerick,292,139,153,4636.02,52,49,105,75,11
Limerick,218,110,108,3288.48,37,22,85,61,13
Limerick,239,126,113,3480.87,34,44,55,90,16
Limerick,231,112,119,5031.25,53,32,76,62,8
Limerick,334,167,167,3778.79,96,32,142,57,7
Limerick,314,146,168,6125.75,52,30,152,17,63
Limerick,242,114,128,219.96,65,13,149,12,3
Limerick,257,115,142,4643.77,47,35,75,79,21
Limerick,204,97,107,4155.89,36,34,57,52,25
Limerick,216,107,109,3809.12,27,30,51,83,25
Limerick,275,133,142,4051.45,41,49,62,90,33
Limerick,421,201,220,3484.9,107,40,173,94,7
Limerick,266,121,145,5762.07,43,40,63,82,38
Limerick,250,122,128,3710.13,36,32,68,62,52
Limerick,270,131,139,977.16,81,28,117,37,7
Limerick,312,166,146,6619.43,70,51,158,30,3
Limerick,320,154,166,523.07,92,25,148,40,15
Limerick,286,139,147,5675.84,72,33,141,35,5
Limerick,307,157,150,3448.86,82,27,172,25,1
Limerick,219,116,103,7935.93,49,20,141,9,0
Limerick,278,145,133,2848.89,89,36,80,65,8
Limerick,351,177,174,5612.14,105,38,173,30,5
Limerick,260,128,132,101.5,57,43,69,67,24
Limerick,328,165,163,737.36,89,34,146,43,16
Limerick,277,133,144,1743.56,89,24,126,32,6
Limerick,190,95,95,5403.41,32,24,45,49,40
Limerick,294,142,152,4728.97,52,43,71,82,46
Limerick,197,101,96,5918.23,58,12,107,20,0
Limerick,317,150,167,5421.68,76,28,175,34,4
Limerick,204,99,105,7596.92,61,10,123,9,1
Limerick,315,162,153,4115.5,101,27,149,34,4
Limerick,250,120,130,4270,62,36,77,58,17
Limerick,235,115,120,4333.55,48,40,76,61,10
Limerick,213,101,112,6033.82,44,29,64,60,16
Limerick,317,135,182,4145.42,70,42,112,67,26
Limerick,312,147,165,167.79,77,29,158,38,10
Limerick,367,190,177,3929.97,92,40,124,81,30
Limerick,298,158,140,1854.28,61,30,110,56,41
Limerick,215,104,111,4055.92,27,24,51,58,55
Limerick,656,298,358,3490.33,71,52,111,144,278
Limerick,257,127,130,666.4,53,22,143,23,16
Limerick,234,111,123,2611.14,21,20,74,55,64
Limerick,320,165,155,19.48,70,34,94,73,49
Limerick,294,155,139,31.05,73,16,97,57,51
Limerick,175,83,92,2415.76,33,23,63,39,17
Limerick,183,99,84,61.23,34,18,52,44,35
Limerick,233,126,107,13.55,45,31,70,54,33
Limerick,243,135,108,33.94,66,19,72,55,31
Limerick,330,166,164,22.5,83,25,93,83,46
Limerick,319,159,160,21.91,76,25,85,86,47
Limerick,258,125,133,130.15,59,20,102,49,28
Limerick,243,115,128,57.09,52,37,65,66,23
Limerick,269,133,136,23.13,60,30,81,64,34
Limerick,183,91,92,15.65,34,23,50,54,22
Limerick,336,177,159,25.77,91,20,103,74,48
Limerick,303,160,143,46.64,74,39,74,85,31
Limerick,465,244,221,81.99,125,47,98,116,79
Limerick,250,151,99,2525.43,6,215,21,7,1
Limerick,116,59,57,5189.69,0,113,3,0,0
Limerick,193,113,80,5509.41,44,49,91,6,3
Limerick,207,101,106,3812.37,36,13,131,16,11
Limerick,266,138,128,4357.73,53,31,172,10,0
Limerick,197,105,92,2487.69,25,69,44,29,30
Limerick,227,117,110,1054.91,23,48,53,54,49
Limerick,304,123,181,402.56,1,283,17,2,1
Limerick,146,95,51,3373.69,0,136,8,2,0
Limerick,357,177,180,43.62,84,43,83,92,55
Limerick,190,97,93,3381.87,31,21,130,8,0
Limerick,210,101,109,2326.48,63,26,107,13,1
Limerick,198,124,74,4175.98,26,107,61,3,1
Limerick,265,134,131,397.43,63,23,126,39,14
Limerick,196,98,98,1441.31,47,12,113,18,6
Limerick,197,115,82,695.01,7,151,28,8,3
Limerick,202,116,86,4483.61,21,111,53,16,1
Limerick,383,186,197,888.04,9,128,58,50,138
Limerick,225,129,96,4541.14,18,60,135,11,1
Limerick,124,69,55,8478.63,1,80,38,4,1
Limerick,186,86,100,7681.51,20,129,29,7,1
Limerick,367,185,182,1377.26,71,84,51,141,20
Limerick,331,184,147,553.96,42,141,86,19,43
Limerick,301,165,136,1746.37,72,58,153,17,1
Limerick,211,104,107,1818.59,24,28,46,66,47
Limerick,244,128,116,3129.21,35,45,53,63,48
Limerick,229,113,116,1442.99,57,34,63,51,24
Limerick,248,135,113,4539.55,31,108,50,41,18
Limerick,233,117,116,4491.83,20,108,41,45,19
Limerick,494,211,283,2191.63,12,307,57,35,83
Limerick,311,141,170,4244.52,92,25,151,31,12
Limerick,301,160,141,6279.34,43,126,103,23,6
Limerick,310,177,133,1673.08,38,134,86,42,10
Limerick,235,135,100,4134.27,30,121,64,18,2
Limerick,450,210,240,133.68,68,62,82,131,107
Limerick,209,96,113,2044.21,47,10,140,12,0
Limerick,314,148,166,1891.04,39,57,61,116,41
Limerick,407,193,214,4145.24,114,73,75,135,10
Limerick,373,178,195,1341.17,100,45,153,65,10
Limerick,447,214,233,3391.71,165,63,107,97,15
Limerick,283,160,123,1260.88,58,28,177,16,4
Limerick,247,116,131,2570.88,48,20,169,6,4
Limerick,383,210,173,2830.7,46,90,107,106,34
Limerick,212,113,99,1387.42,51,21,110,23,7
Limerick,213,103,110,2624.22,26,21,140,22,4
Limerick,313,148,165,3025.41,76,30,149,51,7
Limerick,291,161,130,221.97,2,263,10,10,6
Limerick,227,113,114,209.33,49,42,37,73,26
Limerick,233,124,109,154.87,37,46,45,80,25
Limerick,324,171,153,68.16,59,59,67,105,34
Limerick,258,124,134,310.32,37,39,54,93,35
Limerick,249,103,146,219.35,18,19,118,69,25
Limerick,348,181,167,5906.92,109,35,163,37,4
Limerick,244,115,129,1290.18,48,34,70,65,27
Limerick,310,156,154,7957.49,90,23,169,24,4
Limerick,368,175,193,29.96,78,40,105,110,35
Limerick,399,199,200,57.95,96,58,99,98,48
Limerick,360,176,184,56.42,90,51,99,84,36
Limerick,182,98,84,5216.99,34,19,120,9,0
Limerick,240,122,118,4367.05,69,24,121,24,2
Limerick,236,127,109,138.58,47,34,46,80,29
Limerick,253,117,136,40,58,40,77,54,24
Limerick,152,83,69,7.75,26,16,42,51,17
Limerick,138,76,62,13.52,25,21,36,40,16
Limerick,225,113,112,24.78,63,8,81,37,36
Limerick,235,124,111,153.57,31,35,54,64,51
Limerick,225,121,104,31.95,60,20,64,50,31
Limerick,232,127,105,20.58,48,19,68,60,37
Limerick,361,168,193,41.36,84,36,100,74,67
Limerick,199,97,102,163.55,53,28,79,28,11
Limerick,392,194,198,49.14,73,55,105,108,51
Limerick,199,107,92,812.42,29,18,55,61,36
Limerick,235,117,118,135.39,63,29,57,66,20
Limerick,300,155,145,31.93,75,34,79,70,42
Limerick,390,237,153,38.8,73,36,108,133,40
Limerick,232,115,117,931.73,44,33,65,61,29
Limerick,237,116,121,723.25,43,21,89,34,50
Limerick,346,185,161,23.56,77,32,95,91,51
Limerick,191,97,94,25.81,40,19,41,68,23
Limerick,173,85,88,30.79,30,26,43,47,27
Limerick,273,137,136,30.83,62,30,81,63,37
Limerick,241,121,120,22.05,45,33,61,58,44
Limerick,343,168,175,129.9,87,46,80,100,30
Limerick,254,122,132,373.47,63,32,94,42,23
Limerick,253,116,137,1203.49,68,20,100,44,21
Limerick,274,126,148,423.84,75,8,140,33,18
Limerick,357,182,175,314.01,108,25,161,49,14
Limerick,336,173,163,24.63,71,48,89,82,46
Limerick,233,122,111,43.36,53,34,53,58,35
Limerick,271,136,135,46.41,73,34,73,57,34
Limerick,195,94,101,33.8,42,15,65,45,28
Limerick,256,132,124,40.83,80,23,82,52,19
Limerick,342,181,161,29.83,97,41,118,62,24
Limerick,423,198,225,47.58,110,52,116,104,41
Limerick,341,178,163,37.59,63,58,78,105,37
Limerick,238,104,134,718.22,68,30,85,32,23
Limerick,235,117,118,3159.88,50,28,63,72,22
Limerick,191,93,98,1123.73,19,30,37,65,40
Limerick,289,143,146,19.39,70,28,91,71,29
Limerick,318,156,162,83.72,64,49,65,110,30
Limerick,350,179,171,55.12,63,41,80,97,69
Limerick,234,124,110,94.18,52,36,56,59,31
Limerick,352,175,177,297,107,26,121,76,22
Limerick,340,180,160,51.77,81,37,98,83,41
Limerick,241,123,118,2795.37,57,25,69,65,25
Limerick,204,102,102,1134.51,55,16,63,40,30
Limerick,242,120,122,407.96,47,19,84,70,22
Limerick,166,75,91,3211.33,49,5,99,10,3
Limerick,193,85,108,651.45,55,17,84,26,11
Limerick,238,123,115,1118.37,68,14,91,47,18
Limerick,320,159,161,84.93,64,32,87,86,51
Limerick,300,151,149,533.34,48,33,65,77,77
Limerick,195,93,102,22.03,41,29,40,55,30
Limerick,175,93,82,15.21,36,23,41,47,28
Limerick,244,119,125,16.93,59,28,63,63,31
Limerick,208,113,95,28.33,52,15,54,65,22
Limerick,279,143,136,60.13,57,40,72,76,34
Limerick,323,158,165,60.33,70,34,83,101,35
Limerick,236,125,111,128.1,44,37,38,77,40
Limerick,312,161,151,54.53,64,48,79,90,31
Limerick,213,99,114,75.67,42,32,54,65,20
Limerick,191,87,104,163.47,42,20,45,57,27
Limerick,176,87,89,1114.46,61,7,81,21,6
Limerick,282,140,142,13.54,54,34,65,85,44
Limerick,294,160,134,17.62,64,26,95,65,44
Limerick,229,113,116,30.59,65,18,78,42,26
Limerick,226,116,110,32.64,45,27,58,70,26
Limerick,204,105,99,120.39,60,14,83,35,12
Limerick,261,127,134,4906.11,82,23,133,16,7
Limerick,256,130,126,14.46,34,37,61,85,39
Limerick,284,143,141,22.79,57,32,71,91,33
Limerick,195,105,90,29.89,43,15,62,49,26
Limerick,213,107,106,16.29,36,29,56,56,36
Limerick,272,134,138,19.62,71,28,70,70,33
Limerick,403,208,195,27.76,98,44,117,107,37
Limerick,238,116,122,32.03,60,42,49,73,14
Limerick,205,109,96,35.78,45,23,42,66,29
Limerick,403,186,217,44.22,70,45,85,100,103
Limerick,345,176,169,26.06,90,37,91,92,35
Limerick,308,148,160,58.06,58,30,62,82,76
Limerick,286,148,138,100.54,77,34,78,71,26
Limerick,328,165,163,40,60,53,73,95,47
Limerick,316,162,154,1096.52,79,38,118,55,26
Limerick,184,92,92,2835.35,43,16,64,30,31
Limerick,268,134,134,182.73,50,25,53,76,64
Limerick,194,105,89,23.08,45,21,53,52,23
Limerick,173,97,76,16.75,34,20,42,58,19
Limerick,163,84,79,21.91,28,12,68,30,25
Limerick,252,119,133,22.5,46,31,58,79,38
Limerick,316,165,151,17.06,45,49,89,81,52
Limerick,276,142,134,22.24,59,31,82,68,36
Limerick,306,150,156,58.69,62,44,71,90,39
Limerick,340,176,164,37.63,62,55,65,96,62
Limerick,198,105,93,95.78,43,22,46,66,21
Limerick,170,81,89,115.13,34,17,50,36,33
Limerick,240,125,115,10.17,50,25,80,54,31
Limerick,272,140,132,37.39,80,30,79,61,22
Limerick,313,151,162,34.27,84,28,90,78,33
Limerick,272,134,138,25.71,76,25,71,69,31
Limerick,224,117,107,55.65,29,38,47,67,43
Limerick,260,119,141,284.06,65,31,74,66,24
Limerick,203,102,101,165.26,44,14,44,32,69
Limerick,297,159,138,14.85,56,50,62,83,46
Limerick,258,133,125,21.16,67,26,70,69,26
Limerick,304,148,156,22.06,68,35,84,82,35
Limerick,255,138,117,20.97,47,27,73,56,52
Limerick,310,147,163,47.78,74,32,82,77,45
Limerick,325,181,144,30.93,78,30,102,85,30
Limerick,225,115,110,19.13,53,20,61,61,30
Limerick,242,126,116,24.72,63,16,66,65,32
Limerick,79,39,40,9.07,16,11,17,25,10
Limerick,224,115,109,25.98,52,26,62,63,21
Limerick,205,107,98,32.46,44,33,43,57,28
Limerick,257,127,130,82.03,71,25,68,75,18
Limerick,352,182,170,21.17,61,48,99,84,60
Limerick,272,138,134,33.45,69,33,87,51,32
Limerick,259,129,130,29.14,71,24,85,57,22
Limerick,217,114,103,26.06,43,19,63,60,32
Limerick,324,165,159,98.51,90,37,88,84,25
Limerick,278,137,141,41.14,67,36,71,72,32
Limerick,356,163,193,101.72,107,37,119,60,33
Limerick,264,139,125,41.7,61,33,59,95,16
Limerick,200,106,94,19.93,47,20,56,53,24
Limerick,147,76,71,35.26,33,19,35,43,17
Limerick,213,112,101,13.29,41,22,52,68,30
Limerick,266,132,134,38.17,73,17,68,75,33
Limerick,280,148,132,30.79,55,30,67,92,36
Limerick,294,148,146,26.05,64,40,68,87,35
Limerick,284,138,146,18.57,42,45,47,105,45
Limerick,177,92,85,17.7,38,18,45,50,26
Limerick,350,170,180,42.87,77,46,80,103,44
Limerick,239,121,118,19.32,55,25,74,48,37
Limerick,213,108,105,27.54,45,20,67,44,37
Limerick,264,141,123,41.99,51,37,61,74,41
Limerick,269,131,138,18.37,54,35,61,70,49
Limerick,168,86,82,14.82,25,15,43,48,37
Limerick,254,130,124,15.33,34,34,56,91,39
Limerick,194,97,97,66.84,45,22,60,45,22
Limerick,346,178,168,49.8,84,30,111,92,29
Limerick,308,141,167,3493.85,67,41,114,62,24
Limerick,441,313,128,16.93,104,119,82,83,53
Limerick,243,126,117,435.1,35,34,60,74,40
Limerick,281,144,137,15.81,56,27,62,87,49
Limerick,169,91,78,74.78,21,27,44,45,32
Limerick,272,142,130,28.97,57,33,72,79,31
Limerick,230,110,120,101.89,36,18,51,62,63
Limerick,249,122,127,37.85,43,25,77,58,46
Limerick,275,136,139,28.13,74,22,84,66,29
Limerick,308,170,138,42.61,62,41,78,79,48
Limerick,280,149,131,30.76,71,35,68,75,31
Limerick,302,144,158,150.97,62,42,79,76,43
Limerick,313,163,150,45.34,71,32,81,85,44
Limerick,301,170,131,39.8,69,36,84,86,26
Limerick,299,148,151,18.57,61,32,87,75,44
Limerick,249,133,116,37.82,48,35,67,60,39
Limerick,264,127,137,24.78,56,31,73,68,36
Limerick,225,107,118,58.59,51,25,57,46,46
Limerick,231,116,115,280.72,33,24,66,71,37
Limerick,288,141,147,1010.66,76,34,95,61,22
Limerick,287,146,141,13.16,47,38,70,89,43
Limerick,253,129,124,9.98,50,22,71,70,40
Limerick,385,200,185,39.68,97,33,113,84,58
Limerick,360,188,172,23.22,76,43,96,103,42
Limerick,367,167,200,43.21,107,34,95,100,31
Limerick,299,150,149,59.55,67,35,78,78,41
Limerick,215,120,95,15.52,21,29,49,73,43
Limerick,233,123,110,18.01,37,28,55,87,26
Limerick,253,128,125,22.02,58,27,60,68,40
Limerick,208,105,103,15.36,40,31,57,50,30
Limerick,245,118,127,694.17,48,38,64,60,35
Limerick,171,88,83,76.69,37,11,56,46,21
Limerick,139,70,69,3163.19,27,20,50,32,10
Limerick,113,59,54,1452.48,19,17,22,26,29
Limerick,270,137,133,18.1,57,33,71,68,41
Limerick,227,121,106,11.67,34,25,74,63,31
Limerick,312,161,151,24.23,59,39,89,88,37
Limerick,171,87,84,1927.04,27,13,63,36,32
Limerick,117,62,55,2779.89,28,8,37,30,14
Limerick,270,144,126,42.63,53,32,69,76,40
Limerick,197,97,100,295.05,37,23,81,36,20
Limerick,289,134,155,3160.65,77,31,85,66,30
Limerick,230,119,111,86.47,64,29,73,38,26
Limerick,200,100,100,243.87,55,35,45,54,11
Limerick,331,158,173,87.73,49,26,64,86,106
Limerick,357,187,170,48.3,76,45,80,106,50
Limerick,211,109,102,492.3,46,21,53,57,34
Limerick,177,102,75,16.56,31,23,46,50,27
Limerick,196,106,90,50.29,42,22,60,37,35
Limerick,212,118,94,8.87,21,30,52,73,36
Limerick,219,118,101,17.9,33,25,51,65,45
Limerick,298,158,140,29.98,70,32,83,78,35
Limerick,207,103,104,29.09,60,14,68,41,24
Limerick,392,204,188,42.9,89,45,113,95,50
Limerick,258,135,123,38.57,49,38,65,76,30
Limerick,281,146,135,28.64,75,35,76,72,23
Limerick,229,115,114,23.39,53,12,63,39,62
Limerick,305,169,136,27.58,74,45,75,76,35
Limerick,298,157,141,22.06,78,24,96,58,42
Limerick,311,153,158,71.72,61,48,82,81,39
Limerick,208,115,93,36.29,56,21,58,49,24
Limerick,298,144,154,32.04,71,24,80,87,36
Limerick,233,117,116,32.73,44,27,58,72,32
Limerick,302,160,142,28.15,62,36,65,96,43
Limerick,197,96,101,36.49,47,17,59,55,19
Limerick,192,103,89,33.79,34,26,47,61,24
Limerick,166,79,87,50.07,41,16,42,40,27
Limerick,272,126,146,91.12,74,40,79,57,22
Limerick,255,125,130,37.83,55,29,79,70,22
Limerick,191,95,96,13.45,46,17,74,34,20
Limerick,320,156,164,60.66,67,49,67,86,51
Limerick,255,134,121,5067.47,33,46,55,82,39
Limerick,198,94,104,3278.04,18,29,38,72,41
Limerick,253,123,130,2139.1,37,34,63,74,45
Limerick,289,139,150,3821.69,46,34,70,64,75
Limerick,264,125,139,3597.02,54,41,128,39,2
Limerick,210,100,110,4242,22,33,39,60,56
Limerick,167,80,87,2382.45,28,22,62,33,22
Limerick,183,85,98,220.94,21,26,91,35,10
Limerick,266,135,131,5640.49,45,43,75,63,40
Limerick,204,95,109,3421.1,48,33,60,34,29
Limerick,321,148,173,4574.41,64,41,71,88,57
Limerick,214,97,117,1833.24,39,40,42,76,17
Limerick,212,101,111,5054.96,25,28,40,74,45
Limerick,213,104,109,4313.31,42,29,88,51,3
Limerick,177,88,89,4175.12,20,30,33,59,35
Limerick,279,130,149,906.62,56,40,59,97,27
Limerick,204,96,108,724.22,27,28,59,46,44
Limerick,213,101,112,5992.57,59,16,126,12,0
Limerick,316,155,161,285.06,73,25,124,56,38
Limerick,75,49,26,4331.5,0,74,1,0,0
Limerick,254,125,129,7137.84,96,31,93,27,7
Limerick,246,125,121,7196.14,55,36,105,42,8
Limerick,108,45,63,3138.53,22,38,33,8,7
Limerick,203,99,104,4049.96,58,42,51,47,5
Limerick,161,76,85,3910.71,43,31,42,41,4
Limerick,173,80,93,3454.61,28,25,42,64,14
Limerick,128,68,60,2779.23,32,22,37,34,3
Limerick,162,72,90,197.74,54,34,42,28,4
Limerick,142,87,55,8915.12,0,137,5,0,0
Limerick,184,92,92,138.63,32,24,39,70,19
Limerick,288,142,146,2223.73,107,31,115,32,3
Limerick,346,198,148,133.95,55,28,77,123,63
Limerick,149,74,75,211.59,27,12,82,14,14
Limerick,222,102,120,3677.08,67,17,110,18,10
Limerick,215,114,101,7066.79,69,16,113,16,1
Limerick,256,121,135,248.68,86,22,104,36,8
Limerick,258,132,126,19.74,60,32,73,70,23
Limerick,170,85,85,20.85,28,23,40,55,24
Limerick,219,125,94,89.12,56,27,57,57,22
Limerick,250,158,92,20.3,37,35,99,47,32
Limerick,265,139,126,18.85,46,39,53,79,48
Limerick,211,110,101,28.85,49,15,66,49,32
Limerick,300,149,151,53.38,76,36,76,78,34
Limerick,138,75,63,22.82,25,16,30,46,21
Limerick,340,157,183,63.87,98,35,118,63,26
Limerick,273,140,133,35.98,54,39,75,72,33
Limerick,343,173,170,26.26,70,35,87,98,53
Limerick,263,129,134,28.83,50,35,72,76,30
Limerick,276,145,131,66.22,51,30,73,81,41
Limerick,214,117,97,15.93,24,15,43,88,44
Limerick,328,169,159,15.61,74,37,97,69,51
Limerick,262,124,138,24.71,55,41,61,83,22
Limerick,266,125,141,90.69,55,34,60,85,32
Limerick,231,113,118,27.4,60,24,58,69,20
Limerick,261,134,127,44.14,46,34,58,88,35
Limerick,306,140,166,58.22,61,46,66,90,43
Limerick,221,108,113,284.19,65,17,113,21,5
Limerick,275,135,140,64.77,45,23,81,59,67
Limerick,342,178,164,45.41,73,44,87,95,43
Limerick,173,75,98,2309.01,51,17,89,13,3
Limerick,211,116,95,4096.37,46,29,102,30,4
Limerick,216,109,107,107.33,42,31,74,46,23
Limerick,213,103,110,1747.39,37,20,122,26,8
Limerick,309,153,156,4883.75,61,42,77,102,27
Limerick,280,135,145,797.36,59,24,98,64,35
Limerick,241,127,114,1630.98,61,24,117,37,2
Limerick,220,106,114,3091.89,60,23,100,31,6
Limerick,159,77,82,1608.6,18,28,48,51,14
Limerick,225,89,136,2642.12,23,16,44,44,98
Limerick,224,100,124,3783.72,53,25,93,41,12
Limerick,286,146,140,3380.81,71,39,77,69,30
Limerick,222,112,110,3527.67,51,33,108,25,5
Limerick,216,111,105,5187.07,53,11,101,31,20
Limerick,221,109,112,2815.47,50,28,71,51,21
Limerick,93,41,52,446.69,8,7,30,25,23
Limerick,154,80,74,340.84,19,16,48,39,32
Limerick,100,58,42,355.8,20,11,50,11,8
Limerick,210,105,105,754.61,34,31,50,60,35
Limerick,105,61,44,1868,6,8,33,37,21
Limerick,291,146,145,4555.92,48,45,72,84,42
Limerick,304,157,147,4309.98,62,37,161,29,15
Limerick,254,124,130,2140.03,42,15,66,44,87
Limerick,229,104,125,3697.9,64,27,121,14,3
Limerick,217,96,121,1631.93,34,17,76,50,40
Limerick,320,132,188,1027.37,70,24,71,22,133
Limerick,304,156,148,35.64,69,45,73,81,36
Limerick,319,169,150,25.05,70,43,75,89,42
Limerick,265,137,128,25.47,48,33,74,85,25
Limerick,173,90,83,206.52,19,15,37,62,40
Limerick,380,204,176,41.47,92,57,77,111,43
Limerick,394,210,184,81.55,109,41,136,82,26
Limerick,302,144,158,1458.04,55,48,77,84,38
Limerick,222,111,111,9.09,60,15,75,52,20
Limerick,328,161,167,67.93,57,45,71,77,78
Limerick,139,68,71,710.9,15,13,43,39,29
Limerick,250,131,119,69.08,58,34,60,69,29
Limerick,201,94,107,71.24,40,32,50,56,23
Limerick,252,126,126,244.39,56,32,68,64,32
Limerick,275,146,129,4982.06,56,58,70,77,14
Limerick,335,172,163,27.21,66,39,87,86,57
Limerick,206,118,88,50.91,41,37,36,69,23
Limerick,171,87,84,33.53,20,18,49,49,35
Limerick,150,71,79,32.35,26,18,35,48,23
Limerick,294,148,146,133.31,53,20,99,77,45
Limerick,249,122,127,150.89,68,44,50,54,33
Limerick,226,94,132,697.52,39,24,64,63,36
Limerick,220,106,114,597.18,54,35,56,50,25
Limerick,296,114,182,1434.25,71,40,90,52,43
Limerick,194,85,109,148.46,37,22,54,40,41
Limerick,289,139,150,22.67,69,43,65,77,35
Limerick,292,164,128,12.22,55,26,70,87,54
Limerick,256,128,128,45.74,47,32,51,81,45
Limerick,304,158,146,37.91,50,41,71,97,45
Limerick,335,174,161,27.07,91,34,112,66,32
Limerick,258,135,123,27.04,62,31,72,69,24
Limerick,238,126,112,16.19,49,27,56,73,33
Limerick,330,170,160,19.31,69,24,100,83,54
Limerick,300,150,150,14.42,57,36,73,92,42
Limerick,230,110,120,67.27,60,29,45,80,16
Limerick,321,157,164,54.18,73,44,69,90,45
Limerick,350,184,166,42.51,81,49,78,107,35
Limerick,194,104,90,91.23,20,35,31,73,35
Limerick,207,106,101,86.89,24,37,27,81,38
Limerick,299,149,150,152.37,59,44,50,110,36
Limerick,287,163,124,21.59,70,12,102,61,42
Limerick,257,136,121,88.64,33,28,63,99,34
Limerick,209,94,115,178.28,33,25,55,66,30
Limerick,193,103,90,448.44,18,9,61,60,45
Limerick,260,130,130,35.49,62,14,74,70,40
Limerick,263,132,131,24.65,55,30,66,80,32
Limerick,272,146,126,20.97,67,27,75,68,35
Limerick,278,152,126,28.14,73,33,73,66,33
Limerick,308,163,145,22.67,53,33,78,102,42
Limerick,292,143,149,35.12,62,26,83,71,50
Limerick,315,151,164,42.62,83,35,93,57,47
Limerick,307,157,150,26.65,82,27,94,67,37
Limerick,363,172,191,37.3,84,42,89,97,51
Limerick,323,165,158,38.47,66,30,98,73,56
Limerick,302,161,141,20.03,81,24,92,81,24
Limerick,275,124,151,2667,25,21,58,91,80
Limerick,323,151,172,4381.27,67,50,84,94,28
Limerick,287,135,152,1682.03,49,33,66,92,47
Limerick,295,146,149,3848.86,57,34,83,77,44
Limerick,255,108,147,1257.63,26,29,29,72,99
Limerick,193,95,98,629.71,27,25,43,58,40
Limerick,249,111,138,743.72,45,28,53,70,53
Limerick,405,197,208,750.79,127,39,151,57,31
Limerick,389,176,213,7321.66,100,51,129,82,27
Limerick,170,89,81,3040.87,12,18,23,26,91
Limerick,241,85,156,6402.42,11,175,46,8,1
Limerick,194,107,87,3239.16,33,27,128,5,1
Limerick,369,170,199,1631.52,89,25,121,77,57
Limerick,256,129,127,1752.45,69,38,103,40,6
Limerick,229,109,120,7417.72,44,34,70,73,8
Limerick,212,102,110,1115.45,52,32,66,42,20
Limerick,336,173,163,1447.58,89,35,112,80,20
Limerick,164,75,89,1566.68,18,34,63,19,30
Limerick,244,116,128,2775.53,40,27,102,58,17
Limerick,354,166,188,2611,100,31,180,39,4
Limerick,245,129,116,3040.38,61,35,89,53,7
Limerick,76,17,59,8262.67,0,70,6,0,0
Limerick,278,144,134,1339.71,60,28,134,43,13
Limerick,266,138,128,4410.84,93,17,130,15,11
Limerick,248,123,125,2285.48,58,29,91,49,21
Limerick,94,50,44,5226.87,5,50,33,4,2
Limerick,256,120,136,1641.17,80,31,104,40,1
Limerick,272,134,138,4574.97,92,19,100,39,22
Limerick,195,92,103,3277.7,22,24,54,38,57
Limerick,126,64,62,7014.81,27,21,40,32,6
Limerick,188,102,86,4064.86,31,34,83,27,13
Limerick,203,99,104,9009.81,38,22,54,54,35
Limerick,181,93,88,1530.6,32,20,87,29,13
Limerick,289,139,150,6319.29,38,39,50,88,74
Limerick,179,88,91,3602.55,18,23,38,59,41
Limerick,207,105,102,5227.54,41,19,39,52,56
Limerick,185,85,100,5793.74,33,26,53,46,27
Limerick,212,94,118,6052.82,27,29,47,62,47
Limerick,140,68,72,6831.93,17,29,69,14,11
Limerick,200,67,133,5771.01,43,55,73,13,16
Limerick,209,98,111,3712.65,37,35,52,49,36
Limerick,169,71,98,959.9,19,63,52,22,13
Limerick,200,93,107,3965.11,22,37,40,57,44
Limerick,191,95,96,2574.85,20,28,31,50,62
Limerick,180,78,102,760.34,17,29,46,55,33
Limerick,211,88,123,2782.87,46,26,115,23,1
Limerick,197,88,109,1060.83,40,32,56,54,15
Limerick,244,66,178,220.48,14,158,55,8,9
Limerick,196,98,98,3310.64,23,37,117,17,2
Limerick,273,143,130,6553.36,66,42,74,61,30
Limerick,178,77,101,2391.25,24,23,32,57,42
Limerick,188,83,105,2443.88,22,23,40,46,57
Limerick,216,103,113,3540.69,22,16,56,63,59
Limerick,249,117,132,1751.34,29,28,61,63,68
Limerick,271,127,144,902.32,36,24,62,91,58
Limerick,285,145,140,5021.14,50,62,62,92,19
Limerick,202,89,113,1851.94,39,27,52,48,36
Limerick,233,117,116,4279.78,37,38,47,80,31
Limerick,267,120,147,2700.95,75,45,65,65,17
Limerick,199,104,95,2463.73,57,29,43,55,15
Limerick,203,101,102,1363.17,21,49,42,52,39
Limerick,215,95,120,3107.65,62,43,62,42,6
Limerick,319,164,155,4792.02,58,46,93,89,33
Limerick,194,86,108,1749.53,54,30,54,45,11
Limerick,256,114,142,4065.3,73,39,71,55,18
Limerick,95,45,50,214.7,38,15,25,16,1
Limerick,256,121,135,7297.4,59,40,64,70,23
Limerick,194,95,99,8586.73,49,36,44,52,13
Limerick,224,112,112,2082.66,33,24,58,59,50
Limerick,194,95,99,4071.61,33,23,60,36,42
Limerick,270,110,160,3523.47,73,20,86,62,29
Limerick,295,145,150,5601.97,43,40,69,89,54
Limerick,174,79,95,6075.84,40,22,50,31,31
Limerick,198,88,110,1946.08,29,15,79,41,34
Limerick,185,93,92,4092.11,31,29,47,42,36
Limerick,125,61,64,4648.74,16,13,33,29,34
Limerick,242,117,125,1269.41,42,29,46,75,50
Limerick,243,113,130,718.99,45,34,64,56,44
Limerick,228,121,107,13857.66,13,16,154,35,10
Limerick,218,94,124,3605.21,34,22,62,65,35
Limerick,240,123,117,1886.78,16,25,123,40,36
Limerick,243,116,127,2575.71,36,23,50,74,60
Limerick,241,113,128,496.49,35,30,53,90,33
Limerick,315,161,154,1984.09,77,89,46,78,25
Limerick,221,104,117,2677.98,28,31,34,43,85
Limerick,281,130,151,3433.49,53,24,69,77,58
Limerick,278,132,146,2237.82,38,35,45,77,83
Limerick,243,122,121,2361.54,53,31,44,73,42
Limerick,333,159,174,4889.94,69,39,108,96,21
Limerick,173,78,95,3584.16,25,22,42,39,45
Limerick,204,82,122,2973.07,25,15,39,64,61
Limerick,254,125,129,2049.11,30,21,60,62,81
Limerick,197,91,106,3488.08,19,26,35,55,62
Limerick,228,114,114,4959.54,65,45,68,42,8
Limerick,244,116,128,3543.78,18,45,52,73,56
Limerick,170,80,90,3611.11,26,19,32,33,60
Limerick,155,76,79,2105.43,14,17,29,34,61
Limerick,111,63,48,899.57,5,26,63,14,3
Limerick,161,87,74,21768.52,32,37,80,11,1
Limerick,298,156,142,6879.99,54,39,135,53,17
Limerick,154,92,62,73298.43,30,21,80,23,0
Limerick,162,99,63,16745.92,19,25,96,17,5
Limerick,115,64,51,7361.88,11,34,29,25,16
Limerick,160,94,66,3650.38,15,30,62,40,13
Limerick,112,70,42,33412.89,14,17,68,13,0
Limerick,223,139,84,32239.41,42,46,113,21,1
Limerick,131,71,60,6162.97,14,30,71,15,1
Limerick,200,113,87,23705.11,21,31,117,25,6
Limerick,380,230,150,8814.05,54,79,219,27,1
Limerick,225,110,115,12353.81,33,35,75,49,33
Limerick,170,98,72,2935.18,7,36,91,26,10
Limerick,159,82,77,4988.08,12,34,56,35,22
Limerick,301,152,149,12706.86,79,21,174,26,1
Limerick,225,110,115,10983.11,43,21,100,35,26
Limerick,194,99,95,3808.33,32,19,73,48,22
Limerick,205,110,95,5170.76,26,34,65,44,36
Limerick,150,68,82,6624.56,24,14,39,42,31
Limerick,204,96,108,2770.91,29,32,59,59,25
Limerick,275,116,159,3007.24,27,45,61,68,74
Limerick,170,81,89,1743.23,38,30,76,6,20
Limerick,427,232,195,3500.11,71,126,131,72,27
Limerick,275,114,161,552.29,38,69,65,47,56
Limerick,164,85,79,3559.8,12,21,33,48,50
Limerick,344,156,188,3350.74,46,18,64,57,159
Limerick,195,92,103,3093.03,21,24,37,59,54
Limerick,245,110,135,3581.82,39,24,49,69,64
Limerick,242,118,124,5470.16,40,32,58,51,61
Limerick,163,76,87,6473.91,28,20,33,50,32
Limerick,262,129,133,5925.59,57,37,77,75,16
Limerick,254,114,140,959.34,46,34,76,77,21
Limerick,167,81,86,1308.39,29,11,32,30,65
Limerick,379,182,197,1433.71,88,69,103,106,13
Limerick,177,70,107,4528.24,46,20,42,46,23
Limerick,180,87,93,1973.73,45,43,45,29,18
Limerick,224,106,118,1624.8,48,35,57,52,32
Limerick,132,68,64,368.08,37,21,32,29,13
Limerick,165,83,82,4273.28,29,31,33,35,37
Limerick,180,91,89,3708.43,26,14,44,64,32
Limerick,151,83,68,1978.77,21,23,55,33,19
Limerick,167,81,86,1415.57,28,21,46,49,23
Limerick,267,129,138,8709.84,57,37,60,84,29
Limerick,240,117,123,2078.23,34,30,47,74,55
Limerick,215,106,109,7367.56,33,22,54,67,39
Limerick,188,86,102,7768.92,21,26,43,67,31
Limerick,259,126,133,4345.86,39,29,60,71,60
Limerick,250,131,119,5061.86,50,35,59,78,28
Limerick,274,132,142,1564.45,49,51,63,86,25
Limerick,147,76,71,8412.98,35,23,38,38,13
Limerick,251,128,123,4075.14,55,45,68,56,27
Limerick,132,62,70,1047.46,33,25,22,33,19
Limerick,151,77,74,1318.28,35,20,35,31,30
Limerick,182,94,88,1105.19,54,17,38,49,24
Limerick,193,92,101,3677.87,25,22,41,70,35
Limerick,116,61,55,2651.06,11,9,34,26,36
Limerick,293,155,138,4217.28,73,45,72,70,33
Limerick,140,67,73,1755.82,20,15,49,39,17
Limerick,234,85,149,2626.26,33,31,37,47,86
Limerick,197,91,106,3585.34,20,22,38,73,44
Limerick,171,83,88,8294.13,20,34,89,19,9
Limerick,374,172,202,849,97,80,82,84,31
Limerick,296,142,154,6717.04,48,45,66,94,43
Limerick,178,77,101,7837.96,53,18,58,34,15
Limerick,215,100,115,7063.31,48,14,45,63,45
Limerick,171,83,88,6655.25,35,27,34,53,22
Limerick,211,105,106,5522.55,33,31,55,63,29
Limerick,237,126,111,7247.93,37,24,50,75,51
Limerick,254,115,139,6855.05,55,36,66,66,31
Limerick,152,73,79,4623.43,14,55,33,40,10
Limerick,167,75,92,3579.62,17,24,32,51,43
Limerick,194,98,96,3381.2,29,15,63,40,47
Limerick,275,133,142,6112.2,40,54,122,35,24
Limerick,177,95,82,22467.63,46,37,57,33,4
Limerick,151,76,75,7951.13,25,20,67,30,9
Limerick,152,86,66,6548.05,23,21,47,37,24
Limerick,225,110,115,44404.97,35,36,134,20,0
Limerick,241,121,120,52955.39,39,20,171,11,0
Limerick,131,73,58,3160.97,25,24,59,23,0
Limerick,209,115,94,7064.39,23,47,84,38,17
Limerick,249,116,133,7927.16,34,36,65,68,46
Limerick,205,110,95,4788.04,24,20,53,65,43
Limerick,78,31,47,2721.28,18,10,22,20,8
Limerick,204,105,99,4851.37,46,31,44,48,35
Limerick,182,47,135,13125.63,1,176,4,1,0
Limerick,121,23,98,13255.92,0,117,3,1,0
Limerick,217,110,107,2853.72,33,23,56,61,44
Limerick,228,115,113,7612.94,45,41,65,61,16
Limerick,138,64,74,3320.5,33,26,33,32,14
Limerick,168,84,84,2989.27,32,20,41,40,35
Limerick,190,85,105,743.14,27,32,47,49,35
Limerick,260,125,135,8992.49,49,34,68,51,58
Limerick,260,116,144,8978.83,76,30,84,44,26
Limerick,238,115,123,8475.18,59,40,60,61,18
Limerick,224,94,130,1903.63,47,32,60,61,24
Limerick,163,77,86,1960.93,37,15,49,45,17
Limerick,232,113,119,6410.79,40,29,52,68,43
Limerick,117,59,58,4651.35,14,27,71,5,0
Limerick,155,79,76,55755.4,15,31,102,6,1
Limerick,336,184,152,4268.51,14,60,213,42,7
Limerick,96,51,45,1682.7,5,16,64,9,2
Limerick,104,67,37,3873.95,8,8,56,27,5
Limerick,211,149,62,6932.12,11,23,132,36,9
Limerick,328,158,170,5349.95,74,51,103,66,34
Limerick,245,123,122,7737,46,37,58,79,25
Limerick,282,138,144,6784.39,39,53,57,77,56
Limerick,235,94,141,5609.66,71,36,67,40,21
Limerick,245,123,122,6001.08,40,37,55,61,52
Limerick,342,178,164,3433.8,81,25,116,79,41
Limerick,258,121,137,4751.82,64,46,86,52,10
Limerick,246,120,126,7353.38,76,33,99,31,7
Limerick,385,189,196,8873.22,89,75,104,111,6
Limerick,246,123,123,6113.78,30,20,51,55,90
Limerick,321,164,157,5992.05,67,49,88,105,12
Limerick,269,130,139,1037.01,57,39,94,72,7
Limerick,247,126,121,7589.72,84,25,105,30,3
Limerick,241,115,126,2337.63,93,13,120,14,1
Limerick,276,131,145,6034.77,42,37,59,60,78
Limerick,202,103,99,3458.25,30,18,39,63,52
Limerick,249,134,115,3268.79,37,34,69,93,16
Limerick,313,153,160,1482.01,47,38,72,131,25
Limerick,346,181,165,6784.31,124,34,154,30,4
Limerick,270,142,128,5904.22,81,31,111,33,14
Limerick,308,151,157,784.28,41,42,68,112,45
Limerick,191,91,100,6743.4,16,29,41,63,42
Limerick,617,449,168,1447.59,42,175,254,99,47
Longford,179,97,82,19.46,32,26,49,48,24
Longford,161,89,72,45.49,31,29,37,39,25
Longford,353,185,168,44.55,88,49,91,87,38
Longford,331,163,168,47.02,84,39,99,70,39
Longford,227,105,122,37.15,62,20,66,54,25
Longford,229,129,100,17.76,43,22,63,55,46
Longford,191,89,102,16.5,36,21,39,64,31
Longford,227,113,114,18.54,63,12,70,50,32
Longford,195,95,100,29.83,42,21,61,49,22
Longford,236,126,110,24.73,54,41,50,70,21
Longford,224,115,109,21.73,58,21,69,53,23
Longford,285,123,162,434.15,80,34,87,58,26
Longford,313,153,160,23.44,70,37,81,78,47
Longford,188,105,83,21.58,47,17,53,43,28
Longford,192,103,89,21.44,33,21,54,56,28
Longford,166,89,77,63.33,52,18,53,31,12
Longford,241,125,116,16.56,43,34,51,68,45
Longford,260,131,129,29.02,61,43,67,59,30
Longford,227,117,110,32.17,57,24,59,58,29
Longford,252,141,111,23.44,40,34,63,77,38
Longford,227,119,108,27.74,44,19,60,69,35
Longford,167,78,89,125.33,44,24,52,37,10
Longford,136,68,68,539.48,44,17,49,21,5
Longford,199,106,93,87.21,64,16,76,27,16
Longford,279,143,136,155.38,66,23,91,66,33
Longford,187,86,101,1005.69,31,10,82,20,44
Longford,147,82,65,493.53,23,19,55,33,17
Longford,211,92,119,653.07,52,23,72,47,17
Longford,125,64,61,487.5,38,12,35,27,13
Longford,170,89,81,2594.87,34,20,54,45,17
Longford,252,129,123,19.96,49,25,60,72,46
Longford,260,130,130,34.65,69,29,81,58,23
Longford,195,96,99,41.5,46,27,43,59,20
Longford,183,85,98,41.22,44,22,48,47,22
Longford,178,95,83,50.09,51,16,50,47,14
Longford,188,104,84,17.23,40,23,59,38,28
Longford,192,103,89,26.51,43,17,46,61,25
Longford,279,133,146,213.61,80,34,89,56,20
Longford,191,99,92,94.54,43,21,41,64,22
Longford,230,120,110,74.1,54,20,74,55,27
Longford,251,126,125,69.47,78,32,72,46,23
Longford,199,104,95,74.11,43,22,49,63,22
Longford,203,93,110,928.03,48,23,42,64,26
Longford,175,87,88,237.47,56,16,66,27,10
Longford,341,158,183,2535.33,124,28,146,25,18
Longford,323,175,148,11.34,55,45,77,94,52
Longford,194,105,89,8.71,29,26,40,75,24
Longford,207,105,102,14.14,51,10,66,55,25
Longford,171,87,84,6.37,40,13,44,43,31
Longford,170,87,83,15.6,31,21,34,51,33
Longford,206,113,93,32.53,58,10,55,47,36
Longford,240,126,114,22.75,58,23,64,62,33
Longford,166,80,86,30.21,39,25,38,47,17
Longford,257,123,134,37.54,56,40,69,63,29
Longford,304,157,147,28.17,81,39,83,65,36
Longford,279,150,129,24.5,63,22,63,73,58
Longford,318,166,152,25.86,67,49,71,88,43
Longford,371,190,181,18.38,102,40,99,98,32
Longford,190,97,93,16.04,33,20,47,59,31
Longford,209,116,93,23.23,57,25,50,54,23
Longford,140,75,65,20.68,23,16,34,44,23
Longford,173,93,80,23.84,40,25,44,34,30
Longford,241,112,129,19.69,58,22,70,62,29
Longford,128,77,51,13.16,29,13,34,33,19
Longford,188,96,92,21.09,45,20,49,52,22
Longford,235,123,112,18.86,54,27,67,62,25
Longford,222,122,100,17.09,48,28,57,59,30
Longford,207,112,95,16.11,29,25,40,60,53
Longford,221,112,109,32.98,50,25,55,56,35
Longford,303,160,143,35.02,66,44,79,85,29
Longford,297,150,147,32.17,57,44,95,72,29
Longford,182,94,88,1803.05,62,32,73,13,2
Longford,127,56,71,599.57,22,13,29,35,28
Longford,204,105,99,354.8,53,26,69,37,19
Longford,274,122,152,199.35,73,47,86,52,16
Longford,138,65,73,16.43,27,13,33,43,22
Longford,266,138,128,40.43,73,21,88,59,25
Longford,222,102,120,78.89,45,42,52,45,38
Longford,190,92,98,2072.09,68,26,69,25,2
Longford,225,106,119,3643.9,84,24,89,25,3
Longford,121,68,53,1327.83,28,22,51,9,11
Longford,174,72,102,238.88,17,11,22,36,88
Longford,253,129,124,3500.08,58,31,66,64,34
Longford,96,49,47,765.9,17,16,48,15,0
Longford,227,116,111,1867.67,79,24,93,26,5
Longford,234,135,99,80.45,62,29,92,35,16
Longford,248,125,123,23.98,60,25,77,53,33
Longford,249,123,126,14.73,72,20,68,54,35
Longford,190,95,95,137.02,34,22,47,63,24
Longford,335,172,163,19.27,75,32,102,91,35
Longford,338,175,163,21.42,83,29,94,85,47
Longford,296,152,144,17.8,77,32,74,79,34
Longford,155,72,83,1372.97,23,15,47,43,27
Longford,161,85,76,986.54,27,22,35,43,34
Longford,172,87,85,52.02,41,26,60,27,18
Longford,253,132,121,168.05,43,35,87,61,27
Longford,280,145,135,92.09,68,16,106,49,41
Longford,240,115,125,37.3,55,32,73,54,26
Longford,232,120,112,15.58,56,28,62,58,28
Longford,182,91,91,18.24,55,18,43,45,21
Longford,142,65,77,1918.89,35,29,44,25,9
Longford,157,78,79,495.42,54,17,55,22,9
Longford,239,119,120,23.1,54,21,74,65,25
Longford,267,138,129,34.21,73,24,78,60,32
Longford,201,102,99,12.66,32,28,53,56,32
Longford,168,86,82,11.89,30,15,42,48,33
Longford,264,136,128,34.47,71,40,93,41,19
Longford,293,164,129,19.07,52,28,77,86,50
Longford,151,75,76,16.22,35,7,49,43,17
Longford,178,91,87,10.67,40,24,48,38,28
Longford,178,91,87,14.46,36,19,49,55,19
Longford,139,70,69,15.66,22,19,41,28,29
Longford,184,90,94,1278.14,21,18,41,58,46
Longford,182,92,90,3187.95,44,23,50,38,27
Longford,287,143,144,2357.64,47,34,81,70,55
Longford,152,72,80,2861.82,19,19,39,52,23
Longford,232,111,121,7686.45,32,23,53,74,50
Longford,116,66,50,1840.89,14,19,47,33,3
Longford,183,101,82,2706.22,29,40,74,35,5
Longford,226,111,115,4206.69,67,33,70,41,15
Longford,119,60,59,949.71,11,12,24,36,36
Longford,204,102,102,2521.13,32,29,50,51,42
Longford,185,84,101,497.83,64,24,63,25,9
Longford,415,186,229,1237.41,142,43,162,59,9
Longford,270,127,143,5152.18,80,36,89,45,20
Longford,114,50,64,1157.3,8,9,45,25,27
Longford,94,51,43,3223.59,12,9,40,22,11
Longford,200,97,103,2622.02,44,27,91,25,13
Longford,301,161,140,534.07,62,37,90,86,26
Longford,293,134,159,1729.9,51,33,82,90,37
Longford,182,92,90,721.29,30,21,83,26,22
Longford,232,117,115,33.09,44,26,50,72,40
Longford,233,121,112,2430.32,45,40,89,45,14
Longford,294,147,147,2943,86,43,137,25,3
Longford,183,89,94,6060.61,55,40,43,36,9
Longford,202,92,110,3902.78,60,23,66,43,10
Longford,184,81,103,230.47,48,27,47,43,19
Longford,371,182,189,933.93,71,30,80,78,112
Longford,276,130,146,874.96,33,34,70,99,40
Longford,247,121,126,304.28,76,19,77,51,24
Longford,220,107,113,2740.1,63,28,63,31,35
Longford,224,106,118,1641.51,36,24,81,36,47
Longford,317,152,165,607.02,101,35,140,33,8
Longford,190,87,103,3710.87,53,23,55,45,14
Longford,257,128,129,3273.97,87,27,85,40,18
Longford,207,104,103,6049.8,77,33,75,21,1
Longford,240,124,116,5500.8,92,34,81,26,7
Longford,363,144,219,111.61,51,34,80,65,133
Longford,284,138,146,51.98,55,44,44,101,40
Longford,225,122,103,87.44,27,29,53,61,55
Longford,161,75,86,80.83,51,14,62,28,6
Longford,219,107,112,114.99,66,23,73,49,8
Longford,170,79,91,273.95,29,23,40,51,27
Longford,193,96,97,1905.34,43,31,92,26,1
Longford,377,204,173,22.28,96,40,102,105,34
Longford,218,109,109,24.4,61,20,61,53,23
Longford,250,127,123,8.33,73,26,66,60,25
Longford,245,132,113,24.34,72,17,86,50,20
Longford,183,96,87,17.33,33,25,53,43,29
Longford,240,133,107,30.59,50,27,70,68,25
Longford,165,89,76,19.05,28,14,45,41,37
Longford,150,81,69,16.05,36,9,33,37,35
Longford,299,152,147,13.05,60,39,85,74,41
Longford,254,131,123,42.8,61,19,84,57,33
Longford,168,94,74,7.76,25,20,40,57,26
Longford,136,70,66,459.8,21,13,25,52,25
Longford,149,63,86,916.18,20,28,50,38,13
Longford,195,97,98,225.92,45,24,67,46,13
Longford,232,121,111,19.33,59,15,65,55,38
Longford,160,80,80,16.23,42,15,38,44,21
Longford,165,78,87,949.96,16,20,30,47,52
Longford,260,119,141,858.25,70,25,80,56,29
Longford,136,64,72,1066.02,24,19,68,19,6
Longford,273,138,135,25.92,43,35,53,76,66
Longford,202,100,102,30.36,52,20,48,64,18
Longford,156,85,71,13.03,34,19,40,42,21
Longford,129,69,60,28.12,26,17,16,51,19
Louth,331,166,165,73.1,91,41,100,75,24
Louth,377,187,190,68.57,114,46,105,80,32
Louth,263,126,137,65.43,54,34,59,79,37
Louth,239,124,115,33.8,58,20,75,53,33
Louth,194,100,94,38.81,40,24,48,57,25
Louth,274,132,142,28.24,78,24,66,66,40
Louth,336,179,157,44.63,69,43,96,89,39
Louth,247,115,132,50.87,54,30,75,62,26
Louth,316,167,149,33.04,58,50,81,89,38
Louth,298,163,135,58.19,62,39,56,89,52
Louth,237,130,107,847.2,75,22,104,21,15
Louth,286,146,140,1132.2,44,34,76,81,51
Louth,300,144,156,1705.93,81,38,137,42,2
Louth,340,168,172,3808.71,85,28,167,46,14
Louth,154,72,82,1202.44,10,22,38,45,39
Louth,409,188,221,231.08,106,33,128,89,53
Louth,294,140,154,1891.65,81,27,98,50,38
Louth,359,174,185,797.75,75,65,90,90,39
Louth,223,122,101,810.27,18,29,77,47,52
Louth,155,80,75,3595.87,26,14,46,40,29
Louth,173,90,83,3569.29,18,20,46,39,50
Louth,264,130,134,987.69,67,34,109,35,19
Louth,368,181,187,1654.8,78,77,86,100,27
Louth,289,153,136,1352.48,44,39,77,107,22
Louth,344,175,169,3905.85,87,66,118,62,11
Louth,178,79,99,920.14,28,27,47,30,46
Louth,181,79,102,1783.01,5,5,28,21,122
Louth,313,148,165,115.59,60,41,88,88,36
Louth,230,102,128,71.72,43,28,55,73,31
Louth,231,120,111,113.54,38,36,48,73,36
Louth,457,218,239,112.36,100,56,111,107,83
Louth,338,173,165,93.37,85,43,89,87,34
Louth,292,147,145,81.65,65,27,86,76,38
Louth,352,175,177,60.48,97,39,103,75,38
Louth,261,121,140,36.52,81,22,73,53,32
Louth,229,120,109,35.41,61,34,54,48,32
Louth,254,133,121,62.86,58,27,54,84,31
Louth,228,113,115,63.66,52,29,70,45,32
Louth,150,73,77,32.46,27,11,47,39,26
Louth,109,49,60,936.74,19,10,33,27,20
Louth,189,97,92,1813.59,26,27,51,56,29
Louth,210,109,101,64.79,32,18,57,82,21
Louth,353,158,195,188.92,102,42,102,68,39
Louth,89,38,51,393.09,22,8,40,13,6
Louth,288,141,147,103.65,64,32,65,66,61
Louth,300,155,145,28.53,67,26,73,85,49
Louth,283,139,144,161.59,50,31,73,82,47
Louth,218,99,119,5641.97,56,22,105,23,12
Louth,172,82,90,111.05,42,11,50,38,31
Louth,276,141,135,57.27,53,39,56,86,42
Louth,168,82,86,1840.71,22,24,71,41,10
Louth,200,102,98,912.52,32,21,50,38,59
Louth,309,153,156,46.2,65,47,77,85,35
Louth,337,179,158,34.4,74,60,87,77,39
Louth,366,186,180,223.9,94,34,125,85,28
Louth,210,104,106,119.34,49,15,102,31,13
Louth,239,124,115,85.33,49,39,52,69,30
Louth,303,154,149,106.25,56,53,68,99,27
Louth,321,140,181,478.14,75,37,91,72,46
Louth,346,197,149,68.63,58,48,79,105,56
Louth,228,110,118,51.47,45,30,46,81,26
Louth,221,111,110,111.28,37,33,40,68,43
Louth,335,138,197,7981.7,138,44,100,41,12
Louth,245,128,117,7689.41,54,36,74,54,27
Louth,249,122,127,590.5,65,36,61,70,17
Louth,419,181,238,447.75,133,41,95,73,77
Louth,385,174,211,5987.47,149,34,119,66,17
Louth,276,139,137,3922.18,37,40,60,92,47
Louth,200,94,106,2416.68,52,34,84,29,1
Louth,233,110,123,4716.31,71,38,87,32,5
Louth,361,173,188,34.19,96,47,102,84,32
Louth,266,135,131,87.73,55,49,64,75,23
Louth,355,182,173,49.22,105,30,101,84,35
Louth,220,105,115,170.78,39,19,81,44,37
Louth,191,94,97,250.79,57,11,81,33,9
Louth,318,159,159,1328.98,95,31,119,52,21
Louth,240,113,127,1906.99,48,15,69,58,50
Louth,324,161,163,5732.99,107,30,145,37,5
Louth,250,128,122,6028.16,79,47,79,37,8
Louth,311,151,160,3612.62,120,31,124,31,5
Louth,195,84,111,95.57,67,24,63,32,9
Louth,359,187,172,30.14,77,46,116,90,30
Louth,289,155,134,27.85,71,32,85,68,33
Louth,382,192,190,67.66,126,45,128,54,29
Louth,342,170,172,34.88,84,43,107,73,35
Louth,377,197,180,43.87,77,45,124,94,37
Louth,186,91,95,1994.02,40,15,65,43,23
Louth,285,150,135,74.16,89,32,78,71,15
Louth,198,95,103,1255.54,68,13,89,24,4
Louth,339,173,166,43.36,71,47,107,83,31
Louth,226,119,107,66.59,58,18,74,60,16
Louth,222,120,102,28.58,57,14,77,54,20
Louth,196,105,91,24.38,46,10,60,53,27
Louth,115,69,46,1639.46,8,10,35,46,16
Louth,298,146,152,4450.55,44,34,56,97,67
Louth,356,162,194,5982.09,65,46,94,107,44
Louth,222,115,107,5613.43,27,15,86,57,37
Louth,211,93,118,1998.33,34,25,56,53,43
Louth,230,111,119,4350.29,27,22,51,78,52
Louth,133,60,73,4599.85,21,14,37,37,24
Louth,128,53,75,2741.78,18,16,30,27,37
Louth,94,51,43,878.3,6,12,23,32,21
Louth,187,109,78,7912.33,17,38,110,19,3
Louth,117,68,49,1209.46,14,18,56,19,10
Louth,210,110,100,2906.94,22,26,49,74,39
Louth,172,100,72,12903.23,32,18,100,17,5
Louth,131,68,63,4619.02,23,13,49,27,19
Louth,158,65,93,3527.73,26,14,53,33,32
Louth,254,124,130,4363.36,53,39,71,74,17
Louth,322,155,167,1788.5,96,38,97,71,20
Louth,341,165,176,5283.05,86,38,96,49,72
Louth,319,159,160,5803.17,94,58,93,67,7
Louth,228,114,114,3784.55,33,30,76,65,24
Louth,285,142,143,5151.84,56,34,73,68,54
Louth,226,107,119,5428.52,32,18,70,69,37
Louth,495,174,321,3771.57,72,22,94,75,232
Louth,201,102,99,1847.39,28,13,61,53,46
Louth,301,150,151,2332.09,41,33,79,88,60
Louth,177,88,89,4929.95,28,19,49,58,23
Louth,168,85,83,2688.56,19,21,40,55,33
Louth,183,96,87,4383.34,14,21,47,59,42
Louth,174,78,96,3430.6,44,19,50,33,28
Louth,332,168,164,4349.25,79,58,81,98,16
Louth,334,158,176,2278.15,114,19,156,33,12
Louth,265,123,142,6566.39,72,29,101,59,4
Louth,152,86,66,7401.64,21,28,65,25,13
Louth,138,87,51,1694.39,26,14,55,38,5
Louth,76,44,32,4872.42,8,15,42,11,0
Louth,101,64,37,3179.7,10,9,56,19,7
Louth,268,141,127,5261.09,35,34,75,96,28
Louth,264,116,148,5423.84,47,40,57,87,33
Louth,281,145,136,8358.87,42,31,71,110,27
Louth,218,107,111,4433.15,19,13,67,57,62
Louth,259,138,121,7131.45,36,29,58,84,52
Louth,173,97,76,4527.61,23,18,60,40,32
Louth,300,152,148,8542.38,55,44,130,46,25
Louth,209,98,111,5933.29,22,35,84,35,33
Louth,237,124,113,29.35,57,29,77,53,21
Louth,373,184,189,50.26,101,38,105,75,54
Louth,486,242,244,59.33,106,63,150,102,65
Louth,269,131,138,48.05,64,41,61,83,20
Louth,240,122,118,58.87,48,28,49,69,46
Louth,341,164,177,5012.64,91,44,138,48,20
Louth,204,96,108,373.46,43,30,55,53,23
Louth,343,169,174,119.41,57,52,93,98,43
Louth,304,143,161,946.37,96,28,132,41,7
Louth,253,133,120,39.83,75,21,81,52,24
Louth,490,322,168,89.32,88,44,135,195,28
Louth,338,179,159,26.04,64,36,92,101,45
Louth,125,69,56,906.55,28,8,48,25,16
Louth,320,163,157,127.44,51,42,93,84,50
Louth,163,80,83,17.61,33,20,47,41,22
Louth,235,130,105,42.89,69,30,64,54,18
Louth,233,122,111,35.25,70,23,66,50,24
Louth,285,155,130,110.72,88,28,82,45,42
Louth,192,93,99,1112.6,42,23,67,36,24
Louth,149,80,69,712.9,43,21,45,29,11
Louth,315,145,170,335.23,75,31,118,59,32
Louth,311,159,152,3710.77,85,53,77,78,18
Louth,280,136,144,2431.99,56,55,62,64,43
Louth,330,166,164,1553.72,47,43,73,87,80
Louth,236,117,119,2022.97,34,19,49,56,78
Louth,394,200,194,4329.19,83,209,83,18,1
Louth,235,104,131,2606.71,102,34,58,35,6
Louth,313,166,147,5673.17,46,86,88,48,45
Louth,274,134,140,4167.55,43,35,72,68,56
Louth,289,136,153,7677.8,60,53,89,69,18
Louth,346,176,170,6513.92,124,37,151,26,8
Louth,249,124,125,6711.59,72,26,101,43,7
Louth,283,141,142,7215.89,72,56,93,53,9
Louth,294,157,137,5038.65,95,35,118,36,10
Louth,306,158,148,5578.75,120,29,136,17,4
Louth,331,174,157,4185.74,62,76,87,79,27
Louth,249,120,129,5554.07,49,52,65,60,23
Louth,193,98,95,806.53,64,29,78,18,4
Louth,314,154,160,1479.69,86,36,142,34,16
Louth,454,217,237,522.8,138,60,162,72,22
Louth,317,166,151,4774.6,72,51,85,82,27
Louth,313,150,163,6175.52,55,36,68,78,76
Louth,236,112,124,62.21,48,24,75,57,32
Louth,271,129,142,610.13,52,40,80,69,30
Louth,392,206,186,1758.71,94,57,126,89,26
Louth,187,86,101,5538.61,55,15,105,11,1
Louth,153,74,79,6068.54,33,11,91,16,2
Louth,314,133,181,442.28,18,30,34,56,176
Louth,345,184,161,607.39,19,184,69,40,33
Louth,211,96,115,3614.75,39,36,47,66,23
Louth,177,87,90,305.12,30,15,30,54,48
Louth,248,107,141,5327.26,99,35,72,35,7
Louth,214,101,113,2854.82,28,23,55,55,53
Louth,237,112,125,5439.52,79,28,86,29,15
Louth,363,176,187,4521.56,81,36,108,83,55
Louth,374,177,197,2759.94,88,52,102,94,38
Louth,216,102,114,7077.33,70,28,84,32,2
Louth,335,154,181,6283.53,111,40,119,57,8
Louth,208,114,94,8426.51,32,26,63,42,45
Louth,190,95,95,6010.76,31,24,54,52,29
Louth,160,75,85,1934.26,20,19,24,37,60
Louth,244,116,128,2901,50,17,94,38,45
Louth,216,105,111,4019.5,59,35,104,17,1
Louth,350,139,211,8065.07,167,40,101,37,5
Louth,228,99,129,9080.41,55,60,59,50,4
Louth,264,127,137,5242.98,58,59,66,62,19
Louth,270,150,120,9047.65,75,105,75,15,0
Louth,191,105,86,3780.16,13,123,37,13,5
Louth,275,134,141,5644.73,72,28,86,45,44
Louth,430,209,221,5063.77,118,35,161,78,38
Louth,221,110,111,1819.11,46,11,123,27,14
Louth,171,89,82,6310.66,30,36,40,47,18
Louth,317,146,171,3892.48,48,71,95,83,20
Louth,269,120,149,6212.9,66,43,66,60,34
Louth,432,199,233,1821.92,220,40,144,28,0
Louth,185,87,98,732.35,25,22,70,48,20
Louth,162,75,87,1698.42,20,16,40,48,38
Louth,168,88,80,176.18,36,12,48,39,33
Louth,359,177,182,639.36,122,35,112,57,33
Louth,269,139,130,8441.6,113,29,103,23,1
Louth,236,118,118,6559.93,79,37,83,32,5
Louth,185,88,97,3454.07,48,17,107,12,1
Louth,183,85,98,117.29,41,20,107,13,2
Louth,249,116,133,5615.82,54,39,60,68,28
Louth,285,139,146,7965.34,71,48,82,72,12
Louth,81,48,33,2105.21,5,16,38,9,13
Louth,157,79,78,314.42,23,21,41,46,26
Louth,229,100,129,1564.27,27,40,54,50,58
Louth,220,105,115,707.92,31,23,63,68,35
Louth,200,96,104,5806.86,24,18,77,43,38
Louth,174,95,79,2517.03,15,21,56,44,38
Louth,210,108,102,1849.26,33,81,57,33,6
Louth,178,91,87,4596.16,20,26,57,50,25
Louth,382,195,187,41.27,100,50,111,98,23
Louth,402,201,201,59.24,121,33,136,77,35
Louth,417,200,217,6447.02,151,39,182,36,9
Louth,214,105,109,1060.77,61,14,103,25,11
Louth,166,92,74,1832.65,19,12,73,45,17
Louth,296,143,153,5690.88,82,30,97,30,57
Louth,224,107,117,2290.79,28,23,61,77,35
Louth,236,117,119,52.74,48,34,53,68,33
Louth,257,121,136,72.94,57,34,64,65,37
Louth,202,102,100,377,55,20,102,17,8
Louth,304,148,156,56.28,91,37,99,52,25
Louth,357,191,166,35.95,103,32,120,72,30
Louth,257,135,122,28.74,72,17,78,54,36
Louth,223,114,109,36.43,49,32,63,65,14
Louth,298,157,141,89.99,70,43,93,64,28
Louth,234,117,117,49.58,46,37,59,72,20
Louth,236,119,117,54.29,47,31,60,56,42
Louth,230,115,115,65.8,59,24,72,57,18
Louth,286,146,140,109.25,73,32,77,68,36
Louth,309,133,176,64.39,87,27,109,58,28
Louth,344,165,179,83.92,92,31,102,82,37
Louth,296,138,158,53.6,61,53,65,85,32
Louth,265,130,135,79.53,48,35,60,72,50
Louth,265,134,131,1594.05,34,41,57,93,40
Louth,281,142,139,772.17,90,24,119,33,15
Louth,200,104,96,55.57,48,14,68,47,23
Louth,354,164,190,692.6,73,57,90,89,45
Louth,213,104,109,211.93,27,22,72,45,47
Louth,470,211,259,3241.36,177,41,147,97,8
Louth,407,191,216,3767.02,161,27,147,51,21
Louth,281,134,147,2133.33,61,26,70,71,53
Louth,215,111,104,3361.79,40,30,52,56,37
Louth,172,86,86,1675.42,26,15,43,49,39
Louth,234,111,123,1140.06,69,25,60,57,23
Louth,253,122,131,1317.09,34,26,48,84,61
Louth,226,99,127,1762.8,56,17,70,52,31
Louth,255,127,128,3808.36,53,27,92,62,21
Louth,139,71,68,446.41,21,12,71,26,9
Louth,256,118,138,605.73,35,31,58,74,58
Louth,248,116,132,1085.37,49,23,141,29,6
Louth,283,137,146,228.07,69,38,59,85,32
Louth,274,138,136,93.47,44,35,53,93,49
Louth,279,147,132,62.62,61,41,78,69,30
Louth,245,124,121,19.97,58,26,73,52,36
Louth,323,160,163,189.15,116,23,105,61,18
Louth,326,157,169,82.5,84,30,85,75,52
Louth,246,129,117,31.54,59,28,65,64,30
Louth,229,121,108,39.75,63,24,77,43,22
Louth,324,162,162,44.91,101,31,100,75,17
Louth,198,97,101,40.05,43,33,57,48,17
Louth,339,170,169,40.68,86,39,95,84,35
Louth,263,122,141,239.35,86,25,88,51,13
Louth,256,140,116,124.92,68,31,67,64,26
Louth,210,104,106,38.67,50,21,58,40,41
Louth,239,116,123,799.63,50,30,84,53,22
Louth,370,188,182,26.03,93,50,98,92,37
Louth,235,118,117,140.14,77,23,88,37,10
Louth,202,109,93,319.47,47,16,87,34,18
Louth,377,173,204,46.2,91,35,110,98,43
Louth,267,148,119,72.98,46,41,64,89,27
Louth,343,185,158,41.19,78,44,98,93,30
Louth,355,192,163,102.45,92,38,109,81,35
Louth,277,135,142,42.35,78,34,84,56,25
Louth,273,133,140,474.35,99,19,94,49,12
Louth,229,110,119,275.63,69,22,68,50,20
Louth,477,244,233,97.93,105,66,139,112,55
Louth,467,236,231,40.85,150,51,123,114,29
Louth,286,142,144,68.29,82,35,85,61,23
Louth,243,129,114,24.54,59,33,78,58,15
Louth,284,133,151,45.45,82,19,92,58,33
Louth,354,167,187,98.41,85,48,92,91,38
Louth,185,90,95,98.46,36,19,47,55,28
Louth,437,219,218,27.25,103,49,111,113,61
Louth,314,156,158,63.32,62,41,81,91,39
Louth,267,136,131,57.77,60,35,62,83,27
Louth,257,126,131,3328.46,42,43,61,78,33
Louth,350,178,172,6389.66,129,24,161,32,4
Louth,210,104,106,728.72,30,22,62,48,48
Louth,381,203,178,7622.9,70,78,111,104,18
Louth,271,127,144,708.98,26,27,58,64,96
Louth,268,129,139,4969.68,63,42,65,75,23
Louth,312,152,160,9545.66,66,56,89,89,12
Louth,218,113,105,7809.14,49,28,63,40,38
Louth,318,157,161,3637.78,58,40,74,99,47
Louth,282,148,134,1975.36,59,39,127,43,14
Louth,241,130,111,6543.4,24,31,69,65,52
Louth,262,121,141,3014.86,65,33,81,55,28
Louth,330,173,157,5135.71,92,47,123,58,10
Louth,153,82,71,3582.22,14,22,50,37,30
Louth,134,64,70,2242.98,18,17,54,29,16
Louth,209,96,113,6373.31,55,20,80,28,26
Louth,212,101,111,2980.71,44,28,66,50,24
Louth,137,67,70,2887.8,18,24,49,30,16
Louth,193,88,105,3177.48,28,20,58,46,41
Louth,182,81,101,3019.59,25,17,33,47,60
Louth,258,130,128,9822.58,37,24,68,47,82
Louth,292,141,151,7972.26,50,31,66,48,97
Louth,175,88,87,4968.77,20,21,37,38,59
Louth,165,77,88,2868.47,19,26,72,40,8
Louth,232,122,110,1097.47,34,27,78,54,39
Louth,236,126,110,4703.91,78,10,108,29,11
Louth,306,143,163,1506.3,81,43,104,58,20
Louth,319,158,161,5995,99,41,128,47,4
Louth,355,191,164,143.76,82,56,88,98,31
Louth,206,109,97,2715.06,78,15,90,17,6
Louth,234,111,123,6964.08,91,9,123,7,4
Louth,349,173,176,101.86,88,27,131,70,33
Louth,323,162,161,549.34,81,28,153,49,12
Louth,177,81,96,53.2,43,20,57,42,15
Louth,255,135,120,40.41,58,31,71,70,25
Louth,265,118,147,181.77,72,18,119,38,18
Louth,424,229,195,41.6,89,43,114,126,52
Louth,434,202,232,5197.54,181,36,171,40,6
Louth,298,144,154,3491.34,39,41,63,111,44
Louth,415,202,213,8306.65,145,44,189,33,4
Louth,431,217,214,10837.59,181,33,186,28,3
Louth,338,170,168,7846.23,118,18,184,18,0
Louth,459,206,253,4668.9,195,63,146,49,6
Louth,319,163,156,2768.9,40,56,65,112,46
Louth,272,130,142,1668.76,43,53,70,87,19
Louth,355,166,189,4365.9,107,67,103,63,15
Louth,424,198,226,5122.57,174,59,131,44,16
Louth,260,130,130,221.47,55,32,65,65,43
Louth,387,196,191,2222.16,165,42,140,37,3
Louth,276,134,142,76.09,56,39,55,83,43
Louth,214,102,112,45.94,58,20,49,53,34
Louth,253,132,121,4811.26,93,9,127,21,3
Louth,223,111,112,3261.43,73,25,102,20,3
Louth,344,172,172,2553.27,105,29,160,43,7
Louth,285,141,144,24.64,72,33,80,74,26
Louth,335,170,165,31.39,98,30,90,80,37
Louth,429,229,200,43.38,91,57,134,116,31
Louth,303,149,154,23.23,64,32,88,80,39
Louth,327,157,170,1236.37,81,54,91,80,21
Louth,307,149,158,62.54,84,39,80,85,19
Louth,237,116,121,69.76,41,25,52,74,45
Louth,326,163,163,52.27,96,45,84,83,18
Louth,397,197,200,91.87,102,70,102,103,20
Louth,209,105,104,249.88,58,24,55,57,15
Louth,261,129,132,377.08,65,35,83,61,17
Louth,342,156,186,116.82,71,34,58,98,81
Louth,122,60,62,47.19,19,5,37,45,16
Louth,219,111,108,3022.86,86,11,104,14,4
Louth,320,161,159,272.61,87,37,100,73,23
Louth,361,169,192,208.99,144,37,115,45,20
Louth,193,98,95,1448.1,35,21,49,56,32
Louth,166,80,86,313.58,16,15,52,49,34
Louth,277,128,149,1203.41,30,19,42,87,99
Louth,343,167,176,5868.36,76,55,126,79,7
Louth,312,153,159,5502.74,49,61,80,97,25
Louth,278,142,136,5790.7,52,47,86,73,20
Louth,230,111,119,3577.65,40,17,71,50,52
Louth,211,104,107,5048.69,29,27,48,60,47
Louth,216,108,108,3080.87,31,24,51,55,55
Louth,246,119,127,3827.3,61,35,62,74,14
Louth,258,113,145,2609.88,62,28,85,57,26
Louth,312,152,160,4358.33,80,34,153,34,11
Louth,217,100,117,2056.29,50,26,125,16,0
Louth,209,104,105,5598.71,45,17,120,23,4
Louth,250,116,134,2568.16,43,21,91,51,44
Louth,299,153,146,6089.12,47,36,122,66,28
Louth,180,83,97,5369.77,24,23,46,51,36
Louth,145,80,65,2685.78,14,20,51,40,20
Louth,114,64,50,2202.26,11,15,40,31,17
Louth,175,73,102,1268.55,13,15,35,52,60
Louth,251,134,117,2159.49,75,32,92,28,24
Louth,189,93,96,2775.9,28,15,53,46,47
Louth,277,139,138,4875.47,32,33,78,82,52
Louth,273,135,138,1311.37,44,23,60,74,72
Louth,142,69,73,2677.73,12,17,40,39,34
Louth,182,81,101,5542.87,20,27,47,44,44
Louth,180,89,91,5088.2,20,24,46,49,41
Louth,220,124,96,5499.86,39,32,63,53,33
Louth,187,100,87,4260.75,37,31,59,39,21
Louth,130,65,65,5567.69,22,14,60,24,10
Louth,146,73,73,763.2,21,18,55,21,31
Louth,224,111,113,7712.97,39,32,119,21,13
Louth,177,88,89,117.93,24,22,45,61,25
Louth,305,164,141,2849.72,30,41,71,98,65
Louth,278,135,143,4514.23,59,40,95,70,14
Louth,233,118,115,1868.36,47,28,59,71,28
Louth,205,105,100,516.33,47,28,70,31,29
Louth,179,91,88,2286.02,32,26,46,53,22
Louth,240,112,128,2202.68,40,26,84,51,39
Louth,315,144,171,5212.04,80,38,108,70,19
Louth,307,150,157,8630.14,76,53,105,64,9
Louth,238,126,112,7293.45,34,26,79,57,42
Louth,190,95,95,3707.39,24,17,61,61,27
Louth,167,87,80,5340.07,19,16,62,39,31
Louth,250,134,116,3601.89,41,36,109,32,32
Louth,127,75,52,2294.45,9,23,60,24,11
Louth,288,146,142,584.03,15,35,54,114,70
Louth,123,61,62,2753.4,7,15,54,30,17
Louth,178,92,86,1432.77,17,25,53,31,52
Louth,176,81,95,5200.79,51,30,68,25,2
Louth,181,87,94,6329.11,63,16,82,18,2
Louth,245,119,126,4175.54,30,31,56,85,43
Louth,345,163,182,5357.23,69,49,102,88,37
Louth,246,116,130,4030.67,40,35,66,77,28
Louth,314,145,169,4804.24,61,25,102,89,37
Louth,271,123,148,1053.29,41,41,67,86,36
Louth,174,97,77,3997.7,27,24,49,55,19
Louth,203,98,105,7128.81,43,43,53,51,13
Louth,287,135,152,6803.53,81,46,103,54,3
Louth,279,136,143,6819.18,64,58,76,74,7
Louth,373,175,198,6497.69,128,66,119,53,7
Louth,358,173,185,10523.22,145,32,149,26,6
Louth,307,152,155,375.94,86,36,110,65,10
Louth,331,149,182,6140.32,136,27,127,36,5
Louth,281,131,150,8777.68,82,63,81,48,7
Louth,347,154,193,7357.15,135,51,113,47,1
Louth,358,188,170,3241.87,116,36,173,33,0
Louth,337,167,170,1233.45,103,41,133,45,15
Louth,223,111,112,5449.26,72,14,114,22,1
Louth,329,159,170,12703.68,104,32,154,36,3
Louth,245,117,128,7653.38,45,32,70,69,29
Louth,348,169,179,1521.28,88,64,83,86,27
Louth,239,120,119,501.96,57,19,78,53,32
Louth,445,224,221,3620.86,141,29,207,62,6
Louth,313,146,167,4140.87,77,31,110,72,23
Louth,295,151,144,2526.79,72,24,101,65,33
Louth,286,130,156,3318.83,69,44,56,95,22
Louth,444,229,215,4570.68,139,45,190,64,6
Louth,333,161,172,3893.42,79,51,91,85,27
Louth,168,87,81,4379.56,25,27,37,60,19
Louth,203,94,109,3695.34,22,44,32,85,20
Mayo,210,109,101,42.29,35,24,45,63,43
Mayo,140,72,68,15.38,16,15,33,43,33
Mayo,246,132,114,32.02,30,29,46,73,68
Mayo,108,47,61,12.9,18,13,19,33,25
Mayo,135,69,66,7.23,28,17,26,46,18
Mayo,120,69,51,15.33,29,7,33,31,20
Mayo,170,86,84,90.96,37,19,62,32,20
Mayo,202,107,95,21.94,41,19,42,59,41
Mayo,234,122,112,14.89,60,25,65,56,28
Mayo,303,161,142,56.77,85,29,100,71,18
Mayo,258,132,126,36.85,67,36,78,57,20
Mayo,217,114,103,57.7,53,32,42,67,23
Mayo,216,105,111,33.67,54,26,53,58,25
Mayo,116,72,44,5.03,8,20,24,44,20
Mayo,174,88,86,20.35,31,22,28,60,33
Mayo,182,86,96,19.93,27,19,38,42,56
Mayo,270,142,128,32.66,58,38,48,81,45
Mayo,231,116,115,15.26,38,33,42,76,42
Mayo,110,60,50,7.26,13,14,26,39,18
Mayo,168,94,74,23.22,24,22,50,45,27
Mayo,141,74,67,25.57,15,21,31,42,32
Mayo,275,140,135,26.69,49,37,54,86,49
Mayo,159,80,79,29.01,39,16,36,43,25
Mayo,249,124,125,33.37,49,30,66,65,39
Mayo,199,98,101,21.74,49,26,50,45,29
Mayo,197,94,103,71.19,40,22,48,56,31
Mayo,217,112,105,28.56,54,19,52,53,39
Mayo,347,175,172,18.07,84,34,83,102,44
Mayo,202,107,95,25.99,44,26,44,55,33
Mayo,227,111,116,58.1,46,34,49,62,36
Mayo,213,105,108,35.5,64,16,43,64,26
Mayo,344,172,172,475.02,76,39,92,103,34
Mayo,342,171,171,57.6,82,50,63,116,31
Mayo,260,118,142,1537.3,62,35,91,51,21
Mayo,294,148,146,187.18,94,19,100,49,32
Mayo,232,115,117,40.29,58,26,64,58,26
Mayo,301,153,148,61.29,61,46,63,94,37
Mayo,333,160,173,2126.06,108,13,163,37,12
Mayo,221,112,109,585.64,44,20,58,57,42
Mayo,259,126,133,3197.65,67,26,127,33,6
Mayo,349,179,170,3381.46,107,37,119,71,15
Mayo,177,90,87,474.55,42,22,59,41,13
Mayo,160,73,87,1476.91,52,7,88,12,1
Mayo,228,110,118,34.29,54,33,46,62,33
Mayo,165,88,77,11.5,39,15,39,47,25
Mayo,241,111,130,11.99,46,27,48,79,41
Mayo,166,85,81,28.53,33,18,35,54,26
Mayo,200,104,96,33.11,41,34,39,67,19
Mayo,151,72,79,25.43,28,19,39,45,20
Mayo,134,65,69,138,23,14,51,33,13
Mayo,222,116,106,133.79,54,23,81,56,8
Mayo,269,136,133,18.09,58,36,68,69,38
Mayo,183,86,97,861.64,47,12,71,41,12
Mayo,152,65,87,233.72,28,16,30,45,33
Mayo,221,111,110,21.22,38,27,57,63,36
Mayo,220,111,109,39.8,37,37,45,74,27
Mayo,401,210,191,90.36,82,52,95,128,44
Mayo,326,159,167,56.02,72,45,69,105,35
Mayo,241,131,110,185.58,61,30,89,48,13
Mayo,211,105,106,2560.4,84,22,76,22,7
Mayo,186,88,98,93.81,51,20,54,36,25
Mayo,345,164,181,455.82,100,32,136,51,26
Mayo,141,70,71,444.11,17,21,45,36,22
Mayo,167,80,87,2797.27,36,23,65,33,10
Mayo,258,120,138,82.76,65,25,73,66,29
Mayo,188,85,103,4460.26,57,15,85,26,5
Mayo,299,146,153,1890.08,76,35,106,62,20
Mayo,224,97,127,3419.22,53,25,69,59,18
Mayo,217,96,121,1873.56,38,32,68,48,31
Mayo,156,75,81,2458.63,25,24,37,42,28
Mayo,141,70,71,1905.69,11,15,54,40,21
Mayo,105,63,42,1728.57,6,8,32,34,25
Mayo,148,72,76,265.96,12,28,34,41,33
Mayo,292,151,141,2341.28,109,61,63,46,13
Mayo,177,101,76,4836.73,30,24,38,55,30
Mayo,165,89,76,4464.53,28,19,33,55,30
Mayo,243,135,108,2470.69,17,25,38,64,99
Mayo,130,59,71,2633.98,24,22,49,24,11
Mayo,159,87,72,1119.95,19,14,56,48,22
Mayo,196,102,94,1126.91,27,19,40,75,35
Mayo,151,67,84,1255.45,24,20,36,39,32
Mayo,137,65,72,1623.61,21,11,37,38,30
Mayo,156,82,74,499.31,17,19,49,42,29
Mayo,293,146,147,3988.57,47,46,75,85,40
Mayo,226,111,115,2064.08,51,20,77,51,27
Mayo,237,123,114,2462.01,54,33,100,36,14
Mayo,267,128,139,92.52,92,22,81,49,23
Mayo,189,103,86,19.79,46,18,50,46,29
Mayo,150,67,83,15.82,31,12,38,39,30
Mayo,231,119,112,25.51,48,17,45,62,59
Mayo,157,78,79,14.64,45,15,29,42,26
Mayo,113,57,56,5.55,24,6,24,34,25
Mayo,113,60,53,4.73,14,12,31,31,25
Mayo,228,114,114,28.15,55,27,55,60,31
Mayo,197,107,90,19.01,33,20,43,70,31
Mayo,217,97,120,245.92,46,27,69,45,30
Mayo,181,91,90,61.7,33,27,36,57,28
Mayo,182,87,95,33.26,34,17,47,56,28
Mayo,172,93,79,10.94,41,18,43,42,28
Mayo,249,128,121,39.29,56,36,57,68,32
Mayo,133,66,67,2423.03,30,14,73,14,2
Mayo,191,96,95,596.93,61,16,71,26,17
Mayo,184,87,97,826.37,54,13,64,36,17
Mayo,198,105,93,75.7,63,15,88,24,8
Mayo,159,75,84,495.78,25,20,54,44,16
Mayo,178,82,96,735.92,38,19,77,28,16
Mayo,258,127,131,230.62,64,29,83,53,29
Mayo,279,142,137,17.57,56,29,76,69,49
Mayo,216,105,111,47.02,57,30,67,42,20
Mayo,282,110,172,317.22,46,25,52,51,108
Mayo,207,96,111,2585.72,58,24,84,22,19
Mayo,295,156,139,281.22,102,21,143,23,6
Mayo,82,42,40,1958.35,10,11,39,17,5
Mayo,233,120,113,1286.11,42,25,84,58,24
Mayo,157,80,77,4.84,34,14,27,51,31
Mayo,151,70,81,6.34,30,13,40,40,28
Mayo,158,77,81,117.97,29,29,24,43,33
Mayo,193,90,103,30.45,33,18,36,68,38
Mayo,129,67,62,10.51,23,11,16,37,42
Mayo,191,106,85,2.68,45,17,41,54,34
Mayo,171,92,79,19.24,34,18,36,55,28
Mayo,233,109,124,43.6,54,28,62,58,31
Mayo,324,158,166,201.48,72,27,102,77,46
Mayo,209,105,104,161.18,41,14,73,42,39
Mayo,159,88,71,27.33,28,11,39,53,28
Mayo,219,123,96,46.14,41,22,73,46,37
Mayo,403,175,228,518.73,164,40,141,43,15
Mayo,322,180,142,4149.48,102,43,146,26,5
Mayo,195,97,98,2646.18,52,18,75,31,19
Mayo,234,146,88,794.35,52,39,78,52,13
Mayo,131,61,70,912.14,28,22,30,35,16
Mayo,148,80,68,648.38,20,29,35,29,35
Mayo,124,73,51,309.73,16,9,40,36,23
Mayo,122,63,59,652.04,23,8,38,31,22
Mayo,301,154,147,33.58,70,33,84,78,36
Mayo,309,150,159,39.6,68,37,81,87,36
Mayo,180,89,91,14.03,42,19,41,50,28
Mayo,284,142,142,31.57,55,35,54,100,40
Mayo,170,98,72,6.42,32,19,42,50,27
Mayo,188,89,99,10.25,43,25,30,55,35
Mayo,215,108,107,6.48,31,19,48,71,46
Mayo,326,172,154,21.7,78,41,79,93,35
Mayo,263,141,122,20.8,56,25,69,75,38
Mayo,127,65,62,4.06,36,17,37,28,9
Mayo,121,58,63,482.1,24,21,30,28,18
Mayo,217,102,115,14.49,30,41,43,76,27
Mayo,113,58,55,2.34,16,13,28,36,20
Mayo,205,106,99,17.61,40,20,57,51,37
Mayo,157,80,77,22.29,38,9,35,49,26
Mayo,191,101,90,26.64,36,24,43,55,33
Mayo,203,102,101,21.4,44,27,42,66,24
Mayo,238,119,119,32.85,53,26,66,72,21
Mayo,148,73,75,15,26,25,27,47,23
Mayo,201,112,89,21.38,39,20,54,65,23
Mayo,208,102,106,49.83,57,19,52,53,27
Mayo,212,101,111,83.48,50,11,69,58,24
Mayo,209,111,98,15.83,36,37,48,59,29
Mayo,303,157,146,78.22,48,38,60,74,83
Mayo,185,100,85,919.37,19,18,56,54,38
Mayo,300,161,139,56.87,67,40,71,86,36
Mayo,282,138,144,1855.54,54,27,117,61,23
Mayo,248,129,119,375.17,42,24,83,62,37
Mayo,277,140,137,902.53,74,32,85,46,40
Mayo,309,147,162,25.58,76,18,102,73,40
Mayo,144,74,70,15.32,32,21,29,44,18
Mayo,151,83,68,16.63,28,19,32,42,30
Mayo,178,90,88,30.32,41,28,31,56,22
Mayo,173,86,87,27.64,40,18,45,43,27
Mayo,259,119,140,90.48,68,22,93,49,27
Mayo,345,179,166,33.17,79,43,81,97,45
Mayo,364,186,178,54.83,101,38,98,95,32
Mayo,348,165,183,304.53,81,39,113,92,23
Mayo,439,221,218,141.8,110,62,93,139,35
Mayo,94,54,40,1.73,10,13,17,33,21
Mayo,155,83,72,15.03,33,17,40,49,16
Mayo,145,71,74,5.4,28,22,37,42,16
Mayo,217,114,103,11.71,38,20,54,61,44
Mayo,223,118,105,22.19,43,36,43,68,33
Mayo,176,92,84,13.82,31,17,40,60,28
Mayo,236,120,116,12.88,58,27,53,59,39
Mayo,140,70,70,5.34,24,13,28,47,28
Mayo,202,103,99,9.55,44,24,44,58,32
Mayo,168,87,81,14.97,40,9,48,44,27
Mayo,175,99,76,15.03,41,11,46,56,21
Mayo,201,107,94,13.21,46,27,51,56,21
Mayo,261,129,132,41.6,70,33,71,65,22
Mayo,236,119,117,33.22,57,27,56,54,42
Mayo,219,113,106,42.41,47,28,61,66,17
Mayo,268,130,138,44.36,61,47,49,89,22
Mayo,304,143,161,82.66,60,46,73,96,29
Mayo,292,149,143,96.93,84,34,70,78,26
Mayo,229,96,133,579.84,90,31,72,33,3
Mayo,98,49,49,37.37,5,15,34,21,23
Mayo,352,170,182,42.37,70,68,79,102,33
Mayo,245,106,139,674.2,55,21,118,37,14
Mayo,264,119,145,2684.43,81,33,132,13,5
Mayo,217,104,113,124.23,43,28,35,76,35
Mayo,194,92,102,2815.88,61,14,74,28,17
Mayo,210,107,103,3173.02,45,39,40,78,8
Mayo,228,109,119,2169.65,54,18,132,21,3
Mayo,188,77,111,2547.98,42,17,87,25,17
Mayo,205,103,102,184.96,44,15,96,31,19
Mayo,311,159,152,44.52,71,51,60,105,24
Mayo,277,129,148,262.05,56,38,55,88,40
Mayo,186,87,99,3252.66,52,11,106,15,2
Mayo,244,112,132,3030.42,52,30,79,63,20
Mayo,256,124,132,3874.15,77,32,108,36,3
Mayo,233,106,127,3344.72,53,48,65,49,18
Mayo,192,92,100,459.64,50,24,73,36,9
Mayo,238,107,131,3639.98,85,21,97,30,5
Mayo,166,73,93,931,53,17,60,29,7
Mayo,255,113,142,3139.16,84,35,74,59,3
Mayo,270,133,137,390.48,49,44,63,86,28
Mayo,164,69,95,2964.14,33,22,60,39,10
Mayo,246,131,115,4048.58,56,35,95,48,12
Mayo,325,170,155,2364.46,102,36,136,44,7
Mayo,246,128,118,90.72,60,30,43,88,25
Mayo,306,142,164,635.97,65,39,117,62,23
Mayo,358,171,187,737.48,33,27,84,72,142
Mayo,170,82,88,455.43,21,14,41,63,31
Mayo,109,62,47,1798.98,5,56,33,12,3
Mayo,247,116,131,3734.73,49,43,101,35,19
Mayo,118,59,59,1416.4,16,12,21,38,31
Mayo,175,84,91,3203.19,24,15,47,36,53
Mayo,223,110,113,592.8,34,31,69,54,35
Mayo,180,87,93,2892.31,11,21,75,45,28
Mayo,142,67,75,7292.15,17,14,46,38,27
Mayo,219,103,116,2407.86,38,27,72,63,19
Mayo,264,128,136,2736.12,54,35,78,63,34
Mayo,265,124,141,1101,58,24,110,48,25
Mayo,254,131,123,760.56,37,34,60,74,49
Mayo,212,67,145,667.02,13,15,45,36,103
Mayo,241,102,139,1267.29,47,69,56,41,28
Mayo,294,148,146,2087.58,53,38,64,86,53
Mayo,186,87,99,1895.68,17,22,104,29,14
Mayo,155,83,72,2872.29,27,29,48,41,10
Mayo,165,89,76,3653.92,23,34,50,43,15
Mayo,227,107,120,1403.15,42,25,53,61,46
Mayo,303,153,150,2924.6,67,64,111,54,7
Mayo,256,117,139,4650.99,53,34,80,69,20
Mayo,262,118,144,1905.05,57,25,94,49,37
Mayo,178,83,95,2617.07,16,23,45,46,48
Mayo,322,156,166,2275.41,35,27,42,67,151
Mayo,157,78,79,2081.1,23,19,40,65,10
Mayo,191,96,95,4791.41,47,24,52,53,15
Mayo,176,92,84,5124.02,27,36,94,13,6
Mayo,221,128,93,9.69,45,21,56,59,40
Mayo,251,114,137,66.95,80,32,51,65,23
Mayo,260,130,130,182.85,56,34,85,60,25
Mayo,286,146,140,62.35,84,30,97,56,19
Mayo,280,132,148,228.88,66,34,79,65,36
Mayo,267,118,149,65.41,64,40,80,60,23
Mayo,294,149,145,458.21,87,34,142,29,2
Mayo,268,124,144,645.48,54,26,105,41,42
Mayo,286,124,162,696.84,72,28,85,37,64
Mayo,235,101,134,2144.73,32,37,61,70,35
Mayo,179,77,102,1562.88,35,26,83,27,8
Mayo,92,41,51,1237.87,10,9,16,22,35
Mayo,208,88,120,304.03,27,32,60,58,31
Mayo,169,80,89,1264.71,43,30,45,34,17
Mayo,287,120,167,1089.44,43,32,100,66,46
Mayo,151,71,80,753.18,27,24,38,33,29
Mayo,94,47,47,970.28,6,20,34,21,13
Mayo,197,85,112,58.77,47,33,56,52,9
Mayo,183,87,96,136.62,25,25,43,43,47
Mayo,315,162,153,24.03,65,29,83,82,56
Mayo,237,122,115,32.04,58,29,68,64,18
Mayo,245,120,125,49.56,59,21,72,72,21
Mayo,350,182,168,26.46,84,39,91,94,42
Mayo,275,162,113,70.23,55,32,64,86,38
Mayo,163,79,84,11.99,30,16,32,45,40
Mayo,190,91,99,37.01,32,20,37,75,26
Mayo,277,133,144,40.87,49,37,69,81,41
Mayo,311,164,147,20.5,66,47,72,88,38
Mayo,177,99,78,12.6,14,34,23,79,27
Mayo,136,77,59,14.71,23,19,22,48,24
Mayo,179,91,88,23.21,24,25,45,49,36
Mayo,161,82,79,11.19,28,19,37,54,23
Mayo,323,168,155,51.59,73,47,96,64,43
Mayo,160,81,79,23.71,36,11,49,43,21
Mayo,179,102,77,21.05,36,20,52,46,25
Mayo,194,103,91,19.53,47,22,50,39,36
Mayo,176,97,79,28.66,60,8,48,40,20
Mayo,133,71,62,18.17,10,20,22,53,28
Mayo,279,141,138,15.37,44,23,74,81,57
Mayo,141,70,71,4.33,26,8,44,31,32
Mayo,143,73,70,17.52,10,28,25,49,31
Mayo,224,120,104,11.31,26,23,47,64,64
Mayo,238,125,113,25.04,54,27,62,54,41
Mayo,212,111,101,13.41,34,20,59,64,35
Mayo,166,83,83,5.27,30,20,40,48,28
Mayo,168,82,86,218.8,34,19,31,59,25
Mayo,143,74,69,24.53,32,8,33,46,24
Mayo,329,180,149,78.51,85,48,89,86,21
Mayo,256,128,128,26.36,69,23,61,66,37
Mayo,281,148,133,11.26,58,46,60,72,45
Mayo,209,103,106,175.77,55,21,78,32,23
Mayo,254,136,118,406.9,31,43,78,79,23
Mayo,161,81,80,140.67,28,10,48,34,41
Mayo,127,75,52,357.01,13,13,36,32,33
Mayo,137,80,57,5.92,17,24,34,41,21
Mayo,227,110,117,26.62,61,23,62,54,27
Mayo,168,93,75,27.85,25,21,23,61,38
Mayo,235,110,125,406.11,46,35,57,49,48
Mayo,111,48,63,279.54,23,7,32,23,26
Mayo,159,83,76,13.73,34,15,40,36,34
Mayo,214,113,101,20.46,47,25,41,68,33
Mayo,158,77,81,27.49,32,11,37,47,31
Mayo,172,93,79,16.2,28,22,41,56,25
Mayo,147,72,75,11.46,38,12,42,29,26
Mayo,164,85,79,11.75,41,12,46,38,27
Mayo,193,93,100,28.04,35,29,48,51,30
Mayo,244,127,117,70.5,47,35,68,70,24
Mayo,202,103,99,80.47,48,18,77,37,22
Mayo,128,63,65,196.76,31,12,36,27,22
Mayo,177,103,74,22.5,14,32,45,63,23
Mayo,292,140,152,15.74,68,37,61,84,42
Mayo,240,135,105,9.77,33,46,50,59,52
Mayo,195,99,96,2.98,31,24,43,55,42
Mayo,208,107,101,14.31,51,25,55,56,21
Mayo,184,95,89,31.87,41,24,49,52,18
Mayo,99,46,53,96.62,16,12,28,27,16
Mayo,187,101,86,12.64,29,14,39,62,43
Mayo,190,99,91,8.83,41,15,40,54,40
Mayo,100,43,57,9.66,38,5,20,18,19
Mayo,141,64,77,666.89,15,16,27,36,47
Mayo,148,72,76,17.02,27,17,25,46,33
Mayo,183,94,89,3.34,30,22,48,56,27
Mayo,183,97,86,9.49,29,14,51,57,32
Mayo,123,64,59,17.39,20,12,21,42,28
Mayo,320,167,153,26.95,89,33,89,58,51
Mayo,231,123,108,18.25,64,23,56,50,38
Mayo,224,117,107,20.39,46,25,57,67,29
Mayo,241,127,114,17.37,47,26,62,58,48
Mayo,243,136,107,4.19,49,22,58,77,37
Mayo,181,99,82,25.57,38,19,52,49,23
Mayo,158,78,80,6.54,32,16,43,41,26
Mayo,187,91,96,33.61,47,27,36,55,22
Mayo,235,123,112,5.12,40,24,57,68,46
Mayo,129,60,69,3.53,19,18,19,48,25
Mayo,219,111,108,25.01,59,21,59,49,31
Mayo,206,99,107,50.4,25,19,42,53,67
Mayo,201,105,96,13.89,56,18,55,45,27
Mayo,197,100,97,26.11,48,16,57,52,24
Mayo,158,81,77,15.41,28,20,43,34,33
Mayo,193,92,101,54.39,48,15,58,42,30
Mayo,123,69,54,11.38,32,15,23,35,18
Mayo,174,93,81,23.99,39,14,44,42,35
Mayo,192,103,89,10.63,39,32,36,64,21
Mayo,233,121,112,51.09,61,35,55,61,21
Mayo,174,84,90,21.55,35,18,55,45,21
Mayo,223,112,111,53.74,47,31,54,70,21
Mayo,186,106,80,25.96,48,24,46,49,19
Mayo,191,103,88,19.73,44,32,33,55,27
Mayo,184,91,93,22.25,28,26,39,58,33
Mayo,180,91,89,975.26,40,18,52,32,38
Mayo,203,108,95,195.58,40,18,78,29,38
Mayo,166,81,85,26.62,35,30,29,48,24
Mayo,154,77,77,11.53,28,18,24,54,30
Mayo,262,129,133,22.94,69,34,60,73,26
Mayo,261,127,134,29.22,59,45,55,74,28
Mayo,154,75,79,11.29,30,20,27,51,26
Mayo,171,80,91,16,40,21,43,37,30
Mayo,176,81,95,23.07,34,26,42,51,23
Mayo,191,102,89,24.74,34,24,54,52,27
Mayo,226,117,109,9.12,60,14,51,60,41
Mayo,259,140,119,3.47,56,33,56,66,48
Mayo,134,71,63,1.55,19,12,38,41,24
Mayo,264,134,130,123.82,71,26,71,65,31
Mayo,297,154,143,28.17,46,38,71,94,48
Mayo,240,130,110,5.65,47,34,48,70,41
Mayo,114,61,53,1.85,14,17,23,31,29
Mayo,189,104,85,18.04,31,27,38,55,38
Mayo,201,106,95,37.25,42,31,54,47,27
Mayo,259,139,120,18.76,57,32,53,80,37
Mayo,145,70,75,164.88,41,10,40,32,22
Mayo,164,89,75,15.97,34,13,30,46,41
Mayo,188,110,78,12.25,37,26,42,52,31
Mayo,168,91,77,22.96,27,21,45,49,26
Mayo,193,102,91,30.33,38,22,46,60,27
Mayo,139,64,75,726.19,35,14,37,30,23
Mayo,163,77,86,92.28,38,17,48,35,25
Mayo,147,73,74,70.98,17,9,41,48,32
Mayo,146,71,75,2924.68,27,32,35,41,11
Mayo,223,111,112,15.45,45,30,67,55,26
Mayo,237,119,118,26.13,48,28,65,62,34
Mayo,217,105,112,24.55,59,25,55,52,26
Mayo,189,88,101,39.24,43,22,38,58,28
Mayo,158,81,77,22.32,29,15,44,41,29
Mayo,169,92,77,40.21,37,25,33,48,26
Mayo,224,115,109,27.32,46,21,60,70,27
Mayo,336,169,167,21.92,91,41,100,73,31
Mayo,258,134,124,16.43,55,19,63,60,61
Mayo,243,134,109,20.28,45,20,59,75,44
Mayo,296,141,155,57.84,61,38,73,80,44
Mayo,191,96,95,26.19,46,17,58,43,27
Mayo,293,153,140,67.74,78,33,84,77,21
Mayo,225,115,110,57.95,67,13,58,62,25
Mayo,213,110,103,58.55,63,18,59,51,22
Mayo,190,103,87,33.38,41,23,41,48,37
Mayo,212,114,98,39.57,74,23,47,47,21
Mayo,180,91,89,18.93,42,25,35,48,30
Mayo,168,82,86,16.45,38,17,41,42,30
Mayo,175,91,84,26.9,40,20,49,41,25
Mayo,164,81,83,25.24,35,12,39,50,28
Mayo,176,94,82,18.17,38,26,44,46,22
Mayo,182,93,89,8.66,52,19,48,41,22
Mayo,119,67,52,37.26,25,9,34,31,20
Mayo,108,51,57,37.42,21,7,19,40,21
Mayo,235,113,122,383.83,46,28,69,61,31
Mayo,151,76,75,1186.8,17,18,33,48,35
Mayo,193,98,95,31.46,38,24,38,49,44
Mayo,151,72,79,319.19,14,18,43,31,45
Mayo,148,71,77,425.84,29,22,57,32,8
Mayo,130,63,67,940.66,16,16,34,33,31
Mayo,175,86,89,43.44,46,15,44,52,18
Mayo,173,85,88,25,39,20,36,50,28
Mayo,154,73,81,892.29,37,27,56,24,10
Mayo,135,75,60,16.94,24,9,39,42,21
Mayo,163,78,85,42.72,32,18,40,39,34
Mayo,289,150,139,19.34,70,23,80,69,47
Mayo,186,98,88,31.09,44,20,63,39,20
Mayo,211,102,109,21.78,59,15,70,38,29
Mayo,188,100,88,29.33,52,25,43,50,18
Mayo,166,86,80,45.32,47,21,40,46,12
Mayo,225,120,105,14.12,45,21,56,61,42
Mayo,191,96,95,22.95,28,22,42,72,27
Mayo,136,74,62,279.48,35,11,48,21,21
Mayo,101,40,61,252.58,11,8,18,23,41
Mayo,82,36,46,57,12,6,22,26,16
Mayo,105,48,57,664.16,23,8,23,16,35
Mayo,117,60,57,12.84,6,13,13,52,33
Mayo,275,120,155,62.95,52,31,60,72,60
Mayo,177,88,89,14.61,37,17,41,43,39
Mayo,156,82,74,7.99,30,20,32,47,27
Mayo,180,93,87,39.03,38,24,38,58,22
Mayo,264,135,129,10.78,38,41,43,94,48
Mayo,217,109,108,19.69,37,32,42,66,40
Mayo,170,84,86,26.55,42,16,37,41,34
Mayo,110,58,52,7.19,20,10,28,29,23
Mayo,116,48,68,22.93,17,16,25,38,20
Mayo,125,72,53,8.65,18,18,32,31,26
Mayo,132,67,65,21.53,24,11,38,36,23
Mayo,188,97,91,18.67,42,15,42,45,44
Mayo,125,62,63,30.66,22,17,26,39,21
Mayo,154,92,62,4.41,26,21,31,45,31
Mayo,192,98,94,17.06,38,28,40,64,22
Mayo,166,90,76,13.26,25,26,25,59,31
Mayo,176,82,94,38.28,40,14,55,40,27
Mayo,163,76,87,16.98,35,21,39,39,29
Mayo,156,73,83,349.95,16,41,46,30,23
Mayo,90,39,51,400.48,11,5,23,33,18
Mayo,86,44,42,120.64,25,7,33,12,9
Mayo,147,73,74,33.71,31,7,42,37,30
Mayo,165,77,88,49.01,48,13,35,51,18
Mayo,382,192,190,41.68,101,44,94,100,43
Mayo,309,156,153,24.65,74,43,73,82,37
Mayo,296,149,147,32.08,92,28,87,57,32
Mayo,203,104,99,15.32,47,20,53,45,38
Mayo,235,130,105,17.19,42,34,55,79,25
Mayo,185,106,79,26.22,31,28,40,62,24
Mayo,218,104,114,19.71,49,24,42,65,38
Mayo,188,88,100,28.86,41,22,51,45,29
Mayo,352,192,160,18.08,78,48,95,87,44
Mayo,140,63,77,73.27,31,13,29,42,25
Mayo,234,121,113,95.01,63,18,75,52,26
Mayo,196,95,101,29,39,28,50,57,22
Mayo,160,78,82,48.9,34,10,37,47,32
Mayo,215,109,106,52.79,58,26,65,38,28
Mayo,152,77,75,2.65,14,19,29,57,33
Mayo,130,64,66,21.94,23,11,33,37,26
Mayo,171,86,85,10.7,23,20,39,52,37
Mayo,225,125,100,28.92,59,23,49,60,34
Mayo,162,90,72,6.95,35,14,43,38,32
Mayo,233,115,118,27.47,49,26,68,56,34
Mayo,182,98,84,19.78,39,15,53,42,33
Mayo,196,111,85,23.59,47,20,43,52,34
Mayo,132,66,66,13.25,28,12,41,27,24
Mayo,210,106,104,12.83,40,32,51,52,35
Mayo,189,97,92,17.31,39,24,50,44,32
Mayo,178,90,88,56.7,33,16,58,46,25
Mayo,152,76,76,1128.28,25,12,44,43,28
Mayo,188,99,89,1187.78,23,36,61,48,20
Mayo,265,124,141,39.95,67,23,87,66,22
Mayo,136,66,70,168.47,16,11,20,24,65
Mayo,111,63,48,5.69,15,7,26,36,27
Mayo,130,71,59,3.19,18,13,23,39,37
Mayo,273,146,127,10.25,58,33,69,87,26
Mayo,200,98,102,8.71,42,21,55,66,16
Mayo,311,156,155,19.1,61,33,67,110,40
Mayo,251,115,136,8.48,50,23,74,71,33
Mayo,225,123,102,24.98,52,19,53,60,41
Mayo,121,62,59,15.67,9,12,30,35,35
Mayo,171,89,82,38,29,10,43,58,31
Mayo,108,57,51,11.06,23,7,25,23,30
Mayo,121,63,58,11.74,19,11,27,36,28
Mayo,239,117,122,13.54,49,27,58,61,44
Mayo,186,87,99,25.94,52,22,43,41,28
Mayo,227,123,104,24.27,48,22,64,67,26
Mayo,227,115,112,10.99,53,20,54,59,41
Mayo,247,121,126,28.38,49,29,52,84,33
Mayo,187,90,97,18.39,54,24,46,46,17
Mayo,200,105,95,19.85,49,15,54,53,29
Mayo,140,70,70,37.61,39,13,34,38,16
Mayo,252,127,125,40.4,58,32,69,68,25
Mayo,165,84,81,26.25,43,12,42,50,18
Mayo,187,99,88,35.87,51,15,59,38,24
Mayo,212,112,100,10.77,53,25,62,45,27
Mayo,244,123,121,6.25,60,28,70,61,25
Mayo,107,59,48,5.72,20,7,28,29,23
Mayo,190,94,96,17.02,38,21,47,56,28
Mayo,141,63,78,9.75,20,18,36,37,30
Mayo,122,64,58,156.92,23,8,23,36,32
Mayo,185,91,94,12.8,27,17,37,59,45
Mayo,216,94,122,22.67,36,21,35,51,73
Mayo,211,101,110,24.05,38,30,40,70,33
Mayo,154,76,78,15.85,32,22,31,50,19
Mayo,176,81,95,17.08,40,6,42,39,49
Mayo,168,83,85,194.92,40,19,43,45,21
Mayo,199,93,106,631.09,35,17,60,44,43
Mayo,202,102,100,13.26,56,7,53,55,31
Mayo,258,134,124,39.68,72,28,59,70,29
Mayo,198,99,99,173.99,41,22,48,56,31
Mayo,153,74,79,503.87,30,17,39,47,20
Mayo,140,69,71,1115.19,18,14,35,39,34
Mayo,238,117,121,89.41,58,15,56,60,49
Mayo,128,64,64,1.49,24,12,27,36,29
Mayo,162,88,74,12.32,36,20,37,50,19
Mayo,251,131,120,22.51,46,28,56,79,42
Mayo,177,80,97,15.76,32,17,40,58,30
Mayo,226,121,105,41.58,39,40,50,66,31
Mayo,221,112,109,24.19,33,26,56,81,25
Mayo,200,102,98,31.98,38,38,36,53,35
Mayo,227,111,116,37.6,44,26,53,73,31
Mayo,191,96,95,27.23,44,22,43,49,33
Mayo,231,114,117,228.75,65,22,79,44,21
Mayo,226,102,124,562.02,55,28,48,62,33
Mayo,330,184,146,287.61,24,26,55,125,100
Mayo,121,60,61,161.99,10,9,15,36,51
Mayo,98,46,52,332.39,22,8,32,24,12
Mayo,159,77,82,69,41,17,52,30,19
Mayo,150,82,68,848.45,10,8,28,41,63
Mayo,197,98,99,16.43,39,29,37,57,35
Mayo,162,82,80,7.21,18,21,29,68,26
Mayo,199,107,92,15.59,38,23,66,50,22
Mayo,232,119,113,20.88,68,21,55,56,32
Mayo,194,93,101,38.35,43,26,46,54,25
Mayo,152,81,71,18.58,22,18,35,56,21
Mayo,239,120,119,19.72,54,32,51,64,38
Mayo,234,110,124,100.02,67,20,69,63,15
Mayo,268,132,136,30.54,74,26,63,68,37
Mayo,184,82,102,193.28,21,10,34,40,79
Mayo,199,98,101,1570.43,33,26,55,61,24
Mayo,261,116,145,112.89,68,21,92,51,29
Mayo,84,44,40,113.86,6,9,26,23,20
Mayo,206,103,103,13.51,38,25,50,54,39
Mayo,154,80,74,11.33,37,9,30,50,28
Mayo,231,116,115,93.32,53,38,38,77,25
Mayo,280,131,149,33,56,34,61,54,75
Mayo,278,138,140,35.11,66,40,60,78,34
Mayo,159,79,80,22.33,44,12,40,47,16
Mayo,268,139,129,57.76,63,27,68,66,44
Mayo,249,125,124,464.86,72,15,131,22,9
Mayo,203,108,95,21.05,24,23,59,66,31
Mayo,159,79,80,11.43,23,29,18,58,31
Mayo,181,92,89,10.48,29,21,45,43,43
Mayo,234,114,120,106.28,52,29,59,63,31
Mayo,206,100,106,79.45,44,29,59,49,25
Mayo,180,100,80,184.55,47,19,33,60,21
Mayo,331,161,170,245.28,79,49,87,90,26
Mayo,160,78,82,48.59,33,16,34,57,20
Mayo,162,86,76,101.69,47,7,46,37,25
Mayo,152,75,77,283.8,35,13,28,57,19
Mayo,247,113,134,256.95,60,28,71,62,26
Mayo,420,206,214,343.69,82,44,110,99,85
Mayo,83,41,42,1132.1,14,4,63,2,0
Mayo,157,73,84,599.5,36,23,56,25,17
Mayo,166,78,88,2780.43,44,14,66,23,19
Mayo,319,152,167,2909.34,54,47,95,91,32
Mayo,170,88,82,3410.09,21,14,87,39,9
Mayo,175,89,86,1299.8,25,15,66,47,22
Mayo,184,84,100,161.08,33,18,72,46,15
Mayo,153,80,73,2567.63,26,8,47,35,37
Mayo,199,91,108,3853.98,40,23,75,41,20
Mayo,155,69,86,2345.04,19,25,58,31,22
Mayo,227,119,108,4922.69,10,41,73,76,27
Mayo,154,76,78,2374.16,20,13,72,28,21
Mayo,133,56,77,1298.93,25,14,73,13,8
Mayo,165,76,89,898.05,31,22,47,37,28
Mayo,112,57,55,3446.05,15,21,43,20,13
Mayo,189,96,93,555.99,33,13,82,42,19
Mayo,574,274,300,4077.75,47,47,145,181,154
Mayo,173,90,83,1012.16,16,20,40,50,47
Mayo,185,96,89,234.76,40,22,64,39,20
Mayo,304,148,156,3731.43,13,5,38,64,184
Mayo,157,74,83,1051.57,17,8,44,36,52
Mayo,341,136,205,339.17,75,16,129,49,72
Mayo,155,65,90,921.43,20,36,30,50,19
Mayo,114,44,70,4791.73,29,6,70,8,1
Mayo,132,62,70,212.3,28,13,65,19,7
Mayo,232,118,114,795.8,35,35,60,55,47
Mayo,263,125,138,5352.49,54,42,66,75,26
Mayo,142,68,74,536.2,8,13,32,39,50
Mayo,137,63,74,937.84,16,20,26,41,34
Mayo,136,71,65,3749.86,17,9,31,39,40
Mayo,327,148,179,2095.6,151,33,103,35,5
Mayo,202,94,108,2203.08,45,13,88,43,13
Mayo,150,76,74,3539.41,12,17,38,31,52
Mayo,222,94,128,1360.44,51,23,53,65,30
Mayo,153,75,78,550.29,23,13,24,42,51
Mayo,265,132,133,4655.82,68,61,56,64,16
Mayo,226,103,123,1888.64,77,38,60,40,11
Meath,242,132,110,30.96,45,40,60,62,35
Meath,221,121,100,42.15,48,28,59,59,27
Meath,217,116,101,22.04,39,28,65,53,32
Meath,299,159,140,43.79,63,38,79,79,40
Meath,273,137,136,95.14,74,32,75,64,28
Meath,319,164,155,77,92,31,91,78,27
Meath,270,147,123,30.04,51,30,74,74,41
Meath,279,141,138,54.36,63,32,80,78,26
Meath,229,110,119,38.69,37,27,51,72,42
Meath,308,163,145,64.56,73,32,82,69,52
Meath,247,134,113,84.18,59,33,67,61,27
Meath,355,183,172,30.4,75,55,104,88,33
Meath,227,116,111,40.25,44,36,52,67,28
Meath,232,130,102,7356.21,45,37,73,64,13
Meath,269,138,131,51.24,54,35,67,79,34
Meath,306,161,145,41.56,51,35,81,110,29
Meath,275,139,136,26.04,51,30,71,89,34
Meath,227,115,112,35.49,51,40,55,59,22
Meath,237,126,111,47.77,46,32,58,76,25
Meath,242,128,114,41.39,51,30,66,72,23
Meath,243,122,121,34.6,43,28,66,81,25
Meath,215,117,98,21.75,40,28,63,52,32
Meath,218,116,102,19.09,49,26,62,51,30
Meath,202,104,98,2435.99,58,29,69,40,6
Meath,207,103,104,77.28,44,31,50,66,16
Meath,265,139,126,26.93,55,49,57,66,38
Meath,268,135,133,1144.69,64,31,85,51,37
Meath,258,134,124,846.99,49,31,87,64,27
Meath,287,146,141,58.8,76,21,92,57,41
Meath,250,122,128,1403.41,77,37,86,37,13
Meath,220,104,116,970.61,60,32,78,36,14
Meath,208,96,112,693.49,71,23,78,30,6
Meath,231,113,118,105.32,41,29,64,67,30
Meath,312,135,177,890.1,55,33,83,66,75
Meath,232,113,119,156.97,52,43,57,56,24
Meath,223,119,104,20.93,70,21,61,37,34
Meath,536,271,265,19.02,135,60,135,124,82
Meath,306,149,157,28.36,65,48,80,79,34
Meath,408,201,207,28.07,86,52,96,134,40
Meath,207,109,98,22.36,40,26,50,56,35
Meath,293,145,148,46.49,76,23,108,64,22
Meath,365,200,165,228.49,136,18,147,47,17
Meath,414,204,210,41.46,91,58,86,126,53
Meath,353,181,172,40.48,84,46,94,85,44
Meath,297,151,146,27.17,58,31,82,92,34
Meath,266,139,127,17.83,78,22,67,71,28
Meath,225,125,100,28.91,35,39,41,69,41
Meath,248,134,114,24.1,51,28,73,68,28
Meath,244,123,121,30.19,60,40,62,54,28
Meath,227,116,111,30.38,51,41,50,62,23
Meath,264,126,138,44.53,81,25,71,58,29
Meath,202,94,108,19.79,48,26,56,49,23
Meath,242,111,131,337.73,77,21,88,43,13
Meath,277,129,148,4542.4,101,23,127,20,6
Meath,270,137,133,556.15,83,9,153,22,3
Meath,275,136,139,214.65,84,19,119,42,11
Meath,347,182,165,413.04,98,26,154,47,22
Meath,241,118,123,34.57,61,17,75,64,24
Meath,200,100,100,20.67,39,24,64,45,28
Meath,280,139,141,22.97,82,28,78,66,26
Meath,266,140,126,25.06,65,28,70,71,32
Meath,250,110,140,58.95,57,41,62,65,25
Meath,221,111,110,29.23,46,21,69,62,23
Meath,216,113,103,23.32,43,23,59,55,36
Meath,287,154,133,18.65,80,21,88,75,23
Meath,468,238,230,34.01,115,53,124,124,52
Meath,204,97,107,12.41,55,20,62,44,23
Meath,261,130,131,70.23,65,12,101,62,21
Meath,323,166,157,19.97,71,31,90,100,31
Meath,366,186,180,17.65,87,51,94,100,34
Meath,322,161,161,20.88,76,46,72,90,38
Meath,331,161,170,59.49,51,54,76,109,41
Meath,401,203,198,25.57,83,52,91,113,62
Meath,315,155,160,3589.42,50,53,82,108,22
Meath,384,188,196,7243.1,71,62,104,119,28
Meath,296,153,143,361.15,45,52,82,105,12
Meath,290,141,149,624.23,71,17,182,14,6
Meath,323,166,157,4041.54,66,72,93,82,10
Meath,214,97,117,16284.91,38,41,118,17,0
Meath,219,116,103,1454.01,44,42,55,63,15
Meath,211,100,111,7301.04,43,14,122,23,9
Meath,208,96,112,9275.78,49,21,109,28,1
Meath,340,169,171,2465.05,65,65,89,100,21
Meath,200,101,99,4305.71,23,11,143,13,10
Meath,229,116,113,7145.53,46,12,124,35,12
Meath,158,79,79,3146.09,37,24,55,33,9
Meath,206,103,103,5443.11,58,15,95,29,9
Meath,329,164,165,5616.54,75,74,56,108,16
Meath,450,215,235,2592.84,160,44,198,41,7
Meath,315,156,159,1088.66,85,24,166,27,13
Meath,300,137,163,6387.19,53,38,107,73,29
Meath,454,226,228,5366.37,86,87,110,147,24
Meath,231,124,107,2017.15,29,38,61,75,28
Meath,469,241,228,3960.81,168,51,147,84,19
Meath,390,181,209,2943.91,122,27,197,39,5
Meath,323,159,164,2822.59,115,40,74,80,14
Meath,260,125,135,5984.72,45,32,87,67,29
Meath,276,136,140,6258.93,42,46,68,88,32
Meath,243,117,126,4854.17,51,37,69,69,17
Meath,267,127,140,3996.41,57,18,164,22,6
Meath,289,141,148,458.8,83,22,161,22,1
Meath,342,171,171,1279.21,84,63,84,100,11
Meath,308,157,151,811.97,41,38,143,69,17
Meath,397,196,201,407.23,126,41,177,44,9
Meath,213,107,106,38281.81,50,15,132,15,1
Meath,311,165,146,4096.85,48,37,171,50,5
Meath,322,172,150,33.97,84,38,93,81,26
Meath,256,131,125,19.65,65,30,64,65,32
Meath,303,153,150,56.27,89,34,100,55,25
Meath,263,145,118,66.08,61,30,79,62,31
Meath,272,142,130,42.07,62,28,85,70,27
Meath,325,163,162,77.46,93,41,76,85,30
Meath,205,100,105,19.33,58,14,52,51,30
Meath,225,121,104,20.27,46,25,64,58,32
Meath,163,86,77,22.65,26,20,35,51,31
Meath,203,102,101,266.18,34,23,59,58,29
Meath,241,121,120,26.73,52,33,63,74,19
Meath,253,121,132,32.54,51,34,54,82,32
Meath,233,125,108,20.81,55,23,70,55,30
Meath,323,157,166,30.44,87,27,87,89,33
Meath,243,114,129,6380.3,41,43,71,72,16
Meath,213,106,107,800.32,62,23,72,37,19
Meath,294,153,141,294.26,81,29,111,52,21
Meath,233,125,108,463.03,65,28,77,47,16
Meath,262,127,135,520.2,74,29,83,44,32
Meath,245,115,130,1231.61,57,15,119,49,5
Meath,251,123,128,2500.8,56,33,92,42,28
Meath,203,102,101,68.85,36,22,56,51,38
Meath,374,194,180,579.9,131,29,173,36,5
Meath,343,175,168,202.52,108,22,149,54,10
Meath,199,102,97,63.85,53,14,67,38,27
Meath,393,194,199,496.22,148,38,163,32,12
Meath,193,96,97,32.12,32,20,65,45,31
Meath,319,160,159,1477.08,105,29,134,41,10
Meath,275,143,132,5669.28,92,9,139,26,9
Meath,344,168,176,824.41,115,29,129,45,26
Meath,237,112,125,3030.34,65,28,69,53,22
Meath,262,138,124,36.43,42,30,70,63,57
Meath,200,104,96,113.78,38,32,33,71,26
Meath,298,149,149,356.92,97,36,73,59,33
Meath,237,106,131,35.52,34,50,53,66,34
Meath,253,130,123,20.55,40,29,68,79,37
Meath,229,120,109,6740.65,70,11,136,10,2
Meath,394,197,197,824.21,86,67,93,121,27
Meath,357,175,182,5389.74,65,79,76,125,12
Meath,267,142,125,4060.71,46,41,67,90,23
Meath,329,173,156,7595.52,96,21,186,18,8
Meath,305,164,141,5101.7,63,23,77,76,66
Meath,365,188,177,1453.23,128,59,67,91,20
Meath,487,238,249,33.36,75,68,108,152,84
Meath,497,252,245,2330.55,87,120,82,192,16
Meath,306,139,167,1202.47,71,57,74,93,11
Meath,329,162,167,2053.34,146,33,96,50,4
Meath,335,172,163,6776.85,130,24,130,44,7
Meath,369,164,205,6078.28,134,65,118,41,11
Meath,390,185,205,2154.82,133,48,85,102,22
Meath,407,205,202,245.15,99,66,84,123,35
Meath,429,215,214,6230.48,151,57,129,81,11
Meath,296,154,142,1478.32,55,46,72,71,52
Meath,344,164,180,2801.1,101,63,81,89,10
Meath,213,105,108,1340.23,68,22,100,19,4
Meath,479,260,219,9248.18,113,62,262,36,6
Meath,382,199,183,7295.65,126,49,123,73,11
Meath,221,110,111,5903.57,63,32,68,41,17
Meath,254,119,135,358.58,100,22,83,38,11
Meath,374,196,178,1808.34,73,73,67,138,23
Meath,301,151,150,1557.24,77,25,113,58,28
Meath,236,113,123,1616.18,36,42,51,73,34
Meath,194,106,88,51.72,32,39,44,65,14
Meath,454,218,236,3738.9,104,97,69,168,16
Meath,203,97,106,6477.14,36,16,82,47,22
Meath,254,121,133,335.53,72,17,139,23,3
Meath,233,116,117,291.73,59,27,108,28,11
Meath,238,115,123,454.52,73,16,81,41,27
Meath,316,160,156,1174.11,84,54,91,76,11
Meath,239,120,119,6272.31,82,19,74,51,13
Meath,151,76,75,1441.27,35,15,70,18,13
Meath,215,107,108,31.46,42,22,52,69,30
Meath,443,216,227,60.92,79,54,82,147,81
Meath,262,143,119,64.4,58,38,52,75,39
Meath,225,117,108,35.53,35,42,46,70,32
Meath,255,137,118,56.72,30,29,57,78,61
Meath,226,118,108,35.18,30,22,57,75,42
Meath,367,189,178,31.4,79,60,86,105,37
Meath,251,131,120,49.27,49,25,74,81,22
Meath,291,144,147,36.38,64,39,84,72,32
Meath,203,102,101,25.64,50,22,47,63,21
Meath,242,129,113,31.12,55,29,71,65,22
Meath,386,206,180,18.84,80,49,109,105,43
Meath,244,117,127,18.75,43,27,77,65,32
Meath,350,178,172,26.29,99,32,100,85,34
Meath,370,181,189,33.72,83,56,103,97,31
Meath,310,157,153,26.29,71,27,91,89,32
Meath,257,116,141,386.72,92,18,99,40,8
Meath,241,120,121,21.49,49,31,67,66,28
Meath,266,138,128,28.02,55,34,77,59,41
Meath,400,196,204,6329.92,130,34,196,30,10
Meath,207,103,104,5496.69,83,7,108,7,2
Meath,264,145,119,2310.66,90,22,125,24,3
Meath,329,154,175,2466.27,73,27,154,53,22
Meath,197,96,101,2859.88,38,28,85,39,7
Meath,379,194,185,5443.76,118,38,190,28,5
Meath,221,107,114,703.49,85,17,105,12,2
Meath,284,141,143,56.9,66,34,68,91,25
Meath,323,145,178,4110.83,114,41,125,40,3
Meath,420,209,211,50.28,102,55,113,103,47
Meath,199,103,96,868.21,50,24,78,34,13
Meath,320,167,153,20.74,63,42,78,95,42
Meath,463,233,230,106.09,109,70,117,122,45
Meath,337,171,166,37.35,67,44,76,108,42
Meath,296,160,136,22.46,62,37,67,93,37
Meath,311,124,187,518.82,151,31,103,20,6
Meath,278,123,155,817.84,165,16,90,7,0
Meath,219,117,102,4391.24,27,33,58,79,22
Meath,114,58,56,2461.41,21,9,45,26,13
Meath,186,97,89,2118.48,39,11,74,40,22
Meath,344,171,173,101.67,120,29,109,64,22
Meath,268,134,134,72.75,60,32,72,74,30
Meath,258,134,124,43.39,30,33,46,90,59
Meath,227,123,104,54.86,52,25,52,70,28
Meath,333,193,140,50.04,46,80,77,85,45
Meath,295,145,150,5577.82,108,15,137,30,5
Meath,306,157,149,2780.43,105,15,122,43,21
Meath,273,139,134,3325.42,72,17,142,34,8
Meath,442,211,231,3950.41,120,33,158,81,50
Meath,365,187,178,4243.74,119,54,82,98,12
Meath,106,59,47,3300.64,24,22,32,23,5
Meath,367,180,187,2561.47,111,60,82,91,23
Meath,254,120,134,4327.53,70,16,123,31,14
Meath,318,159,159,3732.88,93,24,135,56,10
Meath,190,90,100,3280.44,22,15,38,50,65
Meath,400,203,197,7527.29,128,39,175,46,12
Meath,426,205,221,6494.2,156,30,184,47,9
Meath,406,186,220,7649.26,129,72,102,81,22
Meath,320,147,173,1645.17,105,14,171,24,6
Meath,290,147,143,871.81,50,24,61,93,62
Meath,265,126,139,1154.26,35,33,69,84,44
Meath,227,118,109,2074.61,36,28,137,25,1
Meath,329,174,155,1808.54,80,44,76,102,27
Meath,509,243,266,2569.29,156,39,217,76,21
Meath,347,165,182,910.3,130,28,116,57,16
Meath,286,141,145,43.72,51,45,59,85,46
Meath,345,155,190,2531.57,76,32,136,71,30
Meath,320,150,170,2978.55,52,28,65,104,71
Meath,297,147,150,4006.15,74,27,102,70,24
Meath,244,118,126,738.6,34,50,42,96,22
Meath,230,111,119,1844.93,32,33,47,74,44
Meath,393,193,200,4822.62,129,52,122,74,16
Meath,404,204,200,525.63,133,40,169,51,11
Meath,183,102,81,744.09,45,12,84,28,14
Meath,245,108,137,862.07,72,22,86,25,40
Meath,282,125,157,313.9,59,29,94,65,35
Meath,392,200,192,3833.97,130,28,206,24,4
Meath,313,147,166,560.18,95,26,157,33,2
Meath,254,127,127,33.93,42,29,64,74,45
Meath,280,135,145,112.84,83,22,110,32,33
Meath,123,63,60,3143.37,14,21,45,35,8
Meath,342,171,171,2659.86,67,47,97,84,47
Meath,162,75,87,523.18,4,20,29,47,62
Meath,156,86,70,663.47,14,20,60,33,29
Meath,150,82,68,2040.73,11,22,37,56,24
Meath,165,86,79,3050.08,20,18,47,39,41
Meath,233,117,116,3484.48,64,30,81,40,18
Meath,359,177,182,4198.39,98,51,110,77,23
Meath,313,150,163,3858.91,109,36,89,56,23
Meath,253,123,130,39.2,83,13,92,49,16
Meath,245,119,126,30.07,54,35,75,59,22
Meath,326,176,150,204.58,89,30,118,61,28
Meath,422,196,226,467.15,129,41,172,67,13
Meath,225,124,101,36.48,51,34,54,65,21
Meath,278,139,139,670.83,95,25,112,32,14
Meath,209,101,108,29.81,44,25,40,74,26
Meath,254,126,128,39.98,47,47,57,77,26
Meath,255,145,110,42.94,53,33,71,72,26
Meath,223,103,120,11501.37,60,18,132,12,1
Meath,383,184,199,6828.56,122,19,204,31,7
Meath,233,112,121,3781.3,36,24,150,19,4
Meath,310,158,152,8200.19,116,14,164,14,2
Meath,245,133,112,5893.53,55,27,138,24,1
Meath,214,97,117,155.43,52,25,110,20,7
Meath,395,208,187,49.91,58,57,111,122,47
Meath,208,106,102,36.83,37,25,61,45,40
Meath,305,156,149,51.72,61,39,47,82,76
Meath,450,212,238,28.02,116,49,112,123,50
Meath,323,152,171,19.53,82,29,89,88,35
Meath,404,205,199,26.5,114,34,128,74,54
Meath,215,105,110,30.96,49,20,70,47,29
Meath,212,108,104,55.73,60,19,70,42,21
Meath,151,66,85,2269.38,45,8,67,17,14
Meath,250,118,132,2595.76,105,13,97,31,4
Meath,249,109,140,3614.88,86,22,88,43,10
Meath,291,150,141,1376.62,70,30,84,69,38
Meath,324,151,173,622.64,132,35,124,29,4
Meath,185,88,97,2808.56,71,11,77,21,5
Meath,261,127,134,1447.88,93,26,117,22,3
Meath,213,108,105,17.75,50,21,69,48,25
Meath,265,141,124,26.18,59,56,67,60,23
Meath,306,145,161,98.05,91,29,104,58,24
Meath,270,137,133,10.64,51,30,79,72,38
Meath,216,110,106,21.24,33,23,58,75,27
Meath,206,104,102,25.84,40,22,52,60,32
Meath,280,136,144,30.95,67,46,71,63,33
Meath,233,123,110,19.58,40,30,75,64,24
Meath,286,146,140,26.27,67,23,79,74,43
Meath,213,106,107,14.2,43,20,62,52,36
Meath,312,164,148,35.68,66,37,68,92,49
Meath,263,139,124,48.82,69,27,76,72,19
Meath,224,113,111,20.45,49,30,52,64,29
Meath,292,144,148,71.1,38,60,53,106,35
Meath,245,122,123,19.24,53,26,57,65,44
Meath,273,134,139,15.88,75,25,77,56,40
Meath,190,80,110,105.11,31,18,36,32,73
Meath,203,100,103,16.65,42,25,61,48,27
Meath,368,188,180,33.24,92,39,99,97,41
Meath,376,192,184,32.33,71,46,102,117,40
Meath,317,154,163,65.39,74,43,77,98,25
Meath,255,127,128,1978.85,66,20,110,44,15
Meath,184,89,95,31.57,32,22,48,50,32
Meath,256,119,137,82.1,64,23,116,40,13
Meath,422,220,202,46.24,73,64,104,140,41
Meath,284,149,135,35.81,58,23,91,72,40
Meath,238,111,127,38.99,53,26,72,68,19
Meath,274,146,128,30.2,69,42,80,59,24
Meath,289,133,156,53.15,69,38,80,72,30
Meath,387,197,190,24.7,109,26,98,100,54
Meath,216,108,108,12.93,44,32,62,53,25
Meath,272,136,136,23.88,57,36,83,69,27
Meath,298,152,146,29.36,81,32,93,70,22
Meath,194,94,100,26.82,39,29,49,44,33
Meath,211,117,94,23.63,54,14,62,47,34
Meath,241,128,113,24.28,48,34,57,65,37
Meath,238,132,106,62.66,46,19,54,63,56
Meath,314,152,162,39.84,71,42,92,78,31
Meath,349,181,168,39.34,72,47,104,93,33
Meath,280,140,140,24.45,69,26,86,61,38
Meath,281,145,136,21.34,47,28,66,80,60
Meath,241,119,122,21.52,59,21,72,62,27
Meath,188,96,92,18.04,34,22,55,57,20
Meath,228,116,112,17.18,41,35,48,66,38
Meath,289,156,133,29.89,46,41,62,88,52
Meath,246,121,125,59.07,46,43,59,70,28
Meath,132,61,71,4087.19,20,19,78,15,0
Meath,198,87,111,5526.25,75,13,88,17,5
Meath,170,81,89,3037.88,26,14,37,44,49
Meath,253,135,118,2894.14,83,23,122,23,2
Meath,375,176,199,4923.78,124,34,176,33,8
Meath,447,223,224,569.06,154,46,191,45,11
Meath,445,207,238,7213.95,201,55,150,33,6
Meath,242,107,135,6676.41,51,36,70,73,12
Meath,192,89,103,2345.87,44,8,111,23,6
Meath,187,80,107,2735.96,43,17,98,26,3
Meath,446,200,246,4740.19,153,61,164,62,6
Meath,279,123,156,5799.69,76,51,77,69,6
Meath,235,112,123,3772.86,76,23,109,21,6
Meath,389,186,203,2076.8,123,45,184,35,2
Meath,240,119,121,850.29,64,24,79,46,27
Meath,301,151,150,4433.97,60,42,106,74,19
Meath,231,108,123,4322.6,66,25,91,39,10
Meath,353,167,186,2191.54,79,69,100,87,18
Meath,511,249,262,3541.85,195,38,214,53,11
Meath,330,170,160,2236.88,100,29,131,56,14
Meath,484,238,246,6179.93,171,50,177,81,5
Meath,396,188,208,906.23,153,37,131,54,21
Meath,340,168,172,34.76,52,52,68,104,64
Meath,360,179,181,41.71,77,39,90,103,51
Meath,403,204,199,1657.86,75,64,170,77,17
Meath,248,118,130,2198.76,58,31,95,50,14
Meath,242,124,118,852.95,43,39,82,58,20
Meath,224,113,111,8072.65,40,28,64,75,17
Meath,384,172,212,2551.95,166,43,122,45,8
Meath,297,159,138,6587.12,70,46,79,81,21
Meath,313,158,155,6161.9,111,17,166,17,2
Meath,446,228,218,6415.33,130,47,186,73,10
Meath,192,84,108,2045.9,22,18,45,65,42
Meath,293,142,151,966.87,46,32,77,82,56
Meath,256,126,130,7537.39,41,33,67,81,34
Meath,227,108,119,3007.62,32,27,56,52,60
Meath,369,194,175,5230.48,127,39,148,46,9
Meath,202,102,100,1254.84,59,11,120,11,1
Meath,279,143,136,6805.87,89,11,143,34,2
Meath,314,147,167,297.26,95,36,118,55,10
Meath,312,148,164,1621.14,65,47,101,77,22
Meath,227,113,114,4235.15,39,38,47,79,24
Meath,310,154,156,3422.28,67,43,121,69,10
Meath,306,163,143,4906.91,57,46,100,72,31
Meath,293,146,147,563.08,45,44,82,88,34
Meath,203,106,97,618.64,22,18,44,58,61
Meath,401,208,193,3426,96,72,92,80,61
Meath,428,211,217,2309.36,52,33,138,90,115
Meath,320,143,177,744.55,106,54,87,48,25
Meath,254,131,123,6026.24,51,29,90,70,14
Meath,366,187,179,4687.86,141,20,184,19,2
Meath,228,118,110,4998.57,75,17,106,26,4
Meath,308,150,158,7561.07,103,28,142,33,2
Meath,266,115,151,3682.12,86,26,124,22,8
Meath,385,190,195,8733.53,147,26,159,43,10
Meath,302,155,147,880.64,78,26,100,67,31
Meath,430,232,198,3572.35,123,67,158,59,23
Meath,200,99,101,73.98,26,21,55,60,38
Meath,283,140,143,4703.18,94,27,127,30,5
Meath,316,143,173,2556.59,94,51,70,91,10
Meath,290,141,149,2126.27,66,31,73,81,39
Meath,270,136,134,838.96,60,30,99,51,30
Meath,267,121,146,5665.18,62,16,153,32,4
Meath,443,218,225,7852.52,161,18,227,30,7
Meath,381,183,198,6110.37,131,20,205,22,3
Meath,322,163,159,2626.71,111,26,150,31,4
Meath,356,164,192,1109.63,103,23,166,50,14
Meath,286,128,158,1642.3,92,28,125,32,9
Meath,204,94,110,3364.12,61,28,34,67,14
Meath,333,152,181,2309.95,78,40,158,40,17
Meath,403,196,207,4445.38,145,31,171,42,14
Meath,367,180,187,522.17,134,41,159,29,4
Meath,450,212,238,233.78,85,60,128,90,87
Meath,436,234,202,230.77,128,39,134,102,33
Meath,320,162,158,74.31,44,47,58,118,53
Meath,308,140,168,89.36,87,34,106,57,24
Meath,371,186,185,63.15,123,37,110,70,31
Meath,167,77,90,4370.47,37,17,53,41,19
Meath,419,217,202,5984.43,173,25,194,25,2
Meath,202,96,106,2599.54,52,18,63,36,33
Meath,355,178,177,4189.83,102,46,123,71,13
Meath,349,180,169,5020.28,53,44,104,105,43
Meath,368,187,181,76.74,94,41,123,79,31
Meath,381,187,194,2880.04,138,34,161,37,11
Meath,101,52,49,5542.75,22,15,38,25,1
Meath,136,74,62,11461.32,19,27,72,13,5
Meath,359,180,179,2677.11,86,32,194,42,5
Meath,256,121,135,3228.7,39,43,71,77,26
Meath,135,76,59,2973.9,20,25,73,15,2
Meath,223,132,91,2456.7,24,40,89,50,20
Meath,107,61,46,1727,8,14,34,20,31
Meath,201,104,97,4980.92,36,27,67,62,9
Meath,277,127,150,4990.72,35,30,92,75,45
Meath,237,108,129,1483.66,20,22,67,59,69
Meath,215,107,108,2138.39,37,33,60,54,31
Meath,144,78,66,1704.42,16,26,45,50,7
Meath,233,129,104,660.18,24,34,76,61,38
Meath,212,114,98,3418.2,22,20,59,68,43
Meath,142,60,82,755.33,11,11,37,35,48
Meath,190,88,102,657.88,39,21,63,42,25
Meath,216,118,98,20.19,42,28,58,58,30
Meath,193,94,99,27.36,39,16,64,50,24
Meath,252,123,129,577.32,80,28,106,22,16
Meath,238,133,105,19.37,49,35,63,60,31
Meath,396,199,197,410.78,126,43,148,67,12
Meath,192,96,96,18.12,36,32,51,52,21
Meath,222,115,107,23.09,43,19,62,64,34
Meath,334,155,179,165.32,81,42,110,71,30
Meath,245,128,117,32.07,57,28,58,69,33
Meath,349,158,191,787.33,120,36,106,62,25
Meath,302,150,152,452.49,97,24,112,47,22
Meath,360,183,177,29.52,84,29,101,99,47
Meath,293,157,136,111.14,59,46,121,45,22
Meath,183,99,84,375.91,20,17,54,57,35
Meath,200,94,106,25.65,40,27,45,55,33
Meath,221,117,104,343.74,46,36,58,62,19
Meath,171,78,93,947.37,27,16,55,40,33
Meath,233,124,109,32.09,57,23,77,59,17
Meath,215,99,116,35.51,46,29,48,54,38
Meath,221,113,108,24.6,52,25,55,56,33
Meath,247,125,122,38.09,40,27,75,75,30
Meath,259,137,122,62.5,58,32,71,79,19
Meath,198,93,105,14.63,45,29,46,46,32
Meath,263,135,128,26.76,72,33,70,72,16
Meath,225,118,107,28.3,38,31,63,79,14
Meath,264,130,134,33.2,60,41,76,63,24
Meath,262,128,134,36.43,55,29,63,70,45
Meath,464,235,229,35,110,70,114,119,51
Meath,273,152,121,28.54,58,23,91,72,29
Meath,345,188,157,27.14,73,41,97,90,44
Meath,285,138,147,24.6,72,32,73,77,31
Meath,256,124,132,81.42,74,30,73,58,21
Meath,429,219,210,32.41,120,24,136,93,56
Meath,333,175,158,29.4,84,29,105,82,33
Meath,324,165,159,79.87,103,21,129,48,23
Meath,292,141,151,18.67,62,36,76,78,40
Meath,381,186,195,45.3,84,44,101,100,52
Meath,276,137,139,44.86,47,45,76,82,26
Meath,393,192,201,87.22,75,46,88,130,54
Meath,370,181,189,7392.02,168,33,141,27,1
Meath,366,189,177,10146.37,118,14,216,10,8
Meath,372,190,182,5443.29,129,27,176,38,2
Meath,235,117,118,3002.5,48,23,78,64,22
Meath,369,192,177,3065.55,135,58,98,75,3
Meath,496,243,253,4069.54,168,63,132,119,14
Meath,554,275,279,5805.12,214,56,166,110,8
Meath,210,100,110,6045.95,73,8,119,9,1
Meath,337,155,182,2051.43,70,15,131,44,77
Meath,384,201,183,5920.81,156,15,197,10,6
Meath,453,214,239,2951.99,159,29,211,44,10
Meath,408,217,191,4746.06,163,39,151,53,2
Meath,184,89,95,2214.09,38,19,101,19,7
Meath,264,132,132,1607.78,65,33,72,68,26
Meath,263,129,134,314.35,92,13,145,12,1
Meath,415,218,197,2049.48,111,87,75,134,8
Meath,339,173,166,881.42,107,39,113,59,21
Meath,410,209,201,4002.15,130,68,90,117,5
Meath,257,126,131,5709.46,85,12,131,20,9
Meath,388,191,197,4286.72,138,50,121,74,5
Meath,357,171,186,1293.1,129,30,155,34,9
Meath,354,164,190,103.84,57,47,67,121,62
Meath,451,220,231,27.62,76,54,92,154,75
Meath,320,158,162,405.5,125,41,85,61,8
Meath,379,195,184,757.73,143,33,149,43,11
Meath,360,176,184,6033.99,130,20,182,25,3
Meath,225,103,122,816.07,40,19,132,24,10
Meath,372,191,181,142.66,100,53,85,93,41
Meath,218,107,111,38.86,32,30,48,65,43
Meath,220,103,117,25.14,63,16,56,53,32
Meath,272,140,132,47.13,38,28,76,99,31
Meath,329,160,169,34.58,72,41,82,90,44
Meath,262,129,133,22.14,40,24,66,89,43
Meath,259,134,125,53.05,59,27,76,72,25
Meath,335,167,168,41.44,70,58,73,93,41
Meath,295,153,142,57.66,70,37,73,71,44
Meath,297,146,151,35.45,70,40,58,102,27
Meath,216,103,113,1701.5,70,17,86,27,16
Meath,309,170,139,1546.22,83,27,110,65,24
Meath,405,200,205,289.33,102,47,111,103,42
Meath,200,108,92,21.15,45,16,67,54,18
Meath,334,165,169,112.72,79,24,148,54,29
Meath,164,82,82,144.6,39,12,71,26,16
Meath,206,102,104,24.22,35,28,46,65,32
Meath,236,117,119,63.33,36,29,53,75,43
Meath,383,203,180,32.87,66,45,111,101,60
Meath,235,116,119,3293.62,36,37,66,61,35
Meath,375,195,180,6332.75,122,53,149,41,10
Meath,375,185,190,216.08,66,57,98,105,49
Meath,236,112,124,331.47,53,20,135,19,9
Meath,447,213,234,635.34,148,47,202,47,3
Meath,497,231,266,633.86,194,43,210,48,2
Meath,386,191,195,6535.06,142,12,178,37,17
Meath,329,170,159,5506.09,126,13,145,35,10
Meath,242,118,124,188.6,67,20,74,47,34
Meath,178,84,94,696.01,37,14,45,54,28
Meath,237,115,122,4189.8,67,25,87,46,12
Meath,237,108,129,4576.17,84,17,115,18,3
Meath,218,117,101,584.07,52,28,46,62,30
Meath,164,74,90,635.82,21,17,37,52,37
Meath,250,123,127,660.81,60,37,61,66,26
Meath,201,109,92,6117.98,62,26,96,17,0
Meath,343,174,169,4998.18,134,23,146,36,4
Meath,254,127,127,315.8,71,18,84,55,26
Meath,204,101,103,48.97,33,29,44,62,36
Meath,363,170,193,5850.59,128,20,154,43,18
Meath,179,95,84,6410.95,55,10,98,13,3
Meath,265,125,140,505.79,81,10,143,24,7
Meath,228,113,115,3346.64,63,22,116,26,1
Meath,151,70,81,3064.75,22,15,101,11,2
Meath,204,103,101,5621.38,63,15,103,20,3
Meath,454,208,246,4552.29,177,33,161,71,12
Meath,247,119,128,4195.54,87,23,86,45,6
Meath,376,181,195,2544.65,141,27,147,49,12
Meath,201,100,101,4592.4,48,9,131,11,2
Meath,193,81,112,1404.59,46,13,90,31,13
Meath,200,98,102,1086.2,52,15,52,46,35
Meath,232,109,123,3671.82,47,21,109,43,12
Meath,190,90,100,307.31,25,20,30,60,55
Meath,181,94,87,136.88,35,21,73,40,12
Meath,310,150,160,4353.99,95,29,99,62,25
Meath,475,239,236,4808.23,152,57,154,93,19
Meath,293,140,153,65.69,60,25,64,87,57
Meath,276,144,132,31.45,60,27,64,88,37
Meath,344,170,174,27.57,88,34,99,82,41
Meath,405,204,201,23.83,90,47,115,97,56
Meath,284,140,144,25.16,55,40,69,92,28
Meath,289,153,136,45.79,60,39,81,85,24
Meath,318,162,156,28.78,67,50,94,76,31
Meath,289,146,143,4879.61,128,18,104,34,5
Meath,290,145,145,783.53,71,33,92,70,24
Meath,427,207,220,8089.42,156,24,212,33,2
Meath,394,199,195,6893.78,137,16,210,27,4
Meath,456,230,226,7099.82,178,25,203,41,9
Meath,280,133,147,6156.01,103,22,127,25,3
Meath,261,129,132,5739.42,101,18,116,24,2
Meath,391,199,192,279.41,75,48,122,117,29
Meath,292,142,150,968.44,69,22,143,42,16
Meath,505,324,181,149.68,77,135,50,104,139
Meath,220,115,105,67.43,56,26,82,29,27
Meath,237,122,115,14.42,50,26,59,70,32
Meath,324,161,163,733.86,88,39,111,58,28
Meath,292,143,149,1137.44,104,26,123,29,10
Meath,325,155,170,34.43,72,56,74,104,19
Meath,358,179,179,47.5,61,55,93,113,36
Meath,441,266,175,57.06,70,36,89,121,125
Meath,214,107,107,21.37,44,21,46,61,42
Meath,240,124,116,34.35,48,28,65,73,26
Meath,298,144,154,52.15,56,40,72,93,37
Meath,226,115,111,27.82,47,26,47,75,31
Meath,377,187,190,37.72,84,50,93,112,38
Meath,283,143,140,40.04,46,51,55,83,48
Meath,333,152,181,55.83,47,18,72,65,131
Meath,337,167,170,23.12,68,43,86,95,45
Meath,227,118,109,4941.66,66,20,95,32,14
Meath,294,149,145,5950.69,121,34,102,36,1
Meath,305,150,155,5409.24,47,49,70,84,55
Meath,253,117,136,3693.81,57,53,88,53,2
Meath,218,114,104,2446.36,46,40,66,53,13
Meath,214,113,101,1135.9,16,26,49,70,53
Meath,400,209,191,1247.32,140,31,163,40,26
Meath,269,127,142,671.73,74,24,115,37,19
Meath,279,145,134,1789.88,75,38,83,70,13
Meath,198,91,107,4013.38,52,16,86,27,17
Meath,294,136,158,319.3,55,43,82,88,26
Meath,284,149,135,49.41,51,31,67,100,35
Meath,310,157,153,401.5,81,26,149,38,16
Meath,361,181,180,671.5,111,34,119,74,23
Meath,259,122,137,281.43,87,30,87,38,17
Meath,349,174,175,2608.06,57,60,78,124,30
Meath,446,198,248,2191.46,85,69,105,69,118
Meath,374,183,191,5529.93,91,32,211,36,4
Meath,259,124,135,2269.88,65,41,67,66,20
Meath,396,178,218,1868.59,115,26,208,44,3
Meath,219,106,113,1919.81,62,29,50,59,19
Meath,299,151,148,703.77,89,46,56,99,9
Meath,230,115,115,2128.43,46,36,47,77,24
Meath,317,165,152,3801.14,108,35,89,80,5
Meath,281,148,133,91.84,41,25,146,48,21
Meath,193,97,96,2403.43,31,24,37,55,46
Meath,296,145,151,4114.65,49,33,88,76,50
Meath,191,96,95,1957.07,21,22,61,44,43
Meath,178,101,77,1949.87,25,19,73,29,32
Meath,244,119,125,4190.78,39,29,78,59,39
Meath,167,91,76,694.14,15,24,62,37,29
Meath,328,184,144,19.45,74,33,79,98,44
Monaghan,339,181,158,15.58,76,44,90,80,49
Monaghan,295,151,144,45.2,65,44,80,78,28
Monaghan,290,137,153,42.16,78,31,80,71,30
Monaghan,295,157,138,43.03,66,46,96,56,31
Monaghan,249,133,116,50.93,58,27,85,52,27
Monaghan,332,175,157,42.49,73,51,79,92,37
Monaghan,249,127,122,22.11,58,25,62,63,41
Monaghan,153,78,75,16.86,40,12,44,38,19
Monaghan,223,123,100,17.43,44,44,61,52,22
Monaghan,282,129,153,578.28,85,40,93,57,7
Monaghan,221,114,107,554.35,37,20,57,64,43
Monaghan,381,170,211,47.04,67,55,107,82,70
Monaghan,310,164,146,32.54,59,34,84,98,35
Monaghan,334,165,169,662.71,86,37,145,47,19
Monaghan,107,60,47,1324.14,13,15,31,24,24
Monaghan,82,39,43,1035.05,11,7,31,18,15
Monaghan,109,62,47,1302.55,14,11,38,28,18
Monaghan,336,180,156,49.43,87,47,86,80,36
Monaghan,310,157,153,81.6,72,41,60,103,34
Monaghan,305,153,152,63.4,81,37,70,83,34
Monaghan,325,164,161,35.84,64,33,56,96,76
Monaghan,206,98,108,257.48,41,22,63,54,26
Monaghan,238,125,113,188.72,54,29,69,53,33
Monaghan,364,190,174,35.65,92,37,93,85,57
Monaghan,473,230,243,204.65,130,47,156,93,47
Monaghan,291,146,145,27.06,83,44,78,60,26
Monaghan,323,174,149,34.74,78,47,94,79,25
Monaghan,340,183,157,46.28,79,42,108,76,35
Monaghan,298,154,144,13.65,61,49,77,80,31
Monaghan,217,112,105,36.64,65,24,56,52,20
Monaghan,278,142,136,36.2,70,49,68,71,20
Monaghan,282,148,134,43.97,75,44,66,67,30
Monaghan,256,125,131,28.63,60,32,75,62,27
Monaghan,239,126,113,17.85,54,35,63,51,36
Monaghan,135,65,70,209.98,40,15,62,13,5
Monaghan,252,132,120,33.57,58,28,64,64,38
Monaghan,220,119,101,18,49,30,61,64,16
Monaghan,333,189,144,22.44,88,42,88,69,46
Monaghan,402,216,186,51.03,125,44,118,78,37
Monaghan,171,74,97,167.22,44,21,47,35,24
Monaghan,295,136,159,1148.87,53,31,88,81,42
Monaghan,289,153,136,61.05,86,27,71,70,35
Monaghan,168,87,81,321.66,43,22,81,21,1
Monaghan,243,119,124,144.28,49,42,61,65,26
Monaghan,313,143,170,4275.55,93,30,151,34,5
Monaghan,190,97,93,335.5,45,12,96,30,7
Monaghan,245,93,152,2625.21,87,33,94,24,7
Monaghan,337,153,184,670.15,52,37,112,91,45
Monaghan,213,101,112,1197.27,65,19,79,42,8
Monaghan,304,153,151,113.01,70,26,78,87,43
Monaghan,208,100,108,2890.01,30,22,57,58,41
Monaghan,299,141,158,1456.13,79,45,136,32,7
Monaghan,131,58,73,543.62,11,14,33,31,42
Monaghan,183,96,87,3635.86,33,31,66,38,15
Monaghan,212,105,107,1780.32,28,27,62,47,48
Monaghan,215,108,107,1178.45,38,16,70,52,39
Monaghan,96,39,57,1567.01,13,10,28,20,25
Monaghan,185,97,88,765.23,24,35,52,59,15
Monaghan,125,63,62,1744.13,15,10,42,38,20
Monaghan,294,157,137,2041.31,66,30,79,68,51
Monaghan,164,86,78,789.7,18,21,59,39,27
Monaghan,110,54,56,1423.51,17,20,35,23,15
Monaghan,263,132,131,6351.74,68,24,148,21,2
Monaghan,249,127,122,1072.55,33,24,63,62,67
Monaghan,140,74,66,1141.99,18,26,54,26,16
Monaghan,140,77,63,2163.16,17,34,62,22,5
Monaghan,75,43,32,1906.12,2,15,19,30,9
Monaghan,118,64,54,793.78,15,9,47,27,20
Monaghan,178,73,105,1153.93,34,19,59,30,36
Monaghan,280,144,136,43.01,59,43,60,86,32
Monaghan,372,175,197,61.89,84,54,97,106,31
Monaghan,220,101,119,36.03,39,30,49,70,32
Monaghan,286,145,141,56.9,51,32,75,81,47
Monaghan,214,97,117,2851.28,69,21,90,25,9
Monaghan,259,128,131,7114.41,88,30,95,38,8
Monaghan,221,109,112,5978.47,42,46,57,70,6
Monaghan,298,146,152,3939.56,63,39,114,46,36
Monaghan,131,56,75,1034.98,32,22,47,24,6
Monaghan,315,140,175,1918.84,42,28,65,36,144
Monaghan,271,127,144,289.78,49,29,64,53,76
Monaghan,354,174,180,1369.66,91,48,180,33,2
Monaghan,211,103,108,1990.4,30,32,62,63,24
Monaghan,283,143,140,153.96,34,46,59,102,42
Monaghan,205,97,108,46.65,43,28,42,52,40
Monaghan,219,119,100,24.51,71,18,63,42,25
Monaghan,256,130,126,135.86,60,37,85,56,18
Monaghan,286,143,143,40.34,68,27,100,47,44
Monaghan,199,98,101,21.28,45,20,59,47,28
Monaghan,209,108,101,65.26,70,27,55,34,23
Monaghan,259,153,106,21.42,48,39,72,58,42
Monaghan,271,135,136,24.1,61,34,78,56,42
Monaghan,201,97,104,25.25,39,26,61,50,25
Monaghan,239,123,116,50.82,48,29,40,72,50
Monaghan,191,95,96,131.51,34,27,58,54,18
Monaghan,245,113,132,30.27,55,31,57,68,34
Monaghan,267,138,129,29.88,58,39,63,67,40
Monaghan,242,117,125,207.25,37,35,60,69,41
Monaghan,253,133,120,93.57,35,29,43,52,94
Monaghan,179,84,95,553.52,35,26,64,32,22
Monaghan,149,73,76,667.2,21,14,46,37,31
Monaghan,200,94,106,6808.74,28,24,59,48,41
Monaghan,140,69,71,1884.33,27,16,41,36,20
Monaghan,128,70,58,807.29,33,10,46,26,13
Monaghan,218,112,106,2244.16,21,25,54,73,45
Monaghan,125,67,58,1014.89,27,17,42,32,7
Monaghan,212,109,103,23.76,40,33,52,53,34
Monaghan,164,81,83,20.19,38,16,43,43,24
Monaghan,325,166,159,50.59,79,47,84,84,31
Monaghan,223,115,108,19.94,53,24,68,47,31
Monaghan,235,128,107,18.97,48,26,67,56,38
Monaghan,271,141,130,21.19,62,38,75,58,38
Monaghan,308,156,152,22.59,71,40,93,72,32
Monaghan,304,171,133,26.78,66,48,73,81,36
Monaghan,295,166,129,35.36,75,27,84,76,33
Monaghan,314,156,158,95.44,99,40,111,56,8
Monaghan,298,150,148,47.43,78,40,80,73,27
Monaghan,259,133,126,31.17,44,36,81,67,31
Monaghan,359,175,184,50.44,78,33,79,67,102
Monaghan,297,161,136,34.14,87,26,94,56,34
Monaghan,221,104,117,30.93,40,25,45,66,45
Monaghan,199,108,91,17.52,44,17,48,56,34
Monaghan,240,122,118,37.63,79,27,94,29,11
Monaghan,209,106,103,17.34,47,29,54,53,26
Monaghan,232,110,122,19.8,55,26,64,67,20
Monaghan,260,130,130,196.95,68,18,87,55,32
Monaghan,272,142,130,18.61,48,40,69,77,38
Monaghan,364,190,174,43.8,85,46,90,111,32
Monaghan,310,168,142,38.52,74,36,103,60,37
Monaghan,187,95,92,11.51,38,22,45,44,38
Monaghan,258,137,121,28.77,56,36,76,62,28
Monaghan,265,132,133,26.83,71,32,90,45,27
Monaghan,178,97,81,19.81,42,20,56,43,17
Monaghan,266,137,129,33.33,77,28,96,42,23
Monaghan,217,115,102,32.57,60,19,76,46,16
Monaghan,222,114,108,35.23,55,22,81,42,22
Monaghan,244,127,117,31.78,60,27,77,59,21
Monaghan,336,165,171,30.8,83,55,103,63,32
Monaghan,355,188,167,27.68,80,48,95,87,45
Monaghan,98,48,50,9.99,18,12,25,27,16
Monaghan,267,135,132,666.08,79,20,99,49,20
Monaghan,159,78,81,69.58,46,14,46,38,15
Monaghan,283,141,142,52.46,59,45,73,80,26
Monaghan,273,135,138,41.58,60,30,69,84,30
Monaghan,315,164,151,42.27,75,59,63,89,29
Monaghan,341,169,172,45.01,74,50,83,88,46
Monaghan,297,144,153,940.31,69,36,106,54,32
Monaghan,277,120,157,1593.91,59,36,78,69,35
Monaghan,282,143,139,30.92,71,36,81,63,31
Monaghan,210,116,94,50.87,37,25,51,74,23
Monaghan,239,122,117,52.91,65,37,63,55,19
Monaghan,224,113,111,45.9,61,28,65,53,17
Monaghan,218,103,115,26.59,51,28,54,54,31
Monaghan,254,137,117,25.23,73,42,64,60,15
Monaghan,218,120,98,28.93,40,30,62,55,31
Monaghan,211,109,102,35.41,46,27,63,59,16
Monaghan,219,105,114,18.97,53,28,49,55,34
Monaghan,223,106,117,143.89,34,21,79,54,35
Monaghan,204,101,103,51.49,50,34,58,50,12
Monaghan,211,111,100,36.2,50,33,63,46,19
Monaghan,222,115,107,21.5,44,38,50,70,20
Monaghan,293,141,152,46.41,76,27,106,56,28
Monaghan,239,129,110,30.51,52,27,72,55,33
Monaghan,200,93,107,40.02,44,26,64,45,21
Monaghan,278,132,146,239.55,30,34,77,91,46
Monaghan,164,85,79,18.97,33,25,41,40,25
Monaghan,205,112,93,23.63,38,30,46,62,29
Monaghan,229,121,108,22.26,49,29,63,62,26
Monaghan,339,175,164,46.57,67,43,98,93,38
Monaghan,261,128,133,39.34,55,22,65,75,44
Monaghan,258,128,130,37.7,55,33,65,71,34
Monaghan,296,156,140,31.59,75,35,96,47,43
Monaghan,329,159,170,38.53,88,34,111,65,31
Monaghan,314,164,150,32.69,70,46,99,72,27
Monaghan,334,180,154,45.77,83,46,96,71,38
Monaghan,279,144,135,39.34,59,34,72,74,40
Monaghan,282,134,148,33.43,75,25,90,62,30
Monaghan,219,116,103,19.1,53,29,48,60,29
Monaghan,176,97,79,16.65,47,11,44,43,31
Monaghan,298,143,155,33.93,80,21,91,73,33
Monaghan,312,172,140,39.35,75,39,94,62,42
Monaghan,296,148,148,43.18,69,28,75,84,40
Monaghan,182,85,97,160.3,37,27,49,41,28
Monaghan,258,136,122,161.07,64,35,59,69,31
Monaghan,233,124,109,255.83,43,20,55,79,36
Monaghan,220,115,105,29.21,59,19,62,58,22
Monaghan,198,97,101,68.34,26,31,35,69,37
Monaghan,329,126,203,1554.42,60,22,157,34,56
Monaghan,322,143,179,1213.74,92,33,99,69,29
Monaghan,259,129,130,804.53,54,34,124,27,20
Monaghan,285,150,135,1761.99,68,51,90,62,14
Monaghan,283,141,142,1557.62,57,40,72,97,17
Monaghan,197,93,104,2759.22,38,21,68,53,17
Monaghan,336,162,174,5170.82,88,50,136,55,7
Monaghan,224,104,120,190.49,49,26,69,60,20
Monaghan,385,182,203,176.91,123,54,90,75,43
Monaghan,245,119,126,4827.11,32,25,82,64,42
Monaghan,308,146,162,1213.53,56,47,89,82,34
Monaghan,233,113,120,1226.48,61,34,84,45,9
Monaghan,171,86,85,2794.12,23,20,39,46,43
Monaghan,291,132,159,148.73,62,37,103,63,26
Monaghan,321,166,155,935.11,84,29,133,52,23
Monaghan,209,89,120,6360.51,66,19,69,32,23
Monaghan,213,104,109,762.93,20,26,44,81,42
Monaghan,206,96,110,1171.72,25,35,101,33,12
Monaghan,173,84,89,977.59,26,25,65,34,23
Monaghan,217,105,112,1412.88,21,42,80,52,22
Monaghan,363,180,183,768.7,33,37,97,92,104
Monaghan,168,76,92,1648.4,30,20,49,40,29
Monaghan,228,92,136,988.16,37,33,90,34,34
Monaghan,193,94,99,824.26,25,13,79,42,34
Monaghan,199,99,100,1564.9,36,17,76,42,28
Monaghan,185,90,95,6635.11,32,21,59,43,30
Monaghan,278,131,147,1092.66,66,33,86,48,45
Monaghan,363,203,160,16.46,77,49,91,90,56
Monaghan,282,148,134,27.73,72,21,83,77,29
Monaghan,210,106,104,25.66,53,29,62,41,25
Monaghan,171,83,88,2722.84,37,26,56,44,8
Monaghan,135,64,71,256.99,30,18,45,24,18
Monaghan,230,122,108,37.5,51,24,58,58,39
Monaghan,218,108,110,36.43,46,30,55,68,19
Monaghan,253,128,125,35.09,77,32,72,50,22
Monaghan,202,100,102,48.19,51,19,49,54,29
Monaghan,236,127,109,22.21,50,23,62,54,47
Monaghan,224,123,101,21.39,42,40,56,63,23
Monaghan,282,148,134,48.58,83,33,76,61,29
Monaghan,292,156,136,25.97,66,41,72,80,33
Monaghan,253,124,129,235.5,66,24,97,38,28
Monaghan,328,175,153,57.29,66,46,93,78,45
Monaghan,219,118,101,15.94,37,38,49,67,28
Monaghan,321,172,149,20.95,83,29,99,76,34
Monaghan,327,176,151,15.61,71,55,98,80,23
Monaghan,183,94,89,37.48,27,30,47,54,25
Monaghan,212,111,101,24.49,62,31,41,57,21
Monaghan,307,164,143,28.1,66,42,82,73,44
Monaghan,266,131,135,45.85,55,32,67,85,27
Monaghan,298,153,145,49.9,65,48,77,79,29
Monaghan,284,139,145,64.06,72,34,95,59,24
Monaghan,297,142,155,52.93,51,40,77,83,46
Monaghan,361,158,203,50.95,118,34,97,76,36
Monaghan,255,136,119,25.9,62,27,61,62,43
Monaghan,194,101,93,21.29,46,21,61,46,20
Monaghan,212,114,98,25.56,56,15,66,45,30
Offaly,179,90,89,10.68,28,29,38,64,20
Offaly,195,95,100,24.56,34,19,43,60,39
Offaly,158,86,72,14.73,38,13,42,40,25
Offaly,300,140,160,26.35,56,61,66,87,30
Offaly,345,173,172,33.24,98,36,103,80,28
Offaly,296,145,151,119.81,76,27,84,55,54
Offaly,384,178,206,3410.24,117,50,152,54,11
Offaly,308,169,139,26.66,78,48,79,75,28
Offaly,253,134,119,16.52,59,27,69,63,35
Offaly,323,155,168,96.04,75,37,92,85,34
Offaly,413,211,202,21.55,89,63,111,105,45
Offaly,323,167,156,23.77,93,35,93,70,32
Offaly,323,167,156,49.05,76,29,105,69,44
Offaly,381,206,175,16.98,104,49,120,70,38
Offaly,205,91,114,152.47,45,15,63,55,27
Offaly,398,206,192,25.34,95,35,110,84,74
Offaly,141,76,65,225,21,26,34,32,28
Offaly,159,81,78,385.39,39,23,40,33,24
Offaly,269,128,141,347.66,87,34,88,40,20
Offaly,316,154,162,3445.61,43,57,73,101,42
Offaly,182,85,97,326.62,39,14,62,37,30
Offaly,323,149,174,978.61,57,44,93,74,55
Offaly,156,79,77,10.53,31,23,32,50,20
Offaly,378,190,188,20.78,106,51,93,77,51
Offaly,209,108,101,41.3,39,38,47,60,25
Offaly,181,93,88,17.45,44,19,38,57,23
Offaly,315,160,155,793.26,65,37,78,95,40
Offaly,311,164,147,973.98,90,30,107,55,29
Offaly,272,131,141,73.14,64,49,65,74,20
Offaly,174,87,87,834.2,44,29,66,34,1
Offaly,202,89,113,417.29,33,22,46,67,34
Offaly,185,93,92,2029.8,22,23,52,40,48
Offaly,194,111,83,190.2,39,17,81,37,20
Offaly,330,169,161,570.29,84,27,141,51,27
Offaly,255,130,125,1877.91,57,29,93,47,29
Offaly,340,145,195,323.49,112,34,80,66,48
Offaly,377,176,201,1532.22,117,36,144,52,28
Offaly,140,77,63,1598.72,15,14,50,28,33
Offaly,124,76,48,1257.06,12,14,45,33,20
Offaly,151,72,79,852.98,26,23,29,47,26
Offaly,195,89,106,2967.9,34,25,75,42,19
Offaly,206,100,106,485.76,57,32,90,19,8
Offaly,286,141,145,1233.55,56,30,72,92,36
Offaly,419,204,215,3689.03,97,82,115,87,38
Offaly,227,109,118,2306.32,33,30,52,79,33
Offaly,198,90,108,305.25,33,15,59,52,39
Offaly,425,191,234,666.16,72,53,83,94,123
Offaly,431,226,205,20.13,135,34,142,80,40
Offaly,274,146,128,39,54,28,72,75,45
Offaly,307,156,151,15.06,72,36,103,68,28
Offaly,120,62,58,6.62,22,21,27,32,18
Offaly,211,111,100,15.41,61,23,59,42,26
Offaly,265,132,133,21.87,69,38,80,53,25
Offaly,305,145,160,18.18,79,25,97,56,48
Offaly,259,128,131,20.19,61,25,83,63,27
Offaly,294,145,149,75.29,66,38,69,77,44
Offaly,367,179,188,88.2,98,50,100,78,41
Offaly,372,207,165,32.52,107,44,101,88,32
Offaly,275,137,138,53.58,71,45,80,48,31
Offaly,297,139,158,2170.35,95,37,110,39,16
Offaly,364,193,171,85.09,96,41,137,59,31
Offaly,220,120,100,188.44,36,25,63,63,33
Offaly,223,118,105,364,44,36,62,63,18
Offaly,268,134,134,392.93,56,60,56,79,17
Offaly,171,83,88,1063.51,39,19,55,30,28
Offaly,219,104,115,1479.12,44,28,60,44,43
Offaly,221,108,113,3480.75,19,30,51,73,48
Offaly,93,45,48,1388.62,7,12,15,36,23
Offaly,256,121,135,657.76,55,32,88,53,28
Offaly,241,108,133,158.14,79,28,62,42,30
Offaly,316,160,156,75.7,66,44,69,88,49
Offaly,358,172,186,2688.78,125,47,125,52,9
Offaly,334,162,172,532.5,81,39,122,52,40
Offaly,344,172,172,29.05,78,41,92,92,41
Offaly,305,151,154,19.57,68,47,83,75,32
Offaly,305,169,136,8.67,77,34,94,66,34
Offaly,440,209,231,45.78,112,40,144,95,49
Offaly,337,169,168,11.13,62,43,90,97,45
Offaly,202,101,101,20.09,47,22,64,42,27
Offaly,218,110,108,30.95,48,31,67,45,27
Offaly,263,139,124,16.74,70,28,81,56,28
Offaly,272,127,145,70.4,63,42,80,65,22
Offaly,305,168,137,11.83,85,45,78,66,31
Offaly,221,115,106,29.37,50,19,71,53,28
Offaly,355,183,172,17.39,86,33,116,85,35
Offaly,165,81,84,133.29,38,14,56,38,19
Offaly,183,90,93,74.79,32,21,49,43,38
Offaly,234,118,116,91.92,41,43,58,68,24
Offaly,263,135,128,19.36,69,31,81,60,22
Offaly,188,97,91,115.11,56,28,68,29,7
Offaly,215,100,115,499.28,44,39,51,62,19
Offaly,260,131,129,1312.06,66,28,83,48,35
Offaly,302,143,159,620.18,77,31,105,54,35
Offaly,300,155,145,14.3,69,50,69,75,37
Offaly,248,123,125,8.35,48,40,61,72,27
Offaly,293,143,150,14.34,68,44,69,77,35
Offaly,256,132,124,17.03,52,35,67,64,38
Offaly,201,107,94,12.39,44,24,50,54,29
Offaly,323,165,158,14.54,83,27,91,75,47
Offaly,354,186,168,13.81,81,28,113,82,50
Offaly,358,189,169,16.08,73,44,83,100,58
Offaly,250,125,125,48.07,60,32,65,70,23
Offaly,249,121,128,28.63,61,33,51,76,28
Offaly,242,122,120,34.79,61,32,58,68,23
Offaly,409,201,208,71.22,101,53,99,109,47
Offaly,447,233,214,14.71,113,54,128,95,57
Offaly,348,170,178,3654.85,72,45,101,91,39
Offaly,241,124,117,3780.69,31,24,62,73,51
Offaly,253,124,129,1401.42,76,30,68,35,44
Offaly,212,105,107,1686.17,40,25,45,66,36
Offaly,312,137,175,1762.11,80,21,105,36,70
Offaly,369,193,176,150.08,99,28,136,81,25
Offaly,189,99,90,875.09,52,18,92,19,8
Offaly,391,180,211,4471.89,130,40,172,41,8
Offaly,279,138,141,925.41,74,28,108,40,29
Offaly,191,100,91,1583.47,67,14,95,13,2
Offaly,239,125,114,222.68,61,23,95,45,15
Offaly,368,187,181,5684.71,62,45,109,114,38
Offaly,456,223,233,9937.46,142,91,122,95,6
Offaly,259,125,134,2653.04,53,37,57,90,22
Offaly,116,75,41,616.03,20,16,48,24,8
Offaly,169,98,71,588.04,16,19,55,56,23
Offaly,250,118,132,785.75,66,32,106,38,8
Offaly,286,150,136,1713.8,111,37,107,25,6
Offaly,210,99,111,2941.05,63,25,73,43,6
Offaly,281,139,142,861.22,79,35,117,42,8
Offaly,189,100,89,3981.55,44,18,101,23,3
Offaly,360,174,186,2900.7,119,33,167,33,8
Offaly,193,102,91,1167.24,23,37,82,42,9
Offaly,329,169,160,291.19,87,34,114,61,33
Offaly,145,82,63,7.41,24,17,27,50,27
Offaly,215,109,106,21.55,42,26,43,85,19
Offaly,272,132,140,19.03,68,31,71,71,31
Offaly,235,121,114,15.18,49,19,69,64,34
Offaly,182,83,99,367.6,28,16,39,54,45
Offaly,192,95,97,2957.49,33,26,38,69,26
Offaly,157,78,79,177.77,28,10,51,35,33
Offaly,217,99,118,130.75,51,15,82,43,26
Offaly,239,126,113,44.32,52,32,62,64,29
Offaly,308,166,142,10.61,60,32,78,89,49
Offaly,267,125,142,533.65,53,37,52,56,69
Offaly,318,155,163,33.04,90,35,82,80,31
Offaly,192,98,94,183.7,53,14,76,37,12
Offaly,184,90,94,64.42,36,23,52,53,20
Offaly,279,134,145,26.08,95,26,67,58,33
Offaly,398,197,201,36.74,104,55,112,93,34
Offaly,246,125,121,453.15,76,14,114,32,10
Offaly,299,158,141,12.05,64,28,78,80,49
Offaly,361,172,189,24.98,98,40,106,74,43
Offaly,317,164,153,21.89,78,49,64,92,34
Offaly,247,122,125,26.74,49,19,71,74,34
Offaly,309,157,152,16.08,45,49,73,95,47
Offaly,150,82,68,12.04,26,16,43,45,20
Offaly,198,106,92,24.87,45,16,55,59,23
Offaly,364,191,173,12.95,93,40,115,79,37
Offaly,385,205,180,15.66,90,41,104,107,43
Offaly,231,117,114,22.1,39,39,57,59,37
Offaly,195,98,97,765.22,47,31,40,58,19
Offaly,179,85,94,286.36,44,20,41,35,39
Offaly,293,153,140,488.6,38,37,64,87,67
Offaly,188,99,89,34.97,46,25,56,40,21
Offaly,218,113,105,50.54,56,25,75,51,11
Offaly,301,149,152,27.52,66,51,69,79,36
Offaly,221,106,115,22.96,59,22,62,51,27
Offaly,406,222,184,40.76,80,61,105,125,35
Offaly,357,196,161,25.99,93,45,94,91,34
Offaly,296,141,155,28.15,72,37,72,82,33
Offaly,198,98,100,34.91,47,19,52,61,19
Offaly,270,155,115,12.18,70,37,71,69,23
Offaly,392,205,187,21.8,78,65,94,112,43
Offaly,259,128,131,29.63,77,24,70,54,34
Offaly,275,141,134,12.26,59,36,77,67,36
Offaly,230,121,109,30.07,42,26,68,66,28
Offaly,282,143,139,10.81,69,35,81,66,31
Offaly,174,83,91,12.01,42,22,47,41,22
Offaly,189,89,100,7.45,58,20,54,41,16
Offaly,367,184,183,11.34,90,45,85,103,44
Offaly,167,86,81,7,37,23,42,44,21
Offaly,360,183,177,18.33,72,47,89,105,47
Offaly,299,151,148,17.11,65,36,76,80,42
Offaly,245,125,120,24.29,55,43,60,69,18
Offaly,202,100,102,12.9,42,20,59,61,20
Offaly,246,119,127,28.01,66,25,74,56,25
Offaly,383,196,187,100.04,89,48,100,119,27
Offaly,253,138,115,14.85,73,36,69,52,23
Offaly,252,126,126,10.33,55,30,68,61,38
Offaly,262,135,127,16.44,69,26,76,60,31
Offaly,410,302,108,47.86,105,134,61,62,48
Offaly,247,118,129,109.78,51,32,52,76,36
Offaly,379,195,184,17.72,91,32,116,85,55
Offaly,160,78,82,12.35,57,11,52,21,19
Offaly,298,149,149,23.48,79,40,78,75,26
Offaly,390,195,195,94.01,130,49,123,65,23
Offaly,187,93,94,1193.17,30,29,41,51,36
Offaly,185,89,96,662.94,42,23,99,18,3
Offaly,347,170,177,6084.3,86,51,97,84,29
Offaly,258,142,116,780,83,26,97,44,8
Offaly,185,86,99,653.53,20,16,31,44,74
Offaly,198,91,107,81.99,43,39,61,36,19
Offaly,318,156,162,509.3,61,27,96,88,46
Offaly,395,199,196,29.38,97,59,105,84,50
Offaly,325,166,159,31.23,75,44,81,89,36
Offaly,424,223,201,26.35,84,52,113,119,56
Offaly,440,226,214,21.26,115,42,123,112,48
Offaly,197,99,98,21.68,53,19,57,47,21
Offaly,206,101,105,14.25,55,24,58,44,25
Offaly,149,73,76,8.09,45,11,45,28,20
Offaly,337,170,167,48.3,86,41,70,97,43
Offaly,252,130,122,4092.24,74,29,68,60,21
Offaly,254,121,133,175.27,47,22,55,47,83
Offaly,307,155,152,227.61,92,37,91,74,13
Offaly,312,161,151,42.43,76,34,77,85,40
Offaly,237,127,110,25.1,48,45,61,67,16
Offaly,253,132,121,22.13,58,45,61,66,23
Offaly,299,161,138,12.52,40,32,66,92,69
Offaly,334,170,164,16.53,66,45,76,97,50
Offaly,180,79,101,101.03,49,18,56,30,27
Offaly,197,104,93,21.37,46,21,49,52,29
Offaly,186,93,93,23.01,48,13,53,38,34
Offaly,169,79,90,245.17,26,22,45,29,47
Offaly,217,109,108,137.41,52,20,58,48,39
Offaly,394,200,194,40.48,101,52,103,89,49
Offaly,323,173,150,24.47,76,37,93,84,33
Offaly,437,225,212,26.04,95,44,124,118,56
Offaly,296,153,143,55.42,65,43,84,67,37
Offaly,212,118,94,10.65,35,24,59,56,38
Offaly,261,141,120,19.07,61,26,77,67,30
Offaly,226,107,119,52.31,54,32,54,70,16
Offaly,232,117,115,58.46,55,41,46,62,28
Offaly,109,60,49,4.6,26,22,24,25,12
Offaly,278,144,134,31.2,55,34,41,102,46
Offaly,235,114,121,151.94,73,24,113,21,4
Offaly,211,103,108,501.82,44,28,41,58,40
Offaly,256,118,138,65.85,45,37,47,81,46
Offaly,328,154,174,7198.98,97,31,173,26,1
Offaly,219,113,106,5755.43,64,30,112,12,1
Offaly,353,173,180,206.04,93,37,172,33,18
Offaly,368,179,189,6082.34,119,25,182,39,3
Offaly,358,183,175,287,76,48,143,57,34
Offaly,241,105,136,368.55,63,26,136,13,3
Offaly,183,82,101,821.36,38,19,105,19,2
Offaly,333,152,181,292.46,72,41,79,94,47
Offaly,266,116,150,1304.64,74,17,126,45,4
Offaly,306,145,161,3388.52,73,60,90,67,16
Offaly,256,117,139,1402.52,47,28,128,37,16
Offaly,338,167,171,609.21,109,40,86,56,47
Offaly,280,132,148,2105.72,75,29,112,52,12
Offaly,230,111,119,3644.6,33,24,69,72,32
Offaly,447,241,206,1818.94,51,28,95,116,157
Offaly,365,182,183,5622.48,107,32,188,36,2
Offaly,190,93,97,3673.7,19,27,50,46,48
Offaly,152,87,65,2135.58,25,15,53,36,23
Offaly,298,141,157,4002.36,55,32,94,64,53
Offaly,163,72,91,1245.3,14,15,54,37,43
Offaly,313,154,159,1286.75,127,23,124,30,9
Offaly,175,85,90,3012.67,47,25,89,14,0
Offaly,276,131,145,5196.57,66,40,101,50,19
Offaly,464,204,260,2156.97,196,47,166,48,7
Offaly,282,135,147,4257.63,107,62,76,35,2
Offaly,186,85,101,1299.65,28,24,48,55,31
Offaly,104,65,39,1323.49,4,13,46,30,11
Offaly,263,124,139,2977.03,33,36,52,124,18
Offaly,194,95,99,1298.88,26,28,38,71,31
Offaly,217,109,108,1561.81,16,26,51,72,52
Offaly,306,148,158,551.87,48,40,51,103,64
Offaly,227,116,111,1084.66,33,29,92,49,24
Offaly,228,115,113,2718.53,50,26,88,42,22
Offaly,203,102,101,2435.72,30,25,61,62,25
Offaly,287,131,156,4424.78,80,67,76,54,10
Offaly,179,87,92,4300.71,30,25,38,52,34
Offaly,240,124,116,1525.28,61,40,65,48,26
Offaly,344,145,199,802.08,104,33,99,77,31
Offaly,274,135,139,2397.68,60,31,114,45,24
Offaly,122,66,56,3070.26,29,14,46,20,13
Offaly,113,65,48,3925.38,15,20,50,18,10
Offaly,331,159,172,2609.9,74,59,83,89,26
Offaly,217,96,121,4123.83,50,14,123,17,13
Offaly,426,219,207,5988.36,72,72,101,146,35
Offaly,195,81,114,716.4,37,23,28,43,64
Offaly,313,137,176,5562.27,77,20,176,32,8
Offaly,225,104,121,317.06,45,27,53,65,35
Offaly,239,122,117,1083.35,45,29,38,81,46
Offaly,397,190,207,4318.64,60,53,90,108,86
Offaly,193,103,90,2256.78,32,24,49,52,36
Offaly,189,92,97,1808.89,31,25,50,62,21
Roscommon,135,73,62,7.62,25,8,39,40,23
Roscommon,135,74,61,13.37,22,12,32,44,25
Roscommon,190,98,92,23.31,37,24,34,67,28
Roscommon,150,68,82,20.44,33,21,32,51,13
Roscommon,187,98,89,16.63,33,23,38,58,35
Roscommon,267,151,116,23.43,78,17,65,75,32
Roscommon,246,117,129,32.01,63,27,65,57,34
Roscommon,296,153,143,13.28,58,40,73,79,46
Roscommon,162,84,78,11.72,29,19,29,50,35
Roscommon,222,112,110,18.91,65,11,68,51,27
Roscommon,236,136,100,14.72,35,33,66,69,33
Roscommon,303,155,148,14.17,56,39,64,89,55
Roscommon,249,119,130,120.83,53,32,82,52,30
Roscommon,260,130,130,136.85,63,27,106,48,16
Roscommon,249,124,125,227.49,69,14,122,32,12
Roscommon,222,116,106,1358.46,43,24,74,55,26
Roscommon,403,206,197,1077.3,101,56,116,105,25
Roscommon,306,145,161,4743.67,80,27,180,16,3
Roscommon,208,91,117,862.27,65,18,105,17,3
Roscommon,285,141,144,5619.53,92,23,151,17,2
Roscommon,297,124,173,591.13,81,16,146,44,10
Roscommon,199,96,103,971.73,74,16,64,30,15
Roscommon,205,85,120,3940.79,77,12,109,6,1
Roscommon,274,121,153,81.35,80,25,119,38,12
Roscommon,322,161,161,154.96,74,50,107,71,20
Roscommon,351,167,184,732.7,100,29,185,32,5
Roscommon,212,97,115,241.74,66,13,117,15,1
Roscommon,232,108,124,66.62,44,21,49,75,43
Roscommon,275,149,126,61.26,69,39,108,45,14
Roscommon,150,84,66,1301.99,43,12,68,24,3
Roscommon,227,119,108,11.03,41,29,48,70,39
Roscommon,188,95,93,10.13,43,19,34,53,39
Roscommon,157,83,74,17.68,23,21,35,51,27
Roscommon,202,104,98,23.39,50,21,51,62,18
Roscommon,191,89,102,401.56,32,20,50,61,28
Roscommon,131,65,66,242.47,35,23,44,25,4
Roscommon,86,56,30,698.23,6,5,33,24,18
Roscommon,262,141,121,193.24,60,26,58,72,46
Roscommon,144,66,78,74.87,20,17,32,51,24
Roscommon,266,130,136,45.83,63,31,63,67,42
Roscommon,144,77,67,655.3,20,19,44,20,41
Roscommon,166,90,76,42.71,62,17,51,24,12
Roscommon,128,62,66,284.87,22,23,40,26,17
Roscommon,216,110,106,1758.99,65,34,61,43,13
Roscommon,127,71,56,15.95,17,14,20,55,21
Roscommon,161,81,80,43.4,38,17,40,42,24
Roscommon,288,143,145,19.12,58,38,53,90,49
Roscommon,250,124,126,12.11,45,16,60,74,55
Roscommon,154,75,79,148.67,18,22,44,43,27
Roscommon,191,101,90,13.97,40,18,52,41,40
Roscommon,130,65,65,311.74,30,12,39,31,18
Roscommon,252,121,131,14.94,55,26,51,75,45
Roscommon,174,92,82,17.1,44,17,46,46,21
Roscommon,185,77,108,36.99,37,19,52,41,36
Roscommon,147,71,76,20.8,33,15,33,35,31
Roscommon,255,126,129,21.53,50,36,61,66,42
Roscommon,262,131,131,19.8,63,27,86,55,31
Roscommon,185,101,84,26.73,40,19,55,38,33
Roscommon,247,126,121,32.63,48,24,64,78,33
Roscommon,155,78,77,12.7,29,13,44,50,19
Roscommon,220,108,112,11.92,42,23,48,65,42
Roscommon,273,141,132,30.52,43,35,64,74,57
Roscommon,265,130,135,24.14,66,28,80,55,36
Roscommon,163,95,68,9.5,31,29,38,35,30
Roscommon,165,87,78,10.55,47,14,40,42,22
Roscommon,114,62,52,11.02,16,5,25,48,20
Roscommon,142,75,67,109.35,30,11,41,36,24
Roscommon,208,120,88,9.09,33,17,48,63,47
Roscommon,127,58,69,15.33,23,13,26,41,24
Roscommon,175,71,104,230.89,21,15,32,57,50
Roscommon,229,113,116,3018.68,68,24,103,33,1
Roscommon,307,135,172,440.45,40,21,72,71,103
Roscommon,190,94,96,15.36,46,19,39,67,19
Roscommon,269,138,131,81.02,66,28,75,76,24
Roscommon,236,118,118,378.56,56,31,72,48,29
Roscommon,168,89,79,975.97,28,27,67,29,17
Roscommon,109,52,57,1588.09,20,10,31,32,16
Roscommon,122,60,62,317.67,22,7,46,20,27
Roscommon,183,89,94,4677.44,45,33,45,43,17
Roscommon,83,46,37,176.05,5,13,9,37,19
Roscommon,84,50,34,2347.42,4,8,25,30,17
Roscommon,166,78,88,3229.01,12,11,28,46,69
Roscommon,217,106,111,242.16,53,30,47,48,39
Roscommon,95,47,48,1232.47,7,4,13,32,39
Roscommon,239,123,116,12.55,33,27,48,74,57
Roscommon,199,98,101,19.4,42,27,36,64,30
Roscommon,175,88,87,14.1,23,24,30,65,33
Roscommon,264,143,121,19.63,55,28,67,84,30
Roscommon,144,76,68,13.34,41,6,41,36,20
Roscommon,275,140,135,18.97,67,28,69,74,37
Roscommon,268,129,139,15.72,57,38,74,64,35
Roscommon,226,106,120,30.78,43,26,51,46,60
Roscommon,263,134,129,24.91,77,18,72,73,23
Roscommon,279,137,142,30.81,76,38,90,61,14
Roscommon,235,127,108,19.61,60,24,63,56,32
Roscommon,203,108,95,11.01,47,17,46,56,37
Roscommon,243,133,110,19.8,63,20,85,45,30
Roscommon,291,155,136,17.97,55,48,73,77,38
Roscommon,189,90,99,16.05,30,27,48,46,38
Roscommon,180,90,90,15.17,39,22,38,52,29
Roscommon,143,80,63,10.39,29,18,35,40,21
Roscommon,167,96,71,110.59,35,12,48,36,36
Roscommon,280,120,160,167.69,63,40,54,66,57
Roscommon,184,95,89,71.78,38,16,50,56,24
Roscommon,206,103,103,23.01,43,27,39,55,42
Roscommon,181,91,90,1443.04,35,22,48,55,21
Roscommon,130,62,68,133.03,12,11,22,32,53
Roscommon,114,55,59,476.55,9,19,26,28,32
Roscommon,174,93,81,14.01,34,20,35,52,33
Roscommon,283,132,151,229.2,47,23,75,56,82
Roscommon,616,505,111,63.44,51,133,280,105,47
Roscommon,97,49,48,524.21,15,9,31,26,16
Roscommon,86,44,42,659.35,5,4,18,23,36
Roscommon,208,106,102,1508.31,19,17,37,59,76
Roscommon,208,99,109,1397.92,29,39,52,66,22
Roscommon,394,198,196,13.79,82,58,100,101,53
Roscommon,353,171,182,17.3,72,45,67,102,67
Roscommon,244,123,121,13.53,68,29,58,55,34
Roscommon,201,103,98,11.2,30,18,47,62,44
Roscommon,184,96,88,12.42,48,14,51,41,30
Roscommon,175,86,89,8.86,23,22,41,57,32
Roscommon,243,113,130,21.59,58,26,70,55,34
Roscommon,139,71,68,14.65,32,11,36,36,24
Roscommon,152,83,69,17.57,28,10,42,45,27
Roscommon,315,163,152,16.69,70,35,84,89,37
Roscommon,273,129,144,34.13,48,36,71,78,40
Roscommon,170,79,91,124.64,39,19,54,36,22
Roscommon,217,99,118,132.6,62,22,90,31,12
Roscommon,157,71,86,812.35,25,14,30,52,36
Roscommon,106,44,62,758.14,5,2,18,20,61
Roscommon,212,98,114,18.55,38,22,56,56,40
Roscommon,239,123,116,14.78,57,29,71,51,31
Roscommon,288,157,131,13.59,49,40,69,86,44
Roscommon,136,70,66,11.53,19,22,29,50,16
Roscommon,167,85,82,11.49,31,13,44,51,28
Roscommon,188,100,88,15.87,37,18,51,42,40
Roscommon,209,104,105,21.02,55,20,63,47,24
Roscommon,302,148,154,84.09,87,38,86,73,18
Roscommon,205,96,109,93.44,37,28,44,74,22
Roscommon,289,148,141,33.66,79,35,77,71,27
Roscommon,172,84,88,129.03,42,12,42,41,35
Roscommon,419,210,209,27.8,95,68,96,119,41
Roscommon,237,111,126,32.22,44,35,47,86,25
Roscommon,197,104,93,45.74,46,23,42,56,30
Roscommon,182,92,90,127,37,22,47,48,28
Roscommon,116,69,47,8.18,19,16,24,37,20
Roscommon,169,88,81,12.14,35,15,47,41,31
Roscommon,164,82,82,11.2,25,28,32,53,26
Roscommon,176,86,90,26.47,45,19,58,30,24
Roscommon,183,86,97,10.56,42,10,43,55,33
Roscommon,207,112,95,11.45,53,11,55,59,29
Roscommon,204,102,102,12.83,46,22,52,56,28
Roscommon,135,68,67,555.37,22,17,43,34,19
Roscommon,203,109,94,139.29,58,15,62,39,29
Roscommon,248,112,136,121.24,46,29,114,37,22
Roscommon,141,77,64,14.93,26,15,21,48,31
Roscommon,271,136,135,20.44,50,22,73,86,40
Roscommon,163,88,75,21.58,33,15,57,43,15
Roscommon,323,168,155,25.53,77,36,81,81,48
Roscommon,360,179,181,17.18,93,31,95,98,43
Roscommon,242,128,114,10.15,57,24,59,55,47
Roscommon,132,67,65,14.81,33,15,37,33,14
Roscommon,150,75,75,11.37,25,15,27,54,29
Roscommon,164,88,76,14.5,45,15,48,36,20
Roscommon,127,67,60,11.11,28,13,38,33,15
Roscommon,223,106,117,52.65,50,28,64,47,34
Roscommon,188,98,90,58.71,21,11,43,47,66
Roscommon,193,94,99,205.29,45,20,59,38,31
Roscommon,190,96,94,27.92,40,23,43,56,28
Roscommon,88,41,47,7.32,12,12,25,21,18
Roscommon,179,93,86,14.88,28,23,34,63,31
Roscommon,180,89,91,8.38,38,23,40,49,30
Roscommon,158,82,76,10.13,26,17,41,50,24
Roscommon,143,70,73,123.8,24,17,42,35,25
Roscommon,149,74,75,26.33,32,20,38,47,12
Roscommon,230,119,111,27.31,54,30,63,52,31
Roscommon,180,84,96,70.61,57,17,55,28,23
Roscommon,199,94,105,25.06,29,30,56,52,32
Roscommon,195,102,93,19.07,41,15,55,51,33
Roscommon,319,157,162,23.75,75,26,89,92,37
Roscommon,141,77,64,16.32,29,19,31,44,18
Roscommon,227,103,124,18.92,49,37,46,65,30
Roscommon,145,77,68,17.18,23,16,36,45,25
Roscommon,228,117,111,22.53,70,25,67,43,23
Roscommon,167,88,79,9.7,33,16,39,45,34
Roscommon,99,50,49,19.9,28,4,31,23,13
Roscommon,222,109,113,10.34,44,24,42,84,28
Roscommon,369,191,178,23.49,74,45,106,96,48
Roscommon,126,60,66,11.1,26,6,39,31,24
Roscommon,316,158,158,14.83,74,37,72,92,41
Roscommon,170,91,79,15.47,21,13,41,66,29
Roscommon,105,51,54,14.22,13,8,31,33,20
Roscommon,117,62,55,13.32,14,14,15,57,17
Roscommon,135,65,70,11.96,20,25,25,43,22
Roscommon,187,95,92,13.89,45,17,49,49,27
Roscommon,231,127,104,16.73,51,27,55,65,33
Roscommon,286,143,143,23.94,74,27,79,72,34
Roscommon,207,113,94,12.4,30,32,41,67,37
Roscommon,107,51,56,8.78,25,9,34,25,14
Roscommon,319,158,161,16.89,68,32,94,86,39
Roscommon,253,131,122,11.41,56,35,58,75,29
Roscommon,269,128,141,19.24,72,29,75,60,33
Roscommon,340,174,166,29.19,68,48,85,101,38
Roscommon,319,167,152,52.35,73,42,71,99,34
Roscommon,370,180,190,79.09,116,37,98,91,28
Roscommon,321,163,158,175.67,68,43,63,127,20
Roscommon,306,156,150,38.29,46,31,61,110,58
Roscommon,231,129,102,29.96,47,33,46,63,42
Roscommon,124,72,52,16.98,16,17,29,41,21
Roscommon,200,105,95,14.4,39,18,41,61,41
Roscommon,235,125,110,20.5,59,20,64,53,39
Roscommon,211,110,101,57.25,34,27,67,47,36
Roscommon,133,58,75,178.03,33,23,35,26,16
Roscommon,388,204,184,16.59,110,33,125,60,60
Roscommon,314,162,152,12.27,73,22,93,84,42
Roscommon,201,105,96,14.16,45,26,44,53,33
Roscommon,169,74,95,15.64,42,17,26,55,29
Roscommon,164,81,83,5.77,31,20,41,44,28
Roscommon,249,130,119,21.95,48,22,67,61,51
Roscommon,187,81,106,334.71,35,22,45,56,29
Roscommon,133,64,69,15.49,28,10,30,33,32
Roscommon,158,80,78,12,33,27,27,50,21
Roscommon,310,163,147,15.29,71,26,88,72,53
Roscommon,250,142,108,23.41,63,25,81,57,24
Roscommon,236,127,109,24.46,61,20,69,56,30
Roscommon,152,82,70,24,28,11,43,45,25
Roscommon,264,130,134,42.07,84,14,111,39,16
Roscommon,173,87,86,12.33,32,16,49,55,21
Roscommon,146,70,76,90.84,37,14,52,28,15
Roscommon,167,86,81,29.1,38,27,51,37,14
Roscommon,163,80,83,11.68,24,24,31,52,32
Roscommon,178,91,87,17.41,36,20,41,43,38
Roscommon,196,97,99,20.38,43,24,44,58,27
Roscommon,210,115,95,13.65,45,18,60,54,33
Roscommon,135,60,75,8.62,19,16,23,49,28
Roscommon,242,113,129,16.24,51,24,64,67,36
Roscommon,166,87,79,41.3,24,18,30,55,39
Roscommon,116,58,58,55.34,18,7,39,16,36
Roscommon,183,94,89,613.68,37,22,72,41,11
Roscommon,180,90,90,33.65,37,19,49,51,24
Roscommon,181,87,94,93.42,40,16,54,44,27
Roscommon,279,143,136,22.8,58,42,76,65,38
Roscommon,264,129,135,103.96,44,31,68,79,42
Roscommon,240,121,119,207.47,20,30,56,79,55
Roscommon,351,167,184,1190.44,112,29,113,54,43
Roscommon,212,104,108,56.34,38,28,60,54,32
Roscommon,325,159,166,93.55,108,27,112,47,31
Roscommon,124,66,58,225.16,25,16,39,33,11
Roscommon,194,98,96,2233.53,42,30,78,32,12
Roscommon,191,90,101,486.64,63,9,105,7,7
Roscommon,598,274,324,648.79,122,53,118,105,200
Roscommon,262,108,154,28.21,57,19,64,48,74
Roscommon,369,182,187,412.17,104,33,143,61,28
Roscommon,159,78,81,149.08,36,20,62,31,10
Roscommon,307,141,166,1323.36,92,24,133,45,13
Roscommon,318,158,160,1485.56,63,47,108,70,30
Roscommon,228,113,115,447.81,55,22,46,72,33
Roscommon,189,88,101,1242.77,72,20,60,30,7
Roscommon,332,160,172,1029.54,75,40,112,73,32
Roscommon,228,117,111,1354.6,22,23,65,67,51
Roscommon,194,89,105,1988.87,27,25,84,28,30
Roscommon,189,89,100,657.42,32,16,47,50,44
Roscommon,152,79,73,1886.75,30,13,56,29,24
Roscommon,86,45,41,2085.2,9,10,28,19,20
Roscommon,150,79,71,2992.1,24,16,40,43,27
Roscommon,181,99,82,583.65,25,27,71,31,27
Roscommon,162,91,71,8.56,25,15,40,40,42
Roscommon,168,82,86,9.29,29,26,30,56,27
Roscommon,213,105,108,22.05,50,23,43,66,31
Roscommon,212,97,115,19.79,53,28,52,50,29
Roscommon,218,117,101,15.77,34,31,61,59,33
Roscommon,270,126,144,57.76,67,31,87,59,26
Roscommon,249,136,113,28.81,43,35,48,73,50
Roscommon,128,63,65,322.71,18,15,30,35,30
Roscommon,131,59,72,1020.66,30,24,34,29,14
Roscommon,113,51,62,105.54,16,12,34,29,22
Roscommon,258,133,125,33.53,43,31,55,82,47
Roscommon,124,63,61,702.99,15,19,35,30,25
Roscommon,254,128,126,40.21,64,27,70,67,26
Roscommon,219,112,107,18.55,54,38,47,48,32
Roscommon,276,142,134,14.43,64,24,72,69,47
Roscommon,93,48,45,57.74,13,14,31,24,11
Roscommon,225,112,113,239.01,70,12,101,33,9
Roscommon,213,113,100,33.64,43,25,71,52,22
Roscommon,165,85,80,22,38,18,29,58,22
Roscommon,259,126,133,30.14,34,33,69,90,33
Roscommon,250,126,124,30.84,46,35,58,88,23
Roscommon,229,106,123,30.83,66,29,63,50,21
Roscommon,134,71,63,13.16,28,11,31,39,25
Roscommon,151,81,70,13.43,26,26,29,50,20
Roscommon,279,138,141,14.74,48,40,61,83,47
Roscommon,178,91,87,12.83,40,16,44,50,28
Roscommon,204,94,110,11.97,39,13,60,57,35
Roscommon,347,178,169,16.34,81,41,92,86,47
Sligo,280,131,149,23.65,51,41,75,64,49
Sligo,259,137,122,19.26,63,28,51,80,37
Sligo,167,84,83,211.37,40,14,68,24,21
Sligo,190,88,102,28.77,44,4,46,54,42
Sligo,201,105,96,18.78,36,26,44,66,29
Sligo,181,100,81,13.4,35,18,43,53,32
Sligo,157,79,78,7.48,24,30,26,53,24
Sligo,135,70,65,36.35,26,14,20,47,28
Sligo,184,88,96,14.02,46,18,51,38,31
Sligo,177,87,90,10.91,41,12,48,44,32
Sligo,172,89,83,18.25,22,21,42,54,33
Sligo,319,162,157,13.51,71,31,85,75,57
Sligo,308,160,148,113.72,91,39,99,58,21
Sligo,256,127,129,19.65,57,29,74,73,23
Sligo,179,94,85,18.28,34,26,33,64,22
Sligo,221,115,106,19.66,47,22,68,54,30
Sligo,350,180,170,54.31,103,31,128,51,37
Sligo,264,124,140,1613.69,92,30,97,38,7
Sligo,199,103,96,480.76,55,21,72,32,19
Sligo,177,84,93,934.03,49,17,66,28,17
Sligo,167,74,93,1432.53,11,14,26,34,82
Sligo,194,88,106,32.12,46,12,48,48,40
Sligo,186,80,106,704.82,43,20,51,42,30
Sligo,109,51,58,1629.54,7,11,22,34,35
Sligo,207,109,98,734.32,26,26,48,68,39
Sligo,287,138,149,22.24,89,25,77,66,30
Sligo,174,90,84,24.2,38,14,55,45,22
Sligo,140,69,71,200.47,35,18,43,29,15
Sligo,197,99,98,7.29,46,22,42,57,30
Sligo,223,101,122,33.29,39,32,43,86,23
Sligo,174,89,85,32.93,29,23,40,62,20
Sligo,192,95,97,738.56,35,17,57,58,25
Sligo,113,58,55,1444.5,18,7,29,38,21
Sligo,315,140,175,4584.42,106,26,136,40,7
Sligo,175,81,94,23.83,30,20,46,51,28
Sligo,171,85,86,13.99,41,16,41,51,22
Sligo,123,61,62,8.3,21,16,24,37,25
Sligo,169,83,86,20.02,38,15,38,55,23
Sligo,160,92,68,21.12,31,25,36,44,24
Sligo,152,81,71,23.72,35,16,29,35,37
Sligo,132,71,61,3.5,18,17,26,47,24
Sligo,238,126,112,15.9,58,26,51,59,44
Sligo,160,88,72,12.75,35,16,30,50,29
Sligo,154,82,72,11.55,22,26,32,56,18
Sligo,327,166,161,92.82,56,53,44,129,45
Sligo,196,95,101,57.41,34,35,35,67,25
Sligo,220,117,103,66.1,34,34,37,87,28
Sligo,237,115,122,19.93,67,26,53,68,23
Sligo,261,83,178,53.42,27,117,31,56,30
Sligo,206,103,103,15.37,38,32,37,77,22
Sligo,196,97,99,114.19,39,29,43,58,27
Sligo,163,81,82,56.93,40,12,44,41,26
Sligo,173,86,87,65.89,23,23,37,55,35
Sligo,249,122,127,28.31,52,26,60,79,32
Sligo,270,134,136,24.07,61,44,59,70,36
Sligo,318,166,152,38.11,76,33,83,86,40
Sligo,345,181,164,32.39,91,37,89,86,42
Sligo,190,99,91,11.28,34,23,45,65,23
Sligo,243,125,118,8.42,51,30,57,67,38
Sligo,177,90,87,19.79,32,19,41,57,28
Sligo,94,45,49,50.63,16,14,29,19,16
Sligo,135,70,65,25.51,22,9,25,50,29
Sligo,199,101,98,21.8,43,14,61,47,34
Sligo,190,98,92,37.39,44,15,49,60,22
Sligo,207,119,88,31.3,58,20,55,53,21
Sligo,179,89,90,24.04,32,20,48,51,28
Sligo,200,98,102,1549.43,49,22,72,45,12
Sligo,183,90,93,216.86,25,18,60,49,31
Sligo,216,113,103,21.8,61,21,53,60,21
Sligo,218,117,101,44.67,40,33,48,72,25
Sligo,183,96,87,18.78,37,26,37,62,21
Sligo,275,144,131,8.81,67,29,64,81,34
Sligo,126,60,66,34.3,30,17,36,31,12
Sligo,181,96,85,14.29,39,18,35,52,37
Sligo,190,98,92,25.05,34,27,43,63,23
Sligo,220,110,110,2730.99,52,17,93,41,17
Sligo,170,93,77,2738.18,20,18,102,19,11
Sligo,137,61,76,750.12,27,14,43,27,26
Sligo,304,150,154,86.48,76,45,82,78,23
Sligo,265,147,118,19.08,73,43,64,53,32
Sligo,117,55,62,326.48,20,10,81,6,0
Sligo,230,114,116,1463.82,52,22,123,24,9
Sligo,267,122,145,3280.66,65,28,97,39,38
Sligo,166,77,89,1592.82,30,18,54,43,21
Sligo,141,69,72,674.27,44,9,55,22,11
Sligo,188,96,92,2189.76,52,28,86,20,2
Sligo,257,140,117,16.11,62,28,83,71,13
Sligo,284,133,151,41.79,91,31,101,44,17
Sligo,278,142,136,1333.82,83,21,148,22,4
Sligo,111,60,51,214.41,23,8,49,23,8
Sligo,128,66,62,804.57,21,22,34,33,18
Sligo,142,69,73,1646.99,44,12,70,11,5
Sligo,142,73,69,11.68,34,12,33,38,25
Sligo,147,74,73,19.2,30,20,29,42,26
Sligo,177,106,71,14.32,39,22,34,65,17
Sligo,165,92,73,13.86,19,19,26,63,38
Sligo,187,97,90,14.8,35,13,56,46,37
Sligo,159,81,78,69.56,33,16,61,26,23
Sligo,174,93,81,13.5,24,25,34,56,35
Sligo,190,102,88,12.63,46,27,43,52,22
Sligo,227,121,106,24.65,48,28,55,68,28
Sligo,246,119,127,82.14,69,21,68,59,29
Sligo,264,136,128,104.28,30,29,51,86,68
Sligo,195,110,85,58.43,30,18,46,65,36
Sligo,277,144,133,33.95,47,53,45,96,36
Sligo,236,120,116,274.74,48,22,60,68,38
Sligo,260,129,131,48.22,52,36,46,93,33
Sligo,322,129,193,282.18,40,25,104,107,46
Sligo,212,105,107,786.2,50,12,58,50,42
Sligo,318,138,180,197.47,43,31,45,106,93
Sligo,313,150,163,64.48,61,37,71,100,44
Sligo,309,164,145,12.89,75,34,79,82,39
Sligo,198,98,100,25.46,41,28,50,54,25
Sligo,216,119,97,20.51,56,19,67,56,18
Sligo,281,151,130,20.1,70,20,75,73,43
Sligo,246,118,128,29.18,63,28,64,51,40
Sligo,187,90,97,30.96,40,15,41,59,32
Sligo,190,103,87,30.74,27,19,49,69,26
Sligo,238,113,125,31.64,70,23,61,49,35
Sligo,225,118,107,19.48,36,20,46,75,48
Sligo,153,80,73,40.56,25,16,35,46,31
Sligo,191,90,101,17.93,42,21,37,51,40
Sligo,112,64,48,51.22,19,5,32,30,26
Sligo,215,115,100,15.29,53,24,39,76,23
Sligo,201,101,100,5.39,52,13,49,51,36
Sligo,232,119,113,358.12,38,35,81,47,31
Sligo,289,155,134,17.29,51,42,58,95,43
Sligo,172,98,74,30.24,34,19,39,48,32
Sligo,178,80,98,261.64,37,21,52,51,17
Sligo,136,71,65,558.51,19,17,29,45,26
Sligo,163,91,72,37.75,35,19,40,44,25
Sligo,206,88,118,270.64,31,25,47,71,32
Sligo,184,91,93,20.76,46,25,47,45,21
Sligo,175,93,82,76.02,55,4,80,27,9
Sligo,105,52,53,823.2,14,8,28,38,17
Sligo,135,55,80,313.73,16,4,35,21,59
Sligo,293,160,133,12.99,55,36,62,89,51
Sligo,227,126,101,14.94,37,24,77,51,38
Sligo,190,100,90,7.15,39,17,41,55,38
Sligo,257,132,125,88.17,55,32,52,90,28
Sligo,264,132,132,143.3,48,50,55,85,26
Sligo,253,124,129,51.84,70,26,46,78,33
Sligo,241,134,107,90.48,40,27,63,67,44
Sligo,233,128,105,45.26,35,43,39,88,28
Sligo,224,116,108,319.33,64,28,65,50,17
Sligo,305,139,166,363.18,69,35,148,43,10
Sligo,244,129,115,90.29,29,32,49,83,51
Sligo,242,122,120,7.84,48,28,53,60,53
Sligo,150,84,66,13.08,32,13,23,52,30
Sligo,194,99,95,11.34,41,22,37,59,35
Sligo,142,63,79,12.17,24,15,30,44,29
Sligo,148,79,69,14.47,34,4,39,33,38
Sligo,241,134,107,14.9,56,18,64,59,44
Sligo,129,63,66,304.59,10,17,58,30,14
Sligo,193,90,103,2526.11,29,18,43,55,48
Sligo,212,104,108,180.78,38,19,73,49,33
Sligo,228,117,111,439.82,63,16,82,51,16
Sligo,261,122,139,41.18,31,44,44,96,46
Sligo,404,196,208,3227.07,122,29,156,39,58
Sligo,163,76,87,994.31,42,13,62,35,11
Sligo,158,71,87,257.61,36,11,70,28,13
Sligo,226,117,109,92.37,23,27,38,88,50
Sligo,353,178,175,62.26,74,46,75,123,35
Sligo,197,101,96,110.53,27,16,39,63,52
Sligo,347,168,179,428.71,85,34,129,78,21
Sligo,309,133,176,3100.48,57,72,77,84,19
Sligo,154,74,80,6244.68,22,8,113,9,2
Sligo,259,129,130,48.79,62,31,84,61,21
Sligo,215,111,104,16.93,51,11,45,71,37
Sligo,170,93,77,11.01,43,16,44,45,22
Sligo,196,110,86,18.9,46,25,37,58,30
Sligo,240,129,111,29.27,47,23,68,70,32
Sligo,182,90,92,23.64,43,23,49,53,14
Sligo,325,163,162,246.73,96,21,152,43,13
Sligo,213,109,104,25.25,48,17,58,64,26
Sligo,244,114,130,31.99,51,26,58,81,28
Sligo,258,122,136,47.83,43,47,55,81,32
Sligo,183,94,89,57.23,50,17,48,39,29
Sligo,209,91,118,414.14,73,20,75,31,10
Sligo,177,97,80,44.41,51,10,65,36,15
Sligo,243,120,123,59.45,74,26,81,49,13
Sligo,151,69,82,70.69,42,9,39,28,33
Sligo,219,102,117,1587.5,73,16,81,38,11
Sligo,111,58,53,27.22,26,7,34,27,17
Sligo,130,63,67,37.39,23,14,36,38,19
Sligo,164,84,80,60.48,45,12,51,42,14
Sligo,77,37,40,4.01,16,13,17,28,3
Sligo,114,56,58,7.11,26,11,26,34,17
Sligo,299,172,127,24.42,64,31,65,86,53
Sligo,280,134,146,14.28,65,32,77,63,43
Sligo,246,132,114,27.91,55,17,77,47,50
Sligo,223,112,111,173.88,50,38,68,42,25
Sligo,263,140,123,30.83,67,23,76,58,39
Sligo,194,105,89,5.74,30,24,49,61,30
Sligo,256,135,121,13.43,77,22,78,56,23
Sligo,153,79,74,7.78,33,19,36,50,15
Sligo,177,83,94,5.83,26,25,37,59,30
Sligo,217,105,112,3326.18,35,14,56,51,61
Sligo,286,126,160,4519.02,58,38,91,84,15
Sligo,205,96,109,3343.66,33,26,87,31,28
Sligo,215,111,104,3577.79,45,22,73,40,35
Sligo,170,90,80,3545.06,19,14,46,51,40
Sligo,262,129,133,1706.84,61,32,91,51,27
Sligo,152,72,80,4735.5,25,12,83,15,17
Sligo,243,118,125,5003.19,26,37,65,74,41
Sligo,182,111,71,164.57,4,22,60,53,43
Sligo,195,100,95,2067.39,24,28,53,57,33
Sligo,153,66,87,1560.67,18,20,57,34,24
Sligo,193,97,96,5113.8,16,19,55,54,49
Sligo,303,129,174,3673.71,61,27,90,82,43
Sligo,220,111,109,2706.99,34,11,63,51,61
Sligo,229,96,133,2647.77,74,33,44,64,14
Sligo,162,80,82,2018.62,25,23,34,67,13
Sligo,354,171,183,2420.96,92,44,68,118,32
Sligo,187,86,101,1750.81,32,15,45,47,48
Sligo,156,88,68,10534.85,13,36,76,20,11
Sligo,143,83,60,7085.17,15,34,74,15,5
Sligo,285,129,156,6950.37,115,36,99,29,6
Sligo,225,108,117,7650.2,56,10,147,7,5
Sligo,180,89,91,5982.65,50,13,110,7,0
Sligo,89,42,47,3326.36,3,15,28,25,18
Sligo,253,117,136,6090.08,46,38,62,91,16
Sligo,266,129,137,3133.28,32,35,63,78,58
Sligo,253,119,134,2980.29,53,45,73,67,15
Sligo,153,74,79,1491.98,26,20,57,20,30
Sligo,235,106,129,5050.61,42,24,102,49,18
Sligo,325,151,174,5531.44,102,25,149,40,9
Sligo,259,116,143,3632.44,28,25,55,93,58
Sligo,225,79,146,107.16,14,17,36,48,110
Sligo,302,150,152,15.39,78,39,68,68,49
Sligo,301,154,147,21.85,72,36,101,62,30
Sligo,301,147,154,23.05,71,36,76,80,38
Sligo,245,123,122,10.44,65,16,67,64,33
Sligo,250,129,121,44.42,62,33,57,65,33
Sligo,241,116,125,16.73,68,17,58,56,42
Sligo,214,107,107,26.5,54,29,49,53,29
Sligo,177,86,91,109.05,48,21,69,29,10
Sligo,184,88,96,97.97,53,17,62,31,21
Sligo,214,103,111,128.44,59,21,85,29,20
Sligo,250,131,119,119.27,62,24,107,34,23
Sligo,155,69,86,448.65,37,20,53,35,10
Sligo,279,128,151,540.57,53,36,70,58,62
Sligo,213,105,108,604.43,35,23,87,36,32
Sligo,143,68,75,185.71,27,20,38,38,20
Sligo,218,106,112,444.4,46,16,63,51,42
Sligo,249,128,121,23.11,52,37,50,80,30
Sligo,277,142,135,21.52,57,28,62,84,46
Sligo,229,117,112,13.87,51,23,58,59,38
Sligo,232,107,125,4464.46,45,34,75,58,20
Sligo,210,106,104,2991.07,41,36,68,53,12
Sligo,182,87,95,1462.69,7,29,56,43,47
Sligo,301,146,155,2821.44,38,33,84,98,48
Sligo,252,119,133,5136.67,48,33,58,68,45
Sligo,237,118,119,4064.06,35,62,64,56,20
Sligo,217,96,121,1110.46,25,31,73,67,21
Sligo,164,83,81,1454.33,8,29,66,46,15
Sligo,81,49,32,2703.15,11,30,24,11,5
Sligo,423,205,218,1195.69,63,34,79,100,147
Sligo,78,30,48,2284.64,2,37,28,7,4
Sligo,185,101,84,239.73,36,84,22,31,12
Sligo,261,112,149,1995.26,35,150,46,28,2
Sligo,249,99,150,617.65,25,170,35,14,5
Sligo,262,121,141,2714.01,12,168,29,38,15
Sligo,120,68,52,2632.21,1,117,2,0,0
Sligo,139,73,66,835.86,8,23,59,33,16
Sligo,186,98,88,4369.07,12,63,68,26,17
Sligo,263,128,135,1289.27,4,150,55,40,14
Sligo,352,171,181,730.42,0,132,16,25,179
Sligo,213,102,111,8033.19,60,43,73,28,9
Sligo,404,165,239,2351.5,107,69,91,77,60
Sligo,260,127,133,222.54,80,35,103,27,15
Sligo,143,69,74,3754.56,9,63,51,10,10
Sligo,270,132,138,2228.26,50,30,77,71,42
Sligo,142,74,68,4024.94,25,28,41,40,8
Sligo,247,108,139,6754.35,69,40,77,41,20
Sligo,132,75,57,8857.87,9,32,68,16,7
Sligo,202,89,113,7276.39,26,31,61,50,34
Sligo,158,83,75,7002.3,19,37,46,41,15
Sligo,153,78,75,2452.32,18,13,31,44,47
Sligo,170,91,79,155.28,31,22,43,49,25
Sligo,345,166,179,2382.65,61,53,139,53,39
Sligo,256,124,132,5142.11,44,37,68,89,18
Sligo,163,86,77,3579.82,24,23,55,32,29
Sligo,404,181,223,2260.84,52,50,90,120,92
Sligo,335,163,172,3884.87,59,61,84,113,18
Sligo,117,63,54,3139.68,14,8,28,38,29
Sligo,143,69,74,3175.17,14,7,41,30,51
Sligo,374,182,192,5217.85,86,51,113,104,20
Sligo,245,102,143,2987.59,36,24,62,83,40
Sligo,334,150,184,1312.03,51,53,115,74,41
Sligo,214,110,104,3044.75,46,37,59,59,13
Sligo,240,110,130,1488.6,25,25,47,63,80
Tipperary,358,189,169,32.02,83,45,108,76,46
Tipperary,257,145,112,6.71,56,25,66,78,32
Tipperary,290,151,139,11,75,39,64,78,34
Tipperary,299,153,146,11.35,61,45,70,80,43
Tipperary,416,213,203,17.28,109,51,99,108,49
Tipperary,287,152,135,49.73,69,35,72,71,40
Tipperary,238,130,108,22.18,50,20,65,60,43
Tipperary,202,94,108,21.85,37,21,67,42,35
Tipperary,254,122,132,786.64,63,26,96,50,19
Tipperary,233,115,118,209.31,38,47,59,73,16
Tipperary,242,123,119,19.14,56,26,80,54,26
Tipperary,186,87,99,102.6,31,18,37,56,44
Tipperary,348,179,169,18.49,55,50,85,90,68
Tipperary,287,148,139,56.42,68,35,97,62,25
Tipperary,225,108,117,15.78,43,27,58,67,30
Tipperary,210,108,102,15.79,48,15,61,58,28
Tipperary,364,188,176,3052.03,125,33,132,63,11
Tipperary,211,120,91,378.56,74,18,66,42,11
Tipperary,235,106,129,1214.22,57,17,74,51,36
Tipperary,242,110,132,1074.03,75,17,75,55,20
Tipperary,181,90,91,1155.27,53,16,70,29,13
Tipperary,219,103,116,717.93,66,23,74,40,16
Tipperary,122,44,78,467.17,30,14,42,29,7
Tipperary,369,179,190,988.18,139,14,126,60,30
Tipperary,348,176,172,22.52,83,43,99,87,36
Tipperary,289,151,138,34.88,65,41,72,70,41
Tipperary,213,109,104,7062.57,57,12,121,19,4
Tipperary,166,68,98,5882.98,39,14,90,20,3
Tipperary,306,149,157,140.61,51,46,85,84,40
Tipperary,237,131,106,20.59,50,35,51,64,37
Tipperary,214,119,95,17.98,41,26,65,53,29
Tipperary,313,157,156,16.22,52,51,73,93,44
Tipperary,218,119,99,10.23,41,27,44,61,45
Tipperary,155,76,79,9.25,30,18,46,38,23
Tipperary,302,152,150,17.61,71,33,92,78,28
Tipperary,171,85,86,18.74,37,15,41,46,32
Tipperary,263,125,138,23.09,56,41,68,58,40
Tipperary,347,171,176,19.27,99,28,115,63,42
Tipperary,342,172,170,19.14,86,32,81,91,52
Tipperary,416,211,205,2161.61,138,49,148,76,5
Tipperary,287,150,137,73.41,76,40,109,49,13
Tipperary,215,114,101,31.61,46,27,46,65,31
Tipperary,211,113,98,18.22,51,18,69,55,18
Tipperary,204,107,97,19.45,56,18,67,39,24
Tipperary,250,137,113,17.94,49,34,67,70,30
Tipperary,169,89,80,55.95,23,22,45,38,41
Tipperary,317,157,160,50.35,67,37,113,69,31
Tipperary,302,177,125,48.53,50,35,92,88,37
Tipperary,349,187,162,15.09,74,42,107,74,52
Tipperary,294,158,136,20.12,70,29,85,74,36
Tipperary,252,132,120,15.6,58,35,68,67,24
Tipperary,254,150,104,21,43,23,79,65,44
Tipperary,375,199,176,27.2,74,47,106,114,34
Tipperary,292,156,136,30.36,50,37,75,97,33
Tipperary,183,96,87,30.16,38,18,53,45,29
Tipperary,232,119,113,23.17,54,31,58,60,29
Tipperary,332,170,162,25.16,84,40,92,69,47
Tipperary,219,117,102,13.47,46,16,70,55,32
Tipperary,193,103,90,326.87,36,18,50,45,44
Tipperary,208,111,97,17.71,36,37,58,54,23
Tipperary,207,103,104,14.03,37,27,52,53,38
Tipperary,292,137,155,21.99,74,14,78,56,70
Tipperary,170,88,82,26.32,28,14,44,57,27
Tipperary,221,113,108,23.23,42,22,56,73,28
Tipperary,203,105,98,33.91,40,29,39,61,34
Tipperary,274,131,143,132.48,54,42,81,60,37
Tipperary,325,174,151,23.31,102,19,77,82,45
Tipperary,404,200,204,43.86,105,43,102,109,45
Tipperary,296,151,145,11.29,77,26,84,65,44
Tipperary,107,60,47,5.08,22,15,21,40,9
Tipperary,365,178,187,52.27,91,41,98,82,53
Tipperary,246,141,105,21.89,44,31,76,62,33
Tipperary,268,128,140,1559.58,84,35,97,31,21
Tipperary,220,113,107,98.25,33,31,42,71,43
Tipperary,195,96,99,1053.99,25,20,42,47,61
Tipperary,397,208,189,29.54,89,45,106,111,46
Tipperary,293,150,143,610.6,54,39,77,79,44
Tipperary,160,80,80,600.3,31,20,53,31,25
Tipperary,228,123,105,31.01,52,29,64,60,23
Tipperary,153,77,76,157.82,41,13,54,27,18
Tipperary,255,140,115,11.37,49,26,63,78,39
Tipperary,387,207,180,15.49,69,50,105,104,59
Tipperary,326,164,162,20.5,76,37,89,77,47
Tipperary,325,167,158,15.24,71,41,82,79,52
Tipperary,209,102,107,925.98,57,32,75,33,12
Tipperary,118,52,66,47.28,19,17,38,32,12
Tipperary,405,211,194,21.18,87,52,98,121,47
Tipperary,174,97,77,8.56,25,18,44,48,39
Tipperary,245,123,122,22.6,63,22,83,43,34
Tipperary,211,106,105,2083.19,25,21,58,63,44
Tipperary,166,70,96,1373.92,13,19,32,45,57
Tipperary,218,104,114,203.78,31,21,74,52,40
Tipperary,356,178,178,33.67,85,38,85,92,56
Tipperary,202,95,107,1729.01,44,20,51,57,30
Tipperary,354,179,175,33.98,78,45,106,82,43
Tipperary,258,114,144,263.91,56,32,73,57,40
Tipperary,295,152,143,22.92,56,41,77,75,46
Tipperary,271,140,131,25.94,68,23,68,74,38
Tipperary,230,117,113,43.2,57,29,52,63,29
Tipperary,147,80,67,4362.92,19,18,30,42,38
Tipperary,259,115,144,1027.94,25,24,52,69,89
Tipperary,214,109,105,3066.61,26,24,55,62,47
Tipperary,210,107,103,5378.55,49,27,61,42,31
Tipperary,86,51,35,3810.37,9,10,36,26,5
Tipperary,234,131,103,5195.84,32,28,60,75,39
Tipperary,179,90,89,2005.44,21,22,44,55,37
Tipperary,298,153,145,2759,60,49,86,76,27
Tipperary,291,143,148,1146.96,51,41,65,95,39
Tipperary,216,111,105,244.91,33,25,61,60,37
Tipperary,188,98,90,1391.18,27,24,51,53,33
Tipperary,219,112,107,263.93,35,36,41,81,26
Tipperary,359,186,173,8318.27,87,53,93,112,14
Tipperary,206,92,114,315.2,52,31,61,58,4
Tipperary,370,167,203,2575.47,120,32,122,36,60
Tipperary,138,62,76,139.53,38,18,55,22,5
Tipperary,269,126,143,963.2,85,23,107,33,21
Tipperary,223,105,118,1938.1,40,29,51,68,35
Tipperary,246,114,132,343.19,64,49,82,44,7
Tipperary,239,111,128,4082.68,57,18,65,66,33
Tipperary,283,137,146,2162.75,67,49,81,60,26
Tipperary,252,134,118,198.07,37,32,49,87,47
Tipperary,290,144,146,1642.65,47,40,69,93,41
Tipperary,470,225,245,219.18,157,40,178,56,39
Tipperary,174,90,84,14.13,31,23,28,65,27
Tipperary,414,209,205,31.81,102,37,105,89,81
Tipperary,272,148,124,33.48,57,30,79,75,31
Tipperary,261,136,125,28,45,32,66,80,38
Tipperary,261,135,126,19.39,64,21,62,78,36
Tipperary,207,99,108,781.48,50,21,106,23,7
Tipperary,298,125,173,484.03,81,32,154,26,5
Tipperary,186,93,93,3179.81,22,24,36,62,42
Tipperary,255,119,136,2870.81,89,20,115,22,9
Tipperary,195,103,92,123.29,39,27,64,48,17
Tipperary,382,187,195,1991.44,115,45,193,23,6
Tipperary,381,169,212,55.08,85,41,99,116,40
Tipperary,254,133,121,32.11,78,32,63,56,25
Tipperary,202,94,108,757.84,36,20,38,46,62
Tipperary,191,86,105,791.39,34,17,56,53,31
Tipperary,147,66,81,2733.26,22,13,49,43,20
Tipperary,282,136,146,1811.58,45,48,64,87,38
Tipperary,133,62,71,1424.67,15,15,49,30,24
Tipperary,356,170,186,4404.36,73,63,96,103,21
Tipperary,299,140,159,2552.48,94,32,135,36,2
Tipperary,208,102,106,1328.47,16,7,26,43,116
Tipperary,271,137,134,4187.92,54,28,94,58,37
Tipperary,186,92,94,1671.46,18,15,46,49,58
Tipperary,225,107,118,34.75,65,26,49,59,26
Tipperary,211,107,104,60.72,49,20,51,63,28
Tipperary,202,87,115,499.84,81,23,56,30,12
Tipperary,245,123,122,36.46,60,34,68,56,27
Tipperary,184,94,90,50.98,33,30,37,58,26
Tipperary,148,74,74,12.78,23,16,41,39,29
Tipperary,253,134,119,24.07,67,22,62,61,41
Tipperary,224,120,104,16.71,46,24,62,57,35
Tipperary,168,96,72,9.03,37,24,44,42,21
Tipperary,188,92,96,5.81,26,29,38,60,35
Tipperary,185,98,87,234.09,34,9,42,58,42
Tipperary,196,101,95,305.41,30,11,65,51,39
Tipperary,244,133,111,11.81,54,29,59,63,39
Tipperary,231,119,112,28.46,50,20,70,52,39
Tipperary,262,138,124,13.38,59,21,80,63,39
Tipperary,309,161,148,313.47,79,28,102,74,26
Tipperary,171,87,84,478.24,30,16,42,56,27
Tipperary,294,144,150,13.03,75,38,74,75,32
Tipperary,242,122,120,12.49,51,29,57,68,37
Tipperary,264,119,145,21.88,46,32,60,81,45
Tipperary,234,125,109,6.45,36,18,73,64,43
Tipperary,248,125,123,34.72,58,25,81,62,22
Tipperary,212,103,109,29.92,52,23,63,51,23
Tipperary,250,126,124,12.44,65,29,81,45,30
Tipperary,300,145,155,42.71,84,29,79,71,37
Tipperary,243,118,125,816.92,61,14,143,21,4
Tipperary,235,107,128,57.59,50,33,38,80,34
Tipperary,450,233,217,121.42,104,75,110,122,39
Tipperary,338,173,165,572.36,120,35,111,61,11
Tipperary,269,128,141,118.68,60,26,85,67,31
Tipperary,213,101,112,80,39,33,35,78,28
Tipperary,249,117,132,1101.94,55,58,76,46,14
Tipperary,260,125,135,1730.58,56,55,69,71,9
Tipperary,213,93,120,6396.59,54,33,72,51,3
Tipperary,186,88,98,4552.02,36,25,55,47,23
Tipperary,272,139,133,2791.92,69,25,142,34,2
Tipperary,278,137,141,3115.68,75,20,158,23,2
Tipperary,263,125,138,4737.63,50,43,92,61,17
Tipperary,264,136,128,4932.64,82,26,90,54,12
Tipperary,310,160,150,5432.02,86,23,161,33,7
Tipperary,240,110,130,1117.92,57,51,74,52,6
Tipperary,250,119,131,8230.99,53,58,74,57,8
Tipperary,218,113,105,3921.92,50,18,133,14,3
Tipperary,235,116,119,3464.19,60,29,103,32,11
Tipperary,267,136,131,778.49,69,16,135,28,19
Tipperary,228,114,114,1092.76,34,23,56,80,35
Tipperary,158,76,82,1755.69,11,6,24,36,81
Tipperary,235,109,126,1970.7,29,25,56,61,64
Tipperary,291,138,153,6573.15,49,41,77,80,44
Tipperary,228,118,110,3824.28,33,28,53,65,49
Tipperary,233,118,115,5578.7,53,29,62,73,16
Tipperary,273,126,147,4948.88,44,30,53,74,72
Tipperary,252,118,134,4564.8,49,44,61,68,30
Tipperary,179,86,93,4293.49,21,20,45,50,43
Tipperary,204,101,103,4038.88,37,12,59,54,42
Tipperary,210,98,112,3837.44,26,25,47,71,41
Tipperary,258,125,133,2439.85,33,18,89,53,65
Tipperary,113,56,57,2317.38,5,14,25,26,43
Tipperary,94,46,48,4435.22,8,14,32,28,12
Tipperary,98,51,47,5649.39,5,17,46,19,11
Tipperary,108,55,53,2005.2,6,4,39,35,24
Tipperary,166,79,87,422.06,36,22,42,36,30
Tipperary,217,101,116,4376.59,44,26,63,57,27
Tipperary,209,110,99,3620.36,32,30,44,91,12
Tipperary,268,128,140,10423.96,56,47,69,83,13
Tipperary,331,156,175,4546.14,72,63,85,95,16
Tipperary,217,105,112,5066.9,40,31,59,53,34
Tipperary,589,277,312,1719.61,119,55,148,108,159
Tipperary,107,57,50,1098.4,10,13,25,31,28
Tipperary,244,115,129,1422.81,33,19,51,76,65
Tipperary,189,92,97,1025.9,17,20,42,58,52
Tipperary,267,126,141,40.56,55,29,74,60,49
Tipperary,263,134,129,22.3,65,31,63,65,39
Tipperary,337,172,165,12.02,85,36,75,93,48
Tipperary,335,177,158,26.3,61,53,96,80,45
Tipperary,233,118,115,23.13,68,18,80,41,26
Tipperary,218,108,110,23.4,45,32,50,67,24
Tipperary,350,182,168,28.58,74,47,94,92,43
Tipperary,180,87,93,9.21,28,17,56,58,21
Tipperary,258,135,123,14.31,43,43,48,86,38
Tipperary,283,137,146,27.51,82,26,89,60,26
Tipperary,251,137,114,14.7,60,23,65,67,36
Tipperary,282,152,130,24.26,59,36,78,64,45
Tipperary,285,148,137,12.06,63,19,70,84,49
Tipperary,184,91,93,18.34,38,20,50,59,17
Tipperary,250,134,116,19.82,61,21,60,78,30
Tipperary,356,181,175,25.18,83,20,99,98,56
Tipperary,297,157,140,26.64,69,22,96,79,31
Tipperary,235,124,111,8.18,40,28,54,71,42
Tipperary,328,161,167,14.47,85,34,92,83,34
Tipperary,316,164,152,28.77,47,47,61,104,57
Tipperary,294,160,134,55.4,79,29,78,68,40
Tipperary,373,179,194,15.24,86,51,84,101,51
Tipperary,287,152,135,20.98,74,23,94,77,19
Tipperary,307,162,145,19.15,75,28,76,78,50
Tipperary,282,156,126,34.63,72,41,70,74,25
Tipperary,274,141,133,29.61,58,31,70,82,33
Tipperary,264,131,133,32.42,73,30,85,54,22
Tipperary,295,147,148,28.82,70,35,84,74,32
Tipperary,180,93,87,15.96,41,18,49,45,27
Tipperary,223,113,110,22.75,39,29,48,70,37
Tipperary,196,106,90,178.01,33,28,56,45,34
Tipperary,130,70,60,1962.68,41,21,46,18,4
Tipperary,221,124,97,29.41,45,18,58,64,36
Tipperary,258,142,116,15.88,57,37,65,72,27
Tipperary,317,161,156,20.96,55,54,69,99,40
Tipperary,222,118,104,20.66,51,14,61,55,41
Tipperary,188,95,93,11.67,49,16,50,40,33
Tipperary,162,90,72,23.26,39,9,48,36,30
Tipperary,170,80,90,9.86,33,21,56,38,22
Tipperary,228,106,122,20.42,44,23,63,65,33
Tipperary,200,104,96,36.76,31,33,39,72,25
Tipperary,333,150,183,1075.11,88,32,115,34,64
Tipperary,376,193,183,15.01,77,45,109,92,53
Tipperary,258,130,128,22.07,73,22,72,67,24
Tipperary,273,153,120,8.44,60,34,61,75,43
Tipperary,419,221,198,15.12,73,42,126,116,62
Tipperary,233,114,119,402.86,47,31,57,56,42
Tipperary,292,148,144,31.95,65,36,74,65,52
Tipperary,277,146,131,25.81,54,29,76,83,35
Tipperary,292,146,146,18.24,63,39,80,83,27
Tipperary,234,114,120,20.14,50,31,59,53,41
Tipperary,153,77,76,8.72,44,18,28,38,25
Tipperary,299,155,144,16.18,50,47,67,77,58
Tipperary,210,101,109,13.42,48,29,55,46,32
Tipperary,235,120,115,15.75,62,30,51,63,29
Tipperary,324,183,141,26.67,59,44,91,88,42
Tipperary,433,224,209,37.9,101,65,99,123,45
Tipperary,299,150,149,116,42,38,58,90,71
Tipperary,338,168,170,37.47,71,30,85,97,55
Tipperary,413,199,214,27.83,77,56,106,113,61
Tipperary,284,151,133,548.08,55,36,55,104,34
Tipperary,385,182,203,23.02,66,47,78,111,83
Tipperary,344,169,175,92.87,61,53,65,125,40
Tipperary,259,124,135,528.78,80,20,102,52,5
Tipperary,245,118,127,273.62,39,34,54,65,53
Tipperary,243,123,120,72.24,56,42,73,60,12
Tipperary,296,139,157,6193.76,97,18,171,10,0
Tipperary,250,100,150,5178.88,84,22,132,10,2
Tipperary,232,117,115,3330.84,23,28,58,75,48
Tipperary,240,109,131,3423.58,32,35,51,97,25
Tipperary,246,123,123,1020.24,35,34,48,81,48
Tipperary,300,131,169,5626.51,72,45,102,68,13
Tipperary,187,86,101,8.98,33,18,40,59,37
Tipperary,215,104,111,20.44,54,28,40,63,30
Tipperary,199,96,103,12.75,40,19,37,72,31
Tipperary,261,135,126,78.19,74,31,92,41,23
Tipperary,191,97,94,11.12,46,25,48,53,19
Tipperary,372,190,182,22.55,102,28,101,100,41
Tipperary,361,175,186,30.17,111,24,111,76,39
Tipperary,311,173,138,32.54,75,34,90,85,27
Tipperary,277,143,134,5099.79,48,46,62,92,29
Tipperary,242,125,117,2031.48,32,29,68,68,45
Tipperary,264,129,135,80.23,52,38,55,73,46
Tipperary,330,164,166,587.22,63,50,94,91,32
Tipperary,231,119,112,23.81,61,24,62,58,26
Tipperary,202,103,99,25.45,37,30,52,62,21
Tipperary,78,38,40,305.73,3,7,25,28,15
Tipperary,201,112,89,1797.71,39,25,72,43,22
Tipperary,309,145,164,80.71,70,40,81,82,36
Tipperary,291,151,140,14.03,73,28,77,75,38
Tipperary,241,122,119,7.51,63,26,65,55,32
Tipperary,281,151,130,18.28,84,26,84,62,25
Tipperary,210,118,92,17.78,37,21,51,56,45
Tipperary,251,133,118,23.89,59,22,62,65,43
Tipperary,289,150,139,21.53,76,28,80,67,38
Tipperary,362,186,176,31.97,78,51,98,102,33
Tipperary,257,117,140,15.17,45,32,54,64,62
Tipperary,276,145,131,20.27,56,32,70,88,30
Tipperary,222,112,110,16.93,56,27,63,59,17
Tipperary,220,121,99,22.99,39,37,50,65,29
Tipperary,381,200,181,13.96,95,40,113,87,46
Tipperary,437,265,172,25.59,90,107,97,88,55
Tipperary,271,136,135,21.76,58,25,68,82,38
Tipperary,255,130,125,31.38,52,28,63,76,36
Tipperary,267,129,138,805.68,56,36,66,72,37
Tipperary,193,93,100,283.24,45,26,48,54,20
Tipperary,198,111,87,16.11,37,26,39,66,30
Tipperary,150,74,76,208.4,22,20,30,46,32
Tipperary,175,89,86,37.63,44,25,40,39,27
Tipperary,173,86,87,9.31,39,23,47,48,16
Tipperary,245,125,120,31.83,67,32,77,45,24
Tipperary,342,183,159,39.2,98,32,106,66,40
Tipperary,340,161,179,12.24,71,33,80,90,66
Tipperary,274,142,132,19.03,70,37,75,51,41
Tipperary,287,151,136,27.7,65,34,78,67,43
Tipperary,342,170,172,15.42,79,23,94,105,41
Tipperary,275,146,129,12.42,58,46,56,83,32
Tipperary,198,103,95,27.01,37,34,48,61,18
Tipperary,334,178,156,10.22,79,27,102,86,40
Tipperary,231,112,119,22.9,50,33,50,65,33
Tipperary,237,113,124,20.36,45,38,57,59,38
Tipperary,247,132,115,151.06,55,36,74,65,17
Tipperary,255,119,136,35.18,47,28,86,64,30
Tipperary,245,123,122,17.22,53,50,40,76,26
Tipperary,278,136,142,27.22,85,32,77,59,25
Tipperary,332,168,164,12.9,72,31,87,83,59
Tipperary,433,225,208,22.96,104,47,133,103,46
Tipperary,342,187,155,26.82,80,40,93,83,46
Tipperary,183,89,94,81.98,36,23,44,53,27
Tipperary,251,125,126,28.99,69,29,71,55,27
Tipperary,407,227,180,21.21,90,46,113,110,48
Tipperary,375,186,189,23.94,84,48,99,94,50
Tipperary,331,176,155,12.8,78,33,98,79,43
Tipperary,217,107,110,336.91,50,21,60,59,27
Tipperary,140,74,66,96.64,18,15,30,48,29
Tipperary,249,115,134,39.22,72,31,60,49,37
Tipperary,277,148,129,29.01,64,34,74,76,29
Tipperary,251,120,131,93.47,74,27,88,48,14
Tipperary,371,184,187,29.98,75,70,84,114,28
Tipperary,283,127,156,64.54,83,38,85,61,16
Tipperary,318,164,154,29.28,72,39,90,78,39
Tipperary,244,128,116,27.65,33,35,50,87,39
Tipperary,225,112,113,33.06,62,25,47,54,37
Tipperary,301,147,154,3971.71,72,46,74,70,39
Tipperary,298,152,146,11.76,76,32,82,69,39
Tipperary,153,77,76,7.17,22,15,30,52,34
Tipperary,166,85,81,19.28,32,17,36,47,34
Tipperary,186,99,87,9.31,40,18,53,45,30
Tipperary,135,68,67,13.38,21,13,29,40,32
Tipperary,334,162,172,17.01,76,37,86,78,57
Tipperary,304,157,147,30.94,80,34,73,82,35
Tipperary,317,136,181,20.7,94,30,110,60,23
Tipperary,322,152,170,17.71,70,38,68,91,55
Tipperary,178,84,94,10.84,41,14,44,49,30
Tipperary,348,184,164,14.11,86,37,84,92,49
Tipperary,134,66,68,11.46,27,12,34,43,18
Tipperary,145,74,71,130.75,21,25,26,54,19
Tipperary,187,81,106,45.49,49,23,40,55,20
Tipperary,215,103,112,34.86,46,30,60,62,17
Tipperary,240,118,122,633.19,38,35,113,41,13
Tipperary,363,181,182,410.03,125,42,133,47,16
Tipperary,260,133,127,24.31,78,29,74,52,27
Tipperary,246,121,125,36.36,55,32,74,61,24
Tipperary,270,131,139,6450.69,70,27,134,31,8
Tipperary,342,168,174,1253.53,103,42,171,24,2
Tipperary,206,108,98,14.05,47,20,54,52,33
Tipperary,202,108,94,22.51,42,24,60,46,30
Tipperary,263,137,126,50.11,46,33,52,93,39
Tipperary,286,144,142,27.74,63,36,79,80,28
Tipperary,318,160,158,11.85,71,40,82,80,45
Tipperary,214,116,98,35.8,59,17,61,58,19
Tipperary,321,178,143,37.73,81,44,96,67,33
Tipperary,264,131,133,26.09,59,34,64,69,38
Tipperary,277,133,144,310.77,53,36,66,78,44
Tipperary,186,82,104,32.72,32,19,44,61,30
Tipperary,224,110,114,92.34,44,36,48,72,24
Tipperary,235,112,123,38.64,41,33,57,76,28
Tipperary,235,116,119,48.06,48,29,54,78,26
Tipperary,288,134,154,40.33,76,46,70,68,28
Tipperary,188,99,89,84.82,36,17,48,73,14
Tipperary,207,104,103,475.41,54,16,76,43,18
Tipperary,305,139,166,60.48,79,25,61,70,70
Tipperary,241,129,112,2129.97,26,27,75,54,59
Tipperary,352,175,177,2400.24,96,34,155,46,21
Tipperary,286,129,157,1370.26,57,31,93,63,42
Tipperary,228,116,112,2978.56,26,27,54,78,43
Tipperary,199,95,104,1385.49,43,24,73,37,22
Tipperary,237,96,141,1772.44,25,21,57,60,74
Tipperary,272,133,139,3121.74,60,24,113,51,24
Tipperary,260,137,123,3682.72,64,19,105,47,25
Tipperary,240,118,122,4503.83,33,33,66,70,38
Tipperary,96,40,56,2008.41,11,12,26,24,23
Tipperary,176,80,96,165.77,30,18,35,50,43
Tipperary,259,126,133,2875.38,65,24,134,25,11
Tipperary,227,115,112,4680.03,46,28,120,29,4
Tipperary,165,75,90,280.49,38,12,42,36,37
Tipperary,177,82,95,1047.15,38,15,71,26,27
Tipperary,191,100,91,3316.84,51,18,111,10,1
Tipperary,209,100,109,8528.87,43,34,51,56,25
Tipperary,169,85,84,1392.26,24,20,48,43,34
Tipperary,260,116,144,2447.13,37,31,64,78,50
Tipperary,345,165,180,3393.73,95,42,108,74,26
Tipperary,316,136,180,1568.02,62,31,73,94,56
Tipperary,196,100,96,29,36,32,53,53,22
Tipperary,239,117,122,26.95,56,23,55,67,38
Tipperary,211,114,97,15,48,26,63,42,32
Tipperary,231,114,117,13.19,68,24,70,45,24
Tipperary,238,122,116,49.64,59,25,73,60,21
Tipperary,171,71,100,447.36,28,21,42,44,36
Tipperary,154,66,88,754.25,35,12,46,34,27
Tipperary,202,106,96,41.33,48,19,63,50,22
Tipperary,330,168,162,49.54,65,35,78,58,94
Tipperary,280,149,131,539.32,94,14,140,22,10
Tipperary,212,110,102,24.36,51,33,69,42,17
Tipperary,278,145,133,46.75,69,32,103,60,14
Tipperary,323,158,165,3078.36,97,42,103,56,25
Tipperary,351,157,194,314.94,125,24,139,48,15
Tipperary,165,79,86,1643.33,41,4,102,11,7
Tipperary,263,129,134,603.42,71,20,99,48,25
Tipperary,219,113,106,15.02,54,24,67,45,29
Tipperary,203,103,100,27.19,40,21,55,58,29
Tipperary,281,136,145,20.88,62,26,87,71,35
Tipperary,262,136,126,34.09,58,27,91,54,32
Tipperary,237,126,111,26.96,59,30,72,53,23
Tipperary,316,162,154,36.93,67,31,61,75,82
Tipperary,189,100,89,18.7,35,22,59,43,30
Tipperary,381,193,188,15.38,76,42,130,82,51
Tipperary,217,113,104,25.3,37,24,52,76,28
Tipperary,308,139,169,226.72,87,52,97,58,14
Tipperary,257,120,137,2898.98,71,22,96,47,21
Tipperary,178,97,81,13.1,37,25,35,52,29
Tipperary,241,123,118,23,57,25,65,65,29
Tipperary,241,123,118,34.01,60,31,60,59,31
Tipperary,283,140,143,33.4,91,22,83,62,25
Tipperary,312,155,157,16.65,87,25,93,65,42
Tipperary,394,209,185,24.39,108,30,124,82,50
Tipperary,278,137,141,15.14,55,27,67,69,60
Tipperary,128,67,61,5.76,21,13,24,45,25
Tipperary,333,157,176,17.11,67,45,80,103,38
Tipperary,233,119,114,241.18,77,19,72,46,19
Tipperary,255,133,122,14.83,53,35,56,72,39
Tipperary,251,103,148,1463.51,46,12,80,30,83
Tipperary,256,141,115,14.71,41,32,62,78,43
Tipperary,194,89,105,1410.57,48,27,96,17,6
Tipperary,213,104,109,23.64,38,23,48,57,47
Tipperary,146,71,75,3340.43,20,15,39,34,38
Tipperary,161,85,76,633.17,23,21,40,40,37
Tipperary,332,167,165,1623.46,75,38,110,65,44
Tipperary,209,98,111,2373.09,42,28,90,27,22
Tipperary,407,214,193,728.64,124,69,152,52,10
Tipperary,220,113,107,3146.9,52,33,57,51,27
Tipperary,407,194,213,1070.16,77,55,107,96,72
Tipperary,318,155,163,2265.07,98,32,148,35,5
Tipperary,258,137,121,84.45,57,30,72,72,27
Tipperary,196,92,104,610.9,60,17,81,21,17
Tipperary,270,134,136,2175.17,69,34,76,65,26
Tipperary,391,205,186,42.39,65,54,81,135,56
Tipperary,130,71,59,2677.54,20,16,45,30,19
Tipperary,307,158,149,139.96,88,54,82,58,25
Tipperary,211,94,117,4198.67,89,14,75,20,13
Tipperary,145,78,67,2042.63,18,11,36,56,24
Tipperary,147,78,69,143.92,19,14,43,37,34
Tipperary,123,64,59,720.37,12,13,31,29,38
Tipperary,103,58,45,2352.83,9,10,49,20,15
Tipperary,318,154,164,100.26,67,31,87,81,52
Tipperary,438,219,219,1393.37,111,66,123,99,39
Tipperary,167,95,72,943.68,43,39,41,27,17
Tipperary,403,216,187,23.7,88,37,97,104,77
Tipperary,238,119,119,22.88,54,33,62,60,29
Tipperary,141,77,64,6.08,18,15,36,49,23
Tipperary,223,119,104,1092.56,26,21,64,65,47
Tipperary,200,108,92,701.56,19,22,46,47,66
Tipperary,292,142,150,615.97,48,38,72,80,54
Tipperary,194,96,98,1263.84,39,17,51,44,43
Tipperary,89,46,43,1783.25,7,7,27,23,25
Tipperary,299,144,155,1377.11,73,41,70,83,32
Tipperary,292,129,163,183.28,68,26,97,69,32
Tipperary,178,78,100,622.34,22,31,37,58,30
Tipperary,174,79,95,152.48,37,20,77,21,19
Tipperary,225,123,102,11.28,40,37,57,59,32
Tipperary,203,100,103,9.68,43,29,50,57,24
Tipperary,315,163,152,16.67,70,29,85,73,58
Tipperary,215,113,102,10.96,44,26,48,67,30
Tipperary,319,178,141,94.32,54,45,79,93,48
Tipperary,142,72,70,10.63,19,13,33,55,22
Tipperary,198,88,110,14.05,45,23,49,59,22
Tipperary,139,68,71,15.39,22,12,33,43,29
Tipperary,186,90,96,32.43,40,28,33,64,21
Tipperary,215,104,111,16.12,53,26,50,59,27
Tipperary,353,177,176,108.8,63,44,114,98,34
Tipperary,383,192,191,40.05,67,67,68,132,49
Tipperary,369,187,182,36.59,66,62,79,125,37
Tipperary,338,184,154,48.53,62,63,66,108,39
Tipperary,300,148,152,4672.75,81,36,161,14,8
Tipperary,312,150,162,2782.34,75,44,120,53,20
Tipperary,245,123,122,28.57,47,29,45,84,40
Tipperary,346,169,177,4492.57,100,32,163,39,12
Tipperary,288,130,158,1045.53,38,30,46,64,110
Tipperary,215,101,114,3533.57,31,17,47,51,69
Tipperary,309,139,170,2457.22,49,32,75,92,61
Tipperary,337,158,179,3815.2,41,42,58,100,96
Tipperary,377,186,191,2388.04,83,43,121,82,48
Tipperary,175,80,95,4558.72,43,22,73,26,11
Tipperary,91,47,44,3528.91,5,11,24,26,25
Tipperary,260,119,141,629.83,65,35,66,63,31
Tipperary,200,107,93,2046.35,32,26,54,60,28
Tipperary,145,64,81,922.18,9,56,21,32,27
Tipperary,194,90,104,2180.27,28,22,43,48,53
Tipperary,293,137,156,2857.39,68,40,115,52,18
Tipperary,171,85,86,4411.65,20,24,39,47,41
Tipperary,158,72,86,1970.91,23,15,42,36,42
Tipperary,127,69,58,2025.55,12,29,50,17,19
Tipperary,337,158,179,7700.39,152,39,110,33,3
Tipperary,158,82,76,2939.04,14,24,37,45,38
Tipperary,148,80,68,4414.09,29,29,48,30,12
Tipperary,157,72,85,2888.37,22,20,42,43,30
Tipperary,161,70,91,4687.05,25,19,48,49,20
Tipperary,167,78,89,5203.79,19,11,38,66,33
Tipperary,175,90,85,1250.38,21,14,46,76,18
Tipperary,192,97,95,1461.87,71,12,63,33,13
Tipperary,189,98,91,1345.53,21,23,54,49,42
Tipperary,127,82,45,900.48,10,13,43,38,23
Tipperary,261,132,129,648.34,38,39,69,78,37
Tipperary,292,133,159,284.78,60,18,86,34,94
Tipperary,146,73,73,1369.03,12,19,48,47,20
Tipperary,261,130,131,1030.51,36,42,66,90,27
Tipperary,191,97,94,1078.65,23,18,47,54,49
Tipperary,281,126,155,591.59,83,46,62,70,20
Tipperary,349,189,160,16.34,77,32,105,89,46
Tipperary,155,84,71,1154.47,23,26,33,46,27
Tipperary,179,93,86,3684.49,18,30,40,60,31
Tipperary,267,139,128,1529.81,59,27,114,46,21
Tipperary,171,84,87,8076.32,43,28,42,38,20
Tipperary,189,99,90,6207.71,28,28,54,47,32
Tipperary,258,124,134,5868.44,81,29,69,69,10
Tipperary,300,161,139,3602.91,31,30,72,101,66
Tipperary,268,132,136,1292.44,61,34,69,69,35
Tipperary,114,62,52,2376.49,11,12,43,29,19
Tipperary,157,69,88,403.88,23,25,25,45,39
Tipperary,185,103,82,796.12,24,14,57,56,34
Tipperary,224,103,121,1752.86,57,25,63,62,17
Tipperary,250,123,127,125.77,67,56,57,52,18
Tipperary,351,177,174,35.74,82,32,99,85,53
Tipperary,229,120,109,37.35,48,36,49,65,31
Tipperary,390,194,196,44.18,69,50,77,130,64
Tipperary,221,107,114,46.13,45,16,52,62,46
Tipperary,334,170,164,63.86,58,44,96,83,53
Tipperary,222,109,113,516.01,60,20,117,19,6
Tipperary,191,91,100,3733.97,49,21,91,27,3
Tipperary,154,79,75,1046.76,13,12,36,48,45
Tipperary,157,67,90,5340.68,22,14,37,50,34
Tipperary,109,58,51,3673.62,15,7,35,30,22
Tipperary,148,72,76,3836.28,43,20,68,14,3
Tipperary,276,138,138,6139.2,75,36,125,30,10
Tipperary,157,87,70,1781.96,20,20,40,37,40
Tipperary,109,61,48,769.5,8,12,26,33,30
Tipperary,151,69,82,1451.92,24,20,53,36,18
Tipperary,247,118,129,277.41,44,33,54,58,58
Tipperary,123,56,67,537.82,15,13,30,35,30
Tipperary,224,107,117,3117.13,24,28,52,65,55
Tipperary,317,164,153,22.83,66,34,96,90,31
Tipperary,276,137,139,15.21,57,25,77,70,47
Tipperary,278,131,147,191.9,71,18,90,68,31
Tipperary,260,117,143,25.05,64,39,63,63,31
Tipperary,263,141,122,40.01,59,26,84,64,30
Tipperary,223,112,111,40.31,51,23,59,69,21
Tipperary,277,136,141,11.71,60,36,74,66,41
Tipperary,251,129,122,21.31,82,17,82,48,22
Tipperary,184,84,100,144.44,50,21,53,38,22
Tipperary,248,136,112,27.84,44,24,96,51,33
Tipperary,404,209,195,121.69,118,51,103,95,37
Tipperary,403,211,192,19.55,97,50,91,132,33
Tipperary,329,180,149,11.89,65,34,92,81,57
Tipperary,248,125,123,11.75,50,26,64,71,37
Tipperary,335,176,159,17.38,76,41,87,93,38
Tipperary,233,127,106,49.02,51,20,85,49,28
Tipperary,344,169,175,61.8,79,49,92,76,48
Tipperary,242,116,126,713.91,43,38,60,68,33
Tipperary,136,60,76,857.41,14,16,33,39,34
Tipperary,298,146,152,1757.28,63,41,99,55,40
Tipperary,224,122,102,3710.45,18,26,54,64,62
Tipperary,194,102,92,1253.06,27,28,58,40,41
Tipperary,245,124,121,2360.56,20,25,50,84,66
Tipperary,246,116,130,3804.93,35,31,56,81,43
Tipperary,187,86,101,2346.62,29,18,32,45,63
Tipperary,238,119,119,3507.94,20,27,45,80,66
Tipperary,199,103,96,728.48,24,32,42,72,29
Tipperary,269,132,137,544.88,46,29,54,82,58
Tipperary,295,146,149,1011.92,56,44,40,125,30
Tipperary,388,191,197,3315.3,106,40,131,79,32
Tipperary,213,112,101,820.33,62,20,100,23,8
Tipperary,325,147,178,1994.28,123,27,121,36,18
Tipperary,82,53,29,3068.86,7,12,47,13,3
Tipperary,168,95,73,3519.21,19,33,75,33,8
Tipperary,167,99,68,3117.82,27,31,72,25,12
Tipperary,130,74,56,390.97,23,17,74,14,2
Tipperary,180,81,99,1600.9,14,13,69,36,48
Tipperary,191,88,103,3736.89,19,11,44,62,55
Tipperary,205,102,103,2518.21,26,26,72,49,32
Tipperary,206,114,92,2326.82,50,21,115,17,3
Tipperary,345,169,176,4169.18,94,43,187,19,2
Tipperary,231,118,113,450.65,70,23,108,22,8
Tipperary,155,78,77,631.63,20,18,53,39,25
Tipperary,342,159,183,164.62,101,36,101,41,63
Tipperary,231,118,113,322.31,66,25,79,42,19
Tipperary,153,59,94,1169.83,16,22,38,36,41
Tipperary,166,94,72,1876.68,28,28,88,14,8
Tipperary,117,64,53,841.46,9,14,32,27,35
Tipperary,168,74,94,3961.7,34,16,52,45,21
Tipperary,137,69,68,771.94,9,11,28,42,47
Tipperary,181,88,93,2230.74,32,34,49,50,16
Tipperary,208,100,108,981.88,50,19,89,30,20
Tipperary,272,129,143,2498.94,44,36,77,62,53
Waterford,159,80,79,43.33,42,10,44,40,23
Waterford,242,132,110,43.9,60,30,71,56,25
Waterford,256,135,121,89.25,88,25,91,38,14
Waterford,194,102,92,9.01,50,25,53,42,24
Waterford,87,43,44,828.37,13,19,18,26,11
Waterford,145,69,76,47.24,39,9,32,45,20
Waterford,104,55,49,104.51,15,6,14,48,21
Waterford,286,145,141,136.72,56,34,78,83,35
Waterford,295,159,136,15.91,57,29,98,70,41
Waterford,180,94,86,6.94,37,33,36,55,19
Waterford,259,116,143,37.47,62,26,67,56,48
Waterford,195,97,98,16.82,37,14,56,51,37
Waterford,239,123,116,67.36,68,26,71,48,26
Waterford,338,173,165,24.77,68,33,82,107,48
Waterford,256,139,117,5.56,54,26,70,67,39
Waterford,262,139,123,21.55,53,25,75,66,43
Waterford,262,139,123,16.9,58,17,83,70,34
Waterford,210,103,107,16.04,73,15,64,38,20
Waterford,260,121,139,20.84,59,36,67,63,35
Waterford,166,78,88,9.66,45,20,44,42,15
Waterford,383,172,211,43.29,63,42,79,88,111
Waterford,175,90,85,8.84,39,15,56,38,27
Waterford,337,173,164,9.73,70,39,92,92,44
Waterford,268,130,138,12.59,64,21,75,67,41
Waterford,181,93,88,22.48,37,29,41,55,19
Waterford,189,92,97,27.71,39,25,43,58,24
Waterford,176,100,76,2508.98,35,13,62,27,39
Waterford,180,94,86,1381.84,35,17,54,42,32
Waterford,201,100,101,320.96,31,16,73,49,32
Waterford,285,146,139,25.22,58,34,73,69,51
Waterford,274,143,131,8.6,61,28,63,71,51
Waterford,247,128,119,50.34,53,32,62,63,37
Waterford,198,98,100,23.52,37,15,50,55,41
Waterford,282,148,134,29.99,64,35,75,78,30
Waterford,268,152,116,19.98,62,32,72,72,30
Waterford,241,116,125,17.71,60,27,52,61,41
Waterford,257,121,136,16.7,52,19,57,69,60
Waterford,223,122,101,16.39,40,21,69,61,32
Waterford,182,81,101,36.03,30,17,35,71,29
Waterford,200,94,106,49.2,47,39,48,46,20
Waterford,233,126,107,15.73,54,26,70,46,37
Waterford,262,131,131,3415.06,63,45,73,69,12
Waterford,294,144,150,652.44,73,35,115,52,19
Waterford,193,100,93,77.42,41,24,56,60,12
Waterford,228,111,117,62.35,50,37,43,76,22
Waterford,267,138,129,25.7,65,45,73,66,18
Waterford,233,118,115,33.28,60,24,62,61,26
Waterford,205,102,103,1639.72,52,16,91,30,16
Waterford,244,116,128,3685.58,62,18,141,21,2
Waterford,222,119,103,23.93,63,17,70,48,24
Waterford,224,123,101,26.53,44,33,52,62,33
Waterford,214,106,108,28.4,39,26,54,58,37
Waterford,208,104,104,10.82,38,28,47,68,27
Waterford,269,147,122,56.31,73,21,88,48,39
Waterford,239,124,115,8.51,45,24,64,70,36
Waterford,282,133,149,229.06,77,26,111,45,23
Waterford,255,133,122,21.86,51,26,75,66,37
Waterford,228,110,118,89.37,61,18,71,52,26
Waterford,259,143,116,13.88,65,27,68,60,39
Waterford,366,191,175,27.49,74,46,78,113,55
Waterford,261,139,122,15.17,55,26,64,76,40
Waterford,249,130,119,3915.53,45,35,64,72,33
Waterford,151,72,79,6095.59,24,14,40,35,38
Waterford,348,163,185,2375.6,94,57,101,76,20
Waterford,167,82,85,1824.18,21,15,56,41,34
Waterford,293,145,148,2995.27,63,32,120,50,28
Waterford,166,82,84,782.44,15,21,91,26,13
Waterford,327,158,169,814.1,71,40,98,65,53
Waterford,342,171,171,6510.81,53,48,110,102,29
Waterford,234,128,106,1642.74,48,26,59,70,31
Waterford,434,205,229,325.8,155,54,158,53,14
Waterford,397,194,203,4159.55,44,40,79,75,159
Waterford,300,153,147,4045.09,60,43,65,80,52
Waterford,187,99,88,800.28,26,25,46,58,32
Waterford,344,161,183,4763.62,87,51,86,73,47
Waterford,231,115,116,521.42,52,23,59,69,28
Waterford,169,81,88,2081.9,34,10,38,44,43
Waterford,165,74,91,1812.87,14,12,49,40,50
Waterford,93,50,43,885.6,8,17,47,14,7
Waterford,120,69,51,5812.26,18,22,57,17,6
Waterford,337,167,170,1186.03,108,38,141,42,8
Waterford,279,128,151,3478.85,100,12,134,21,12
Waterford,291,136,155,1041.04,42,20,84,67,78
Waterford,298,146,152,4367.2,41,41,63,105,48
Waterford,235,112,123,1754.22,50,22,81,46,36
Waterford,189,97,92,677.95,25,30,48,67,19
Waterford,257,126,131,1987.89,52,23,50,66,66
Waterford,306,155,151,2325.3,59,38,74,72,63
Waterford,341,162,179,3000.99,51,67,65,123,35
Waterford,246,117,129,1486.67,53,36,47,90,20
Waterford,272,138,134,1071.32,71,32,140,27,2
Waterford,223,108,115,439.11,52,18,74,55,24
Waterford,356,179,177,33.2,74,42,90,103,47
Waterford,375,195,180,95.1,82,41,104,98,50
Waterford,180,78,102,1684.83,19,12,52,21,76
Waterford,358,180,178,128.05,101,30,113,77,37
Waterford,278,131,147,482.49,73,39,123,31,12
Waterford,320,147,173,731.81,81,42,140,44,13
Waterford,266,136,130,24.98,61,35,68,73,29
Waterford,364,189,175,29.64,73,41,80,124,46
Waterford,280,142,138,156.28,61,34,63,77,45
Waterford,207,109,98,54.03,69,15,48,60,15
Waterford,371,182,189,959.84,82,50,120,79,40
Waterford,272,132,140,205.64,77,27,69,67,32
Waterford,238,125,113,93.72,39,31,42,84,42
Waterford,146,68,78,50.23,28,9,50,33,26
Waterford,226,111,115,418.84,64,21,58,60,23
Waterford,234,121,113,18.89,57,27,53,63,34
Waterford,336,170,166,17.17,84,37,107,75,33
Waterford,212,106,106,23.11,43,25,55,65,24
Waterford,220,123,97,19.2,48,25,54,76,17
Waterford,207,110,97,21.57,61,15,63,42,26
Waterford,209,110,99,54.5,46,20,61,56,26
Waterford,186,97,89,19.9,50,16,57,48,15
Waterford,243,126,117,21.54,54,37,54,69,29
Waterford,180,94,86,20.09,41,24,37,49,29
Waterford,191,94,97,23.07,45,14,48,53,31
Waterford,201,111,90,12.98,29,45,34,70,23
Waterford,313,170,143,24.2,70,43,91,58,51
Waterford,244,123,121,12.68,60,27,74,59,24
Waterford,319,164,155,24.65,91,29,94,63,42
Waterford,376,208,168,7.62,87,44,109,83,53
Waterford,224,116,108,63.88,59,17,56,53,39
Waterford,207,103,104,33.3,30,25,54,64,34
Waterford,290,142,148,417.67,111,12,122,28,17
Waterford,293,148,145,1191.96,50,38,50,107,48
Waterford,249,126,123,805.16,53,21,53,72,50
Waterford,367,177,190,2020.3,85,47,68,113,54
Waterford,227,114,113,17.72,47,36,56,57,31
Waterford,264,133,131,50.98,97,22,57,63,25
Waterford,204,96,108,121.64,73,21,73,23,14
Waterford,191,96,95,31.72,50,18,67,39,17
Waterford,196,107,89,9.98,29,15,48,62,42
Waterford,281,132,149,43.68,66,26,78,75,36
Waterford,143,63,80,1185.73,48,8,63,19,5
Waterford,192,80,112,812.62,43,25,61,50,13
Waterford,187,99,88,36.43,45,19,49,50,24
Waterford,150,75,75,435.54,21,13,47,47,22
Waterford,91,47,44,1035.59,12,10,22,26,21
Waterford,97,46,51,124.33,20,2,34,30,11
Waterford,360,173,187,55.62,45,59,71,126,59
Waterford,233,118,115,52.61,43,21,47,85,37
Waterford,405,212,193,28.03,102,41,110,102,50
Waterford,286,146,140,21.73,70,34,75,76,31
Waterford,205,89,116,179.78,32,29,39,62,43
Waterford,391,209,182,24.98,95,34,106,102,54
Waterford,227,113,114,104.72,62,45,54,54,12
Waterford,270,132,138,372.81,34,43,69,71,53
Waterford,271,135,136,80.69,59,36,93,59,24
Waterford,238,111,127,1724.24,66,20,90,44,18
Waterford,263,134,129,56.04,52,38,66,74,33
Waterford,171,84,87,79.77,23,25,35,51,37
Waterford,353,176,177,27.02,71,43,97,100,42
Waterford,343,174,169,79.06,88,54,106,68,27
Waterford,386,207,179,18.2,106,37,126,89,28
Waterford,218,99,119,20.58,63,27,48,62,18
Waterford,105,54,51,9.34,21,8,21,36,19
Waterford,183,95,88,11.77,38,16,58,47,24
Waterford,182,92,90,20.3,31,19,41,57,34
Waterford,231,126,105,36.8,58,30,80,45,18
Waterford,117,57,60,24.83,16,15,35,28,23
Waterford,211,110,101,7.24,45,23,64,56,23
Waterford,190,94,96,25.84,28,22,44,61,35
Waterford,289,152,137,52.93,50,33,57,100,49
Waterford,372,170,202,220.45,92,41,83,81,75
Waterford,152,82,70,13.99,30,16,43,44,19
Waterford,211,94,117,121.83,75,28,78,20,10
Waterford,233,114,119,9.06,47,27,53,64,42
Waterford,301,154,147,14.71,73,31,74,80,43
Waterford,327,167,160,17.04,95,32,97,66,37
Waterford,205,112,93,16.68,57,21,47,60,20
Waterford,269,134,135,31.07,62,38,64,79,26
Waterford,202,101,101,18.46,46,32,53,49,22
Waterford,247,126,121,16.33,59,33,70,53,32
Waterford,92,49,43,5.17,33,9,21,18,11
Waterford,250,129,121,23.9,72,22,64,65,27
Waterford,246,122,124,35.53,72,31,66,47,30
Waterford,251,125,126,18.99,60,30,62,71,28
Waterford,217,105,112,24.41,53,21,75,41,27
Waterford,251,118,133,42.49,53,25,75,68,30
Waterford,243,125,118,26.12,61,23,56,70,33
Waterford,337,170,167,1770.56,122,25,157,30,3
Waterford,217,110,107,4012.5,25,28,49,67,48
Waterford,258,121,137,2299.1,46,24,83,46,59
Waterford,273,128,145,1044.3,61,30,81,65,36
Waterford,219,103,116,11.98,50,22,41,46,60
Waterford,294,145,149,165.45,80,37,107,61,9
Waterford,197,102,95,4.77,47,14,53,55,28
Waterford,247,119,128,32.24,58,25,70,65,29
Waterford,152,75,77,393.75,29,15,42,44,22
Waterford,175,84,91,384.42,46,19,60,40,10
Waterford,240,112,128,1928.33,72,35,75,47,11
Waterford,286,138,148,34.97,83,27,82,63,31
Waterford,221,113,108,30.71,44,27,66,55,29
Waterford,340,168,172,82.76,66,29,127,77,41
Waterford,276,140,136,41.98,63,37,68,79,29
Waterford,268,135,133,30.34,84,24,75,60,25
Waterford,291,150,141,691.61,60,47,73,84,27
Waterford,236,119,117,51.56,60,20,61,63,32
Waterford,374,191,183,43.26,133,25,103,86,27
Waterford,286,147,139,16.97,69,37,72,71,37
Waterford,238,116,122,16.99,56,29,68,44,41
Waterford,217,108,109,18.31,40,22,52,69,34
Waterford,220,119,101,7.12,36,26,44,77,37
Waterford,225,116,109,115.91,54,22,62,59,28
Waterford,281,136,145,104.31,43,24,64,94,56
Waterford,216,103,113,813.51,56,25,67,46,22
Waterford,181,100,81,29.44,42,19,46,56,18
Waterford,182,90,92,155.52,34,14,43,41,50
Waterford,193,90,103,20.41,32,28,36,62,35
Waterford,326,171,155,17.27,83,29,72,91,51
Waterford,246,119,127,2278.5,59,29,82,47,29
Waterford,198,97,101,221.95,16,17,47,65,53
Waterford,263,136,127,1030.95,61,30,83,64,25
Waterford,238,121,117,938.87,50,29,61,57,41
Waterford,223,117,106,10.74,50,38,64,52,19
Waterford,212,110,102,15.33,55,32,38,68,19
Waterford,98,52,46,6.95,23,13,25,26,11
Waterford,133,56,77,1871.08,22,14,34,37,26
Waterford,210,95,115,594.17,33,25,49,59,44
Waterford,169,89,80,2721.33,35,17,53,36,28
Waterford,215,118,97,2188.03,34,30,47,66,38
Waterford,209,94,115,2418.79,32,30,35,78,34
Waterford,282,135,147,2343.83,55,31,62,88,46
Waterford,227,115,112,1169.96,47,25,48,64,43
Waterford,355,173,182,4362.89,105,32,144,49,25
Waterford,375,176,199,5575.13,136,35,143,53,8
Waterford,198,93,105,993.35,27,19,34,59,59
Waterford,336,155,181,4019.43,110,31,132,52,11
Waterford,428,223,205,2701.37,141,46,201,34,6
Waterford,436,214,222,3203.03,150,35,162,70,19
Waterford,274,127,147,1375.75,76,28,75,52,43
Waterford,256,126,130,3681.18,111,28,98,18,1
Waterford,226,110,116,1386.7,73,13,98,28,14
Waterford,317,156,161,1272.13,65,47,83,101,21
Waterford,130,66,64,99.1,28,16,56,25,5
Waterford,231,112,119,4332.58,61,30,58,55,27
Waterford,374,181,193,4624.42,113,39,117,67,38
Waterford,299,154,145,2785.46,65,27,62,86,59
Waterford,218,104,114,4252.66,35,23,44,59,57
Waterford,214,108,106,1208.27,42,19,57,54,42
Waterford,182,98,84,3165.49,23,24,84,40,11
Waterford,270,144,126,3469.86,32,38,66,111,23
Waterford,468,225,243,337.05,168,56,123,104,17
Waterford,309,158,151,30.82,59,56,67,97,30
Waterford,331,156,175,1852.39,65,49,80,97,40
Waterford,249,121,128,4130.86,71,27,96,47,8
Waterford,223,105,118,1712.97,36,12,62,52,61
Waterford,132,63,69,2630.06,14,12,35,44,27
Waterford,200,106,94,2640.72,18,18,55,63,46
Waterford,253,121,132,6517.93,86,29,111,25,2
Waterford,220,102,118,4870.27,89,32,63,30,6
Waterford,187,88,99,2984.88,61,12,96,14,4
Waterford,198,100,98,3969.77,10,25,40,61,62
Waterford,147,64,83,1517.75,15,12,26,27,67
Waterford,216,116,100,19.88,55,29,57,53,22
Waterford,194,92,102,27.44,45,27,32,66,24
Waterford,239,119,120,36.47,53,32,51,77,26
Waterford,168,88,80,37.52,39,10,45,43,31
Waterford,256,114,142,5880.6,53,26,80,66,31
Waterford,346,163,183,4942.57,74,54,74,102,42
Waterford,272,136,136,3823.5,31,58,61,77,45
Waterford,395,189,206,6552.21,94,55,90,122,34
Waterford,371,184,187,6496.35,157,55,101,51,7
Waterford,240,108,132,8159.93,77,41,78,37,7
Waterford,373,193,180,8359.11,117,64,115,72,5
Waterford,351,157,194,3806.03,113,62,92,73,11
Waterford,185,86,99,1047.14,45,21,100,16,3
Waterford,130,63,67,1907.58,6,9,46,22,47
Waterford,342,175,167,1110.14,40,49,60,149,44
Waterford,268,131,137,68.69,37,50,59,79,43
Waterford,304,141,163,2769.76,50,43,50,100,61
Waterford,407,207,200,748.55,114,40,143,93,17
Waterford,217,106,111,4205.92,40,27,63,57,30
Waterford,253,126,127,2189.55,26,23,68,64,72
Waterford,223,104,119,1755.12,26,37,62,79,19
Waterford,722,355,367,1238.48,111,45,153,156,257
Waterford,339,161,178,1114.57,108,51,73,97,10
Waterford,396,187,209,1654.96,117,41,116,86,36
Waterford,260,132,128,84.7,68,20,129,31,12
Waterford,190,94,96,3575.86,42,18,50,59,21
Waterford,240,117,123,5574.39,70,27,102,38,3
Waterford,327,150,177,8565.82,120,63,106,33,5
Waterford,313,156,157,3315.71,101,22,161,25,4
Waterford,296,136,160,7475.88,134,41,97,23,1
Waterford,217,104,113,6983.55,68,14,126,8,1
Waterford,271,130,141,7763.49,89,14,166,2,0
Waterford,371,187,184,3010.75,69,54,107,120,21
Waterford,238,111,127,9005.6,59,54,62,51,12
Waterford,175,85,90,5650.45,44,23,72,33,3
Waterford,287,134,153,8864.04,89,51,75,63,9
Waterford,278,139,139,6386.84,53,50,74,88,13
Waterford,319,145,174,1761.53,111,22,166,18,2
Waterford,289,145,144,4087.52,56,44,68,107,14
Waterford,310,148,162,2428.08,96,36,128,44,6
Waterford,318,152,166,5913.09,107,29,149,29,4
Waterford,327,154,173,3933.41,34,72,70,106,45
Waterford,505,234,271,3251.9,112,116,153,102,22
Waterford,234,103,131,5345.76,69,38,83,38,6
Waterford,152,77,75,3201.55,54,19,42,33,4
Waterford,126,58,68,4158.28,19,11,35,29,32
Waterford,191,93,98,400.69,29,31,66,37,28
Waterford,210,107,103,9099.97,24,35,94,48,9
Waterford,147,86,61,11957.05,26,21,73,19,8
Waterford,81,45,36,6680.41,3,14,39,16,9
Waterford,105,65,40,7221.46,19,18,34,21,13
Waterford,252,113,139,2026.99,5,17,44,99,87
Waterford,94,55,39,6552.35,14,20,39,16,5
Waterford,228,101,127,2932.44,32,17,49,48,82
Waterford,356,183,173,3220.03,52,42,87,133,42
Waterford,229,109,120,5983.64,73,21,114,19,2
Waterford,301,162,139,5262.05,80,43,118,51,9
Waterford,276,128,148,5466.65,59,55,89,61,12
Waterford,360,176,184,4816.63,82,47,92,116,23
Waterford,227,109,118,2107.16,38,39,65,70,15
Waterford,254,118,136,7333.83,51,48,62,85,8
Waterford,345,175,170,2532.11,68,36,132,90,19
Waterford,109,57,52,2417.07,8,21,46,16,18
Waterford,99,57,42,4402.54,13,16,34,22,14
Waterford,79,49,30,4184.77,0,6,23,14,36
Waterford,99,63,36,959.77,5,14,42,15,23
Waterford,114,83,31,1817.49,2,25,64,20,3
Waterford,192,90,102,5972.19,53,18,105,13,3
Waterford,253,118,135,1988.98,37,28,45,99,44
Waterford,376,186,190,4631.8,111,36,127,81,21
Waterford,272,128,144,5946.14,63,29,144,28,8
Waterford,505,243,262,717.09,143,83,115,143,21
Waterford,331,154,177,1415.72,115,32,131,44,9
Waterford,186,88,98,4877.15,45,22,78,32,9
Waterford,189,101,88,5100.25,47,25,62,43,12
Waterford,281,147,134,5612.26,78,24,112,56,11
Waterford,245,121,124,3571.79,62,29,84,58,12
Waterford,197,98,99,3101.19,31,21,44,39,62
Waterford,165,77,88,4843.11,39,9,61,48,8
Waterford,141,63,78,3733.52,24,19,47,33,18
Waterford,372,176,196,4627.1,104,41,163,63,1
Waterford,223,110,113,2104.65,43,42,32,90,16
Waterford,249,117,132,2526.71,58,57,32,96,6
Waterford,261,126,135,5282.65,49,32,71,90,19
Waterford,232,114,118,2663.27,31,22,55,70,54
Waterford,218,116,102,4696.45,41,32,60,63,22
Waterford,283,135,148,2146.36,52,20,80,86,45
Waterford,294,144,150,3037.75,92,36,114,48,4
Waterford,210,102,108,2030.18,27,25,37,63,58
Waterford,250,121,129,3652.62,35,28,63,59,65
Waterford,257,127,130,2648.47,20,25,62,75,75
Waterford,194,71,123,251.42,23,16,30,49,76
Waterford,201,102,99,307.18,48,22,110,19,2
Waterford,349,161,188,61.73,90,38,130,72,19
Waterford,449,215,234,726.8,179,61,139,63,7
Waterford,235,107,128,977.75,45,40,90,40,20
Waterford,285,121,164,196.58,68,15,72,42,88
Waterford,294,143,151,2490.83,82,33,98,68,13
Waterford,224,117,107,2976.23,61,31,56,35,41
Waterford,226,90,136,6554.14,36,26,54,59,51
Waterford,295,149,146,5129.01,48,24,84,66,73
Waterford,317,147,170,1672.02,96,26,157,33,5
Waterford,292,130,162,5495.23,80,62,90,52,8
Waterford,307,139,168,936.19,80,24,157,27,19
Waterford,214,106,108,110.47,70,17,89,27,11
Waterford,202,100,102,4908.27,70,15,100,17,0
Waterford,315,146,169,4243.05,73,58,96,69,19
Waterford,379,193,186,2471.31,99,25,214,36,5
Waterford,249,115,134,6753.64,69,11,154,15,0
Waterford,328,151,177,1474.52,55,31,59,103,80
Waterford,315,163,152,3526.29,85,20,141,40,29
Waterford,130,63,67,1771.09,30,20,64,14,2
Waterford,393,183,210,6302.42,104,38,176,61,14
Waterford,218,111,107,2210.37,15,24,25,104,50
Waterford,340,168,172,142.5,84,35,175,36,10
Waterford,344,165,179,282.36,101,39,161,34,9
Waterford,126,59,67,2445.23,28,36,51,10,1
Waterford,211,98,113,2267.82,17,19,32,45,98
Waterford,151,76,75,3042.88,14,18,39,53,27
Waterford,116,58,58,604.31,11,38,16,16,35
Waterford,105,44,61,16735.73,0,99,6,0,0
Waterford,206,76,130,1798.44,11,13,46,35,101
Waterford,132,68,64,6410.88,9,12,30,45,36
Waterford,185,92,93,6627.02,26,18,55,57,29
Waterford,207,100,107,3533.45,18,23,38,70,58
Waterford,242,129,113,1348.38,46,47,56,52,41
Waterford,264,115,149,880.33,75,42,71,60,16
Waterford,229,127,102,3003.59,35,19,59,73,43
Waterford,240,120,120,8173.55,33,42,65,47,53
Waterford,209,98,111,7790.37,56,14,59,36,44
Waterford,192,94,98,5684.17,13,20,43,41,75
Waterford,200,87,113,11670.65,37,33,49,38,43
Waterford,211,108,103,6639.19,22,26,53,33,77
Waterford,200,90,110,6079.95,25,21,56,60,38
Waterford,158,82,76,4970.59,15,12,40,47,44
Waterford,253,118,135,2684.46,23,32,64,66,68
Waterford,210,100,110,5850.89,31,24,49,58,48
Waterford,230,115,115,4426.99,38,27,60,57,48
Waterford,179,114,65,8966.59,31,38,71,21,18
Waterford,151,76,75,5177.26,8,17,36,48,42
Waterford,295,152,143,4549.73,44,30,64,87,70
Waterford,189,84,105,10619.77,12,25,59,48,45
Waterford,133,61,72,11372.38,19,14,44,33,23
Waterford,186,96,90,5890.55,20,16,48,47,55
Waterford,123,67,56,3044.48,8,23,32,36,24
Waterford,181,101,80,6868.81,19,28,64,49,21
Waterford,193,101,92,4680.72,28,30,47,36,52
Waterford,116,62,54,3118.7,10,47,57,2,0
Waterford,196,80,116,8265.51,56,23,50,56,11
Waterford,199,100,99,7392,25,23,64,54,33
Waterford,161,87,74,7535.69,21,16,49,46,29
Waterford,160,74,86,4075.08,17,16,32,56,39
Waterford,383,174,209,3230.76,56,104,50,56,117
Waterford,282,137,145,1741.54,58,23,49,83,69
Waterford,281,142,139,3158.08,46,28,57,89,61
Waterford,184,99,85,12763.6,22,33,99,18,12
Waterford,107,60,47,1841.65,7,19,44,25,12
Waterford,257,139,118,4144.49,26,32,124,46,29
Waterford,78,55,23,17465.29,4,10,49,14,1
Waterford,116,71,45,14250.61,13,31,63,8,1
Waterford,188,102,86,4077.21,27,19,50,55,37
Waterford,82,45,37,1795.53,3,19,21,21,18
Waterford,177,97,80,7531.27,20,23,99,31,4
Waterford,193,97,96,381.86,23,20,59,53,38
Waterford,218,99,119,1427.23,15,27,35,57,84
Waterford,85,44,41,6253.68,3,26,50,6,0
Waterford,173,93,80,4692.42,21,27,63,43,19
Waterford,111,53,58,1764.2,13,41,33,11,13
Waterford,156,71,85,4103,16,23,41,44,32
Waterford,305,135,170,6329.11,76,38,91,63,37
Waterford,268,134,134,3895.41,55,32,74,54,53
Waterford,241,108,133,6632.18,35,28,58,80,40
Waterford,172,93,79,7818.18,14,22,45,62,29
Waterford,102,56,46,4396.17,8,17,26,31,20
Waterford,195,94,101,1502.81,14,19,47,67,48
Waterford,149,73,76,5830.79,18,19,39,43,30
Waterford,248,120,128,4148.2,25,27,58,71,67
Waterford,133,63,70,4489,24,19,38,35,17
Waterford,78,47,31,5824.37,7,17,37,10,7
Waterford,96,57,39,14527.85,6,35,38,10,7
Waterford,117,60,57,15806.54,11,35,59,12,0
Waterford,142,83,59,3757.91,9,29,65,26,13
Waterford,290,147,143,4985.99,16,46,50,127,51
Waterford,232,114,118,4911.72,17,27,38,86,64
Waterford,237,114,123,3951.84,28,32,56,75,46
Waterford,309,168,141,5444.84,34,46,59,122,48
Waterford,373,192,181,5203.25,56,80,98,117,22
Waterford,429,216,213,2326.36,116,48,137,89,39
Waterford,294,153,141,2989.96,70,42,85,45,52
Waterford,225,118,107,3848.59,18,56,47,49,55
Waterford,148,67,81,3159.22,6,17,29,39,57
Waterford,239,116,123,3615.41,71,24,68,33,43
Waterford,267,116,151,2357.49,36,22,79,67,63
Waterford,213,103,110,1043.72,9,13,27,62,102
Waterford,215,112,103,2691.4,30,19,58,59,49
Westmeath,275,133,142,21.81,77,16,76,71,35
Westmeath,441,222,219,28.08,86,53,111,148,43
Westmeath,246,129,117,2655.47,35,23,66,68,54
Westmeath,292,143,149,4504.85,53,47,74,76,42
Westmeath,243,145,98,5807.84,31,29,155,17,11
Westmeath,140,82,58,3312.04,7,42,53,23,15
Westmeath,165,95,70,9121.57,27,26,100,10,2
Westmeath,406,228,178,4434.44,45,57,195,65,44
Westmeath,144,80,64,799.92,10,21,40,46,27
Westmeath,212,94,118,2253.33,34,26,59,69,24
Westmeath,242,102,140,1869.33,13,19,59,58,93
Westmeath,299,129,170,2839.29,50,136,51,38,24
Westmeath,239,122,117,2920.19,38,28,64,54,55
Westmeath,247,121,126,2548.18,30,37,71,60,49
Westmeath,221,100,121,1655.96,36,22,61,60,42
Westmeath,184,87,97,674.98,13,30,31,52,58
Westmeath,207,100,107,1732.2,14,23,36,38,96
Westmeath,191,93,98,1462.87,31,19,61,52,28
Westmeath,159,82,77,2618.66,12,17,71,34,25
Westmeath,197,95,102,2402.44,19,30,87,28,33
Westmeath,97,45,52,125.01,15,14,35,13,20
Westmeath,290,136,154,4500.87,61,44,118,51,16
Westmeath,198,87,111,2871.1,68,17,86,26,1
Westmeath,222,116,106,3133.03,28,55,81,36,22
Westmeath,211,119,92,2925.31,21,69,69,44,8
Westmeath,218,109,109,3279.63,43,23,56,61,35
Westmeath,212,112,100,2919.71,60,36,75,40,1
Westmeath,127,68,59,6262.95,2,117,8,0,0
Westmeath,160,83,77,2885.38,9,103,28,12,8
Westmeath,168,86,82,1057.58,4,139,15,9,1
Westmeath,165,89,76,1299.27,45,32,60,22,6
Westmeath,163,97,66,4157.74,21,55,60,17,10
Westmeath,323,157,166,1933.66,86,21,158,50,8
Westmeath,327,169,158,2229.57,53,43,132,60,39
Westmeath,370,171,199,1893.24,94,27,171,49,29
Westmeath,294,137,157,1675.79,40,19,92,44,99
Westmeath,519,227,292,986.49,206,48,156,80,29
Westmeath,327,170,157,352.52,99,53,70,73,32
Westmeath,231,114,117,481.64,49,22,57,72,31
Westmeath,194,90,104,2111.93,29,17,132,10,6
Westmeath,225,119,106,2528,56,31,77,48,13
Westmeath,295,125,170,2455.67,92,51,87,46,19
Westmeath,230,109,121,1167.63,32,32,48,67,51
Westmeath,206,94,112,703.62,80,21,72,28,5
Westmeath,146,74,72,819.95,15,10,41,36,44
Westmeath,231,115,116,2418.75,44,36,42,84,25
Westmeath,325,160,165,3714.71,86,50,75,91,23
Westmeath,300,159,141,4556.71,63,49,118,60,10
Westmeath,139,70,69,552.85,10,53,33,27,16
Westmeath,278,138,140,3917.76,35,127,76,27,13
Westmeath,213,108,105,30.16,48,21,64,46,34
Westmeath,374,180,194,3779.84,99,60,99,86,30
Westmeath,125,67,58,7397.76,6,17,55,26,21
Westmeath,108,62,46,10311.25,15,15,55,13,10
Westmeath,222,116,106,4711.48,33,30,57,57,45
Westmeath,240,132,108,964.08,27,85,69,45,14
Westmeath,126,68,58,5347.37,15,23,45,24,19
Westmeath,148,66,82,4355.12,8,20,60,21,39
Westmeath,194,96,98,485.94,31,23,73,49,18
Westmeath,335,154,181,733.01,57,35,109,74,60
Westmeath,256,131,125,479.79,39,39,71,67,40
Westmeath,246,120,126,1140.69,60,21,93,43,29
Westmeath,315,156,159,3402.61,72,36,102,69,36
Westmeath,246,117,129,2312.16,42,27,79,48,50
Westmeath,230,111,119,601.36,42,23,52,69,44
Westmeath,246,122,124,29.51,71,24,70,59,22
Westmeath,189,94,95,29.99,37,15,48,62,27
Westmeath,277,138,139,50.88,57,43,78,84,15
Westmeath,174,80,94,33.09,41,19,50,46,18
Westmeath,408,201,207,29.93,125,142,51,63,27
Westmeath,134,70,64,15.34,28,11,41,32,22
Westmeath,316,158,158,14.29,70,37,90,83,36
Westmeath,239,119,120,20.11,62,33,51,67,26
Westmeath,280,143,137,24.03,61,28,82,84,25
Westmeath,165,74,91,889.56,30,20,59,33,23
Westmeath,321,170,151,25.64,82,36,86,78,39
Westmeath,221,109,112,35.66,42,25,69,56,29
Westmeath,321,159,162,41.72,82,38,75,71,55
Westmeath,347,183,164,26.35,82,33,107,83,42
Westmeath,341,175,166,29.07,65,57,74,112,33
Westmeath,192,98,94,26.11,41,11,60,46,34
Westmeath,268,131,137,18.68,79,26,69,67,27
Westmeath,306,154,152,36.11,66,40,107,67,26
Westmeath,257,125,132,45.92,71,32,71,52,31
Westmeath,352,177,175,33.37,53,66,56,137,40
Westmeath,407,201,206,39.86,76,53,81,136,61
Westmeath,155,83,72,10.84,50,11,40,32,22
Westmeath,266,142,124,14.76,71,36,69,67,23
Westmeath,276,139,137,52.95,59,46,66,86,19
Westmeath,220,111,109,29.87,46,33,54,60,27
Westmeath,255,121,134,29.45,69,31,61,69,25
Westmeath,310,141,169,14.69,53,44,71,95,47
Westmeath,284,143,141,132.45,84,33,68,69,30
Westmeath,279,129,150,494.66,55,25,127,57,15
Westmeath,339,166,173,34.26,47,38,66,130,58
Westmeath,189,96,93,17.09,33,20,56,51,29
Westmeath,255,121,134,23.73,46,33,70,67,39
Westmeath,231,118,113,26.01,53,24,57,68,29
Westmeath,355,187,168,23.79,78,55,91,82,49
Westmeath,246,131,115,5825.24,78,35,87,37,9
Westmeath,234,117,117,5273.24,74,35,79,35,11
Westmeath,221,101,120,562.34,54,43,61,47,16
Westmeath,315,161,154,227.61,102,40,110,45,18
Westmeath,347,164,183,1125.19,57,48,84,97,61
Westmeath,230,112,118,15.15,73,16,72,42,27
Westmeath,300,150,150,69.03,63,40,67,78,52
Westmeath,219,119,100,32.5,49,17,70,55,28
Westmeath,313,162,151,14.36,92,34,96,60,31
Westmeath,332,155,177,23.95,95,32,107,63,35
Westmeath,276,125,151,22.87,85,44,68,56,23
Westmeath,224,116,108,24.11,64,29,62,51,18
Westmeath,305,158,147,184.94,58,28,65,77,77
Westmeath,327,166,161,19.07,87,38,95,76,31
Westmeath,233,120,113,22.6,55,29,48,72,29
Westmeath,215,97,118,21.65,44,28,63,53,27
Westmeath,295,154,141,115.36,61,26,88,82,38
Westmeath,179,92,87,16.1,43,15,53,42,26
Westmeath,253,132,121,20.77,56,31,61,71,34
Westmeath,290,159,131,13.22,51,34,82,81,42
Westmeath,271,146,125,17.92,47,29,75,77,43
Westmeath,295,149,146,94.56,78,28,105,62,22
Westmeath,319,146,173,322.63,76,30,101,64,48
Westmeath,168,84,84,320.88,59,16,57,27,9
Westmeath,242,116,126,25.29,76,22,77,50,17
Westmeath,272,141,131,24.2,73,20,81,70,28
Westmeath,239,118,121,15.6,59,17,74,50,39
Westmeath,273,135,138,21.04,65,40,78,55,35
Westmeath,250,125,125,13.08,62,19,58,72,39
Westmeath,214,107,107,10.92,44,31,51,61,27
Westmeath,409,199,210,20.69,118,42,116,94,39
Westmeath,236,120,116,14.74,44,27,63,66,36
Westmeath,272,148,124,10.72,70,20,75,68,39
Westmeath,210,104,106,34.03,56,21,47,64,22
Westmeath,199,106,93,18.44,50,23,50,52,24
Westmeath,399,202,197,18.28,103,40,117,89,50
Westmeath,444,218,226,29.94,130,53,125,97,39
Westmeath,195,98,97,36.27,45,22,42,72,14
Westmeath,219,112,107,95.09,31,28,55,75,30
Westmeath,264,129,135,37.77,48,41,60,94,21
Westmeath,162,78,84,152.19,25,17,37,65,18
Westmeath,184,89,95,7.74,29,21,43,51,40
Westmeath,193,97,96,11.7,49,18,53,50,23
Westmeath,251,132,119,16.6,49,30,63,75,34
Westmeath,286,147,139,27.1,82,35,67,71,31
Westmeath,272,139,133,17.89,63,37,73,67,32
Westmeath,263,117,146,42.99,66,27,68,70,32
Westmeath,218,125,93,27.58,53,19,57,69,20
Westmeath,225,102,123,32.94,68,33,50,59,15
Westmeath,264,135,129,12.69,45,27,69,77,46
Westmeath,300,141,159,18.53,80,44,75,61,40
Westmeath,274,132,142,61.68,60,35,61,75,43
Westmeath,314,145,169,30.17,67,54,57,109,27
Westmeath,401,221,180,21.07,101,38,120,106,36
Westmeath,129,64,65,9.03,25,11,33,37,23
Westmeath,222,107,115,1170.26,36,24,91,43,28
Westmeath,292,143,149,797.44,84,25,96,57,30
Westmeath,340,175,165,48.72,83,37,108,77,35
Westmeath,355,179,176,252.06,71,52,148,58,26
Westmeath,314,148,166,35.99,52,44,100,75,43
Westmeath,331,171,160,17.63,70,39,95,80,47
Westmeath,281,136,145,50.04,70,39,75,62,35
Westmeath,169,87,82,14.63,28,19,42,43,37
Westmeath,405,216,189,24.75,92,61,90,114,48
Westmeath,362,190,172,12.64,80,57,71,109,45
Westmeath,365,202,163,15.94,73,48,109,111,24
Westmeath,249,121,128,316.7,63,26,80,40,40
Westmeath,174,84,90,19.86,33,21,44,46,30
Westmeath,221,105,116,23.46,65,26,65,47,18
Westmeath,367,174,193,620.6,101,55,115,71,25
Westmeath,279,130,149,1931.8,96,31,115,32,5
Westmeath,303,149,154,1005.14,75,40,104,59,25
Westmeath,286,132,154,83.71,37,21,64,43,121
Westmeath,219,113,106,57.07,56,27,64,58,14
Westmeath,282,128,154,272.91,85,21,96,49,31
Westmeath,313,159,154,55.54,71,38,85,93,26
Westmeath,217,115,102,18.25,69,20,71,39,18
Westmeath,224,108,116,23.46,59,20,69,55,21
Westmeath,222,113,109,12.6,57,26,60,51,28
Westmeath,224,108,116,758.07,38,24,74,52,36
Westmeath,286,148,138,4078.78,70,28,93,68,27
Westmeath,305,153,152,76.2,80,25,128,51,21
Westmeath,316,161,155,5234.99,106,39,110,59,2
Westmeath,344,167,177,4017.42,116,28,145,46,9
Westmeath,352,180,172,6045.51,109,30,165,31,17
Westmeath,301,146,155,4500.93,114,26,127,30,4
Westmeath,277,127,150,475.92,106,36,85,40,10
Westmeath,425,219,206,47.72,127,52,149,72,25
Westmeath,307,160,147,37.34,47,39,70,88,63
Westmeath,134,56,78,744,24,13,42,33,22
Westmeath,220,109,111,94.96,57,33,59,54,17
Westmeath,227,104,123,2671.06,76,26,80,37,8
Westmeath,117,52,65,162.8,15,10,21,38,33
Westmeath,145,73,72,1768.75,28,14,39,44,20
Westmeath,91,47,44,255.63,18,6,33,19,15
Westmeath,113,58,55,6.26,21,10,35,31,16
Westmeath,262,128,134,22.33,51,28,75,69,39
Westmeath,292,137,155,26.38,92,27,81,71,21
Westmeath,99,54,45,14.13,34,4,40,19,2
Westmeath,214,107,107,11.88,50,25,60,57,22
Westmeath,321,168,153,17.77,62,42,90,89,38
Westmeath,223,122,101,19.58,48,26,58,60,31
Westmeath,305,142,163,81.52,63,42,73,87,40
Westmeath,355,167,188,4003.16,74,39,160,59,23
Westmeath,267,135,132,749.45,60,38,75,55,39
Westmeath,134,70,64,1163.39,15,22,57,28,12
Westmeath,192,98,94,1250.17,28,20,43,54,47
Westmeath,295,138,157,714.59,91,19,158,22,5
Westmeath,225,125,100,606.86,53,31,59,66,16
Westmeath,218,113,105,92.28,58,23,63,48,26
Westmeath,283,132,151,3079.2,71,42,87,56,27
Westmeath,360,172,188,608.82,108,40,181,27,4
Westmeath,189,87,102,113.49,8,9,30,54,88
Westmeath,328,163,165,49.12,88,39,84,83,34
Westmeath,289,149,140,27.44,70,26,89,71,33
Westmeath,158,73,85,996.94,32,13,103,9,1
Westmeath,192,92,100,3955.75,57,16,100,17,2
Westmeath,196,98,98,68.17,40,23,37,61,35
Westmeath,265,141,124,34.33,50,54,52,81,28
Westmeath,392,208,184,214.09,79,50,83,119,61
Westmeath,196,94,102,170.41,26,29,38,70,33
Westmeath,248,124,124,133.88,46,38,46,87,31
Westmeath,354,171,183,223.32,73,44,139,79,19
Westmeath,402,219,183,281.78,107,38,169,71,17
Westmeath,391,201,190,59.23,86,56,92,130,27
Westmeath,173,91,82,6.91,38,24,43,47,21
Westmeath,265,128,137,3731.55,75,24,104,50,12
Westmeath,222,116,106,4957.57,85,15,98,22,2
Westmeath,277,130,147,3763.33,88,25,124,32,8
Westmeath,344,158,186,4724.89,126,31,127,52,8
Westmeath,340,169,171,1058.68,103,40,158,36,3
Westmeath,291,152,139,4565.28,96,45,116,32,2
Westmeath,292,135,157,2373.58,95,31,106,38,22
Westmeath,332,156,176,406.26,124,28,152,19,9
Westmeath,238,124,114,1421.1,29,49,58,79,23
Westmeath,202,79,123,79.55,17,7,33,29,116
Westmeath,303,146,157,1893.44,77,27,117,36,46
Westmeath,209,92,117,726.56,30,21,46,70,42
Westmeath,314,154,160,2229.24,84,45,99,67,19
Westmeath,263,135,128,3755.48,44,45,63,85,26
Westmeath,422,211,211,4519.9,165,31,182,36,8
Westmeath,209,103,106,3785.89,64,18,90,21,16
Westmeath,264,121,143,3448.01,64,37,114,37,12
Westmeath,292,142,150,113.78,44,38,68,95,47
Westmeath,264,133,131,603.96,74,30,86,63,11
Westmeath,258,121,137,2417.59,44,52,45,91,26
Westmeath,331,154,177,116.64,58,35,87,63,88
Westmeath,202,103,99,2056.63,54,13,114,18,3
Westmeath,158,81,77,567.3,42,12,66,20,18
Westmeath,346,178,168,1163.67,95,36,134,62,19
Westmeath,299,143,156,117.93,70,48,109,51,21
Westmeath,245,116,129,3429.84,70,25,85,50,15
Westmeath,272,130,142,2285.12,35,44,66,97,30
Westmeath,340,170,170,3624.23,109,35,115,63,18
Westmeath,351,163,188,3402.12,107,33,167,36,8
Westmeath,263,125,138,168.85,60,25,103,48,27
Westmeath,175,89,86,487.82,35,18,97,19,6
Westmeath,276,127,149,7185.63,76,42,70,76,12
Westmeath,362,193,169,733.55,81,38,88,82,73
Westmeath,224,106,118,5000.22,55,17,128,19,5
Westmeath,223,102,121,5880.18,65,25,109,19,5
Westmeath,468,231,237,4516.46,168,50,183,60,7
Westmeath,220,95,125,3665.99,39,37,53,75,16
Westmeath,215,96,119,2057.14,29,27,59,52,48
Westmeath,171,81,90,3135.2,25,32,38,35,41
Westmeath,235,119,116,20290.11,46,39,118,29,3
Westmeath,215,108,107,1003.98,24,27,50,80,34
Westmeath,234,114,120,1919.75,32,46,57,59,40
Westmeath,143,78,65,21852.08,26,35,62,15,5
Westmeath,166,89,77,7731,34,20,84,23,5
Westmeath,116,65,51,769,9,10,52,24,21
Westmeath,202,107,95,1170.8,22,14,60,56,50
Westmeath,195,100,95,3017.36,32,16,73,34,40
Westmeath,222,114,108,3136.79,27,22,69,59,45
Westmeath,334,161,173,397.32,72,36,87,89,50
Westmeath,250,121,129,1004.68,40,31,138,30,11
Westmeath,150,68,82,4405.29,17,24,38,43,28
Westmeath,136,62,74,1394.03,16,9,47,34,30
Westmeath,221,103,118,2504.85,53,28,48,71,21
Westmeath,239,109,130,2029.19,46,9,131,39,14
Westmeath,217,104,113,704.27,53,12,88,39,25
Westmeath,240,114,126,4060.09,43,40,76,63,18
Westmeath,198,84,114,3175.57,23,28,54,45,48
Westmeath,284,138,146,39.85,41,39,58,72,74
Westmeath,321,156,165,17.99,59,36,90,79,57
Westmeath,216,107,109,11.85,50,20,65,58,23
Westmeath,413,210,203,25.49,101,57,115,102,38
Westmeath,222,115,107,24.78,37,25,48,83,29
Westmeath,199,94,105,41.31,33,24,44,69,29
Westmeath,113,56,57,8.36,25,14,30,32,12
Westmeath,328,163,165,12.84,72,36,81,87,52
Westmeath,245,117,128,247.7,48,50,59,67,21
Westmeath,268,140,128,23.74,70,36,68,74,20
Westmeath,297,159,138,15.8,54,33,64,103,43
Westmeath,355,175,180,21.22,82,45,111,83,34
Westmeath,146,74,72,77.99,32,28,37,41,8
Westmeath,172,89,83,12.43,35,20,43,42,32
Westmeath,208,110,98,20.93,64,16,76,36,16
Westmeath,218,110,108,19.98,66,18,64,39,31
Westmeath,327,157,170,27.46,63,40,101,84,39
Westmeath,231,106,125,32.2,51,36,47,70,27
Westmeath,281,143,138,41.21,87,28,83,60,23
Westmeath,243,129,114,13.91,52,20,66,67,38
Westmeath,298,147,151,17.65,61,46,76,92,23
Westmeath,226,112,114,14.03,47,37,51,55,36
Westmeath,362,189,173,25.23,81,54,86,97,44
Westmeath,303,162,141,9.77,62,31,75,83,52
Westmeath,193,101,92,29.93,42,25,51,53,22
Westmeath,197,101,96,18.37,51,13,62,48,23
Westmeath,196,105,91,12.93,32,19,56,55,34
Westmeath,376,206,170,22.62,78,57,96,89,56
Westmeath,289,156,133,24.62,62,29,71,75,52
Westmeath,391,192,199,26.19,95,46,86,104,60
Westmeath,266,128,138,12.87,69,29,70,65,33
Westmeath,143,79,64,10.4,40,12,35,38,18
Westmeath,299,132,167,17.64,67,32,71,93,36
Westmeath,236,118,118,5224.71,53,50,60,59,14
Westmeath,315,151,164,3763.13,84,54,100,63,14
Westmeath,196,104,92,1051.37,31,40,59,43,23
Westmeath,249,128,121,6267.78,79,41,55,65,9
Westmeath,421,201,220,2533.55,176,73,130,39,3
Westmeath,157,79,78,1825.43,17,19,29,43,49
Westmeath,138,70,68,1429.16,11,20,70,27,10
Westmeath,227,110,117,6594.81,68,31,88,32,8
Westmeath,262,127,135,3042.23,23,30,56,91,62
Westmeath,84,42,42,1539.96,2,8,28,20,26
Westmeath,139,61,78,1062.29,15,11,38,36,39
Westmeath,133,71,62,1816.32,17,16,44,30,26
Westmeath,256,106,150,2442.47,93,34,99,26,4
Westmeath,234,113,121,2368.04,57,42,88,38,9
Westmeath,387,198,189,5510.07,117,47,172,45,6
Westmeath,236,118,118,6551.92,82,29,99,25,1
Westmeath,224,109,115,6398.72,68,24,88,37,7
Westmeath,288,133,155,568.5,44,30,107,40,67
Westmeath,211,105,106,675.05,44,25,50,49,43
Westmeath,122,67,55,3689.81,5,8,47,36,26
Westmeath,237,115,122,1172.08,37,31,58,60,51
Westmeath,295,146,149,2090.83,30,39,57,117,52
Westmeath,268,126,142,2616.09,43,27,70,82,46
Wexford,292,158,134,22,69,32,88,64,39
Wexford,258,132,126,387.62,66,35,100,32,25
Wexford,387,184,203,38.57,70,40,73,101,103
Wexford,155,74,81,606.37,41,9,55,25,25
Wexford,83,47,36,138.35,18,13,17,20,15
Wexford,127,67,60,1594.68,22,11,56,33,5
Wexford,210,112,98,3243.39,45,37,58,61,9
Wexford,147,72,75,2423.18,41,10,47,29,20
Wexford,240,118,122,3727.34,64,13,112,43,8
Wexford,143,74,69,2126.36,52,10,62,14,5
Wexford,138,66,72,793.57,32,10,83,9,4
Wexford,197,99,98,1729.3,53,25,74,36,9
Wexford,155,86,69,947.07,33,17,60,30,15
Wexford,104,53,51,419.66,21,12,35,17,19
Wexford,245,115,130,1703.12,74,28,74,51,18
Wexford,166,89,77,712.13,62,15,63,21,5
Wexford,176,71,105,1945.65,32,11,46,17,70
Wexford,92,43,49,408.76,13,16,23,28,12
Wexford,119,56,63,2679.09,35,13,41,20,10
Wexford,371,178,193,112.22,70,38,77,99,87
Wexford,273,137,136,115,47,32,57,81,56
Wexford,290,136,154,861.71,101,24,88,53,24
Wexford,217,103,114,84.89,53,23,54,57,30
Wexford,193,90,103,1231.42,61,12,85,25,10
Wexford,255,127,128,62.5,71,27,61,72,24
Wexford,239,114,125,260.71,69,21,97,39,13
Wexford,183,92,91,131.13,32,18,87,25,21
Wexford,312,144,168,3224.51,91,45,105,50,21
Wexford,211,103,108,1540.36,55,28,61,57,10
Wexford,214,114,100,31.07,38,22,68,61,25
Wexford,125,61,64,62.59,22,19,28,36,20
Wexford,243,123,120,58.59,68,19,64,59,33
Wexford,232,116,116,114.64,45,24,59,79,25
Wexford,113,54,59,9.71,22,13,29,28,21
Wexford,176,83,93,54.29,39,18,46,42,31
Wexford,258,133,125,103.24,42,35,41,93,47
Wexford,402,199,203,33.48,114,32,119,83,54
Wexford,274,134,140,34.46,70,32,84,69,19
Wexford,248,117,131,32.09,64,15,69,66,34
Wexford,308,151,157,40.75,59,36,96,79,38
Wexford,304,147,157,47.24,83,34,80,70,37
Wexford,194,105,89,21.54,52,18,53,47,24
Wexford,240,123,117,39.7,60,25,69,53,33
Wexford,247,119,128,48.56,64,21,73,57,32
Wexford,298,158,140,27.09,64,34,86,74,40
Wexford,285,147,138,21.59,72,43,76,65,29
Wexford,272,132,140,25.05,74,35,61,78,24
Wexford,278,146,132,37.63,70,32,95,57,24
Wexford,328,163,165,34.68,59,49,87,95,38
Wexford,201,93,108,517.68,37,28,75,42,19
Wexford,295,147,148,260.86,70,40,99,60,26
Wexford,214,107,107,23.47,45,19,67,47,36
Wexford,218,110,108,37.08,62,29,63,45,19
Wexford,180,101,79,24.13,47,20,44,48,21
Wexford,193,97,96,36.98,49,23,53,50,18
Wexford,210,105,105,26.25,63,20,57,46,24
Wexford,175,87,88,79.45,36,23,36,38,42
Wexford,244,123,121,58.76,68,30,63,66,17
Wexford,110,52,58,31.22,24,8,23,41,14
Wexford,92,44,48,37.23,21,12,19,30,10
Wexford,165,80,85,93.06,42,19,42,43,19
Wexford,236,114,122,64.94,49,25,54,63,45
Wexford,284,149,135,31.19,55,25,74,83,47
Wexford,256,126,130,50.72,50,28,71,64,43
Wexford,90,45,45,35.97,29,11,20,23,7
Wexford,105,55,50,987.53,21,5,41,24,14
Wexford,166,88,78,692.07,31,15,37,42,41
Wexford,223,115,108,34.81,58,17,67,61,20
Wexford,240,132,108,37.29,62,25,73,55,25
Wexford,442,213,229,49.32,121,49,127,109,36
Wexford,311,149,162,38.34,71,32,93,74,41
Wexford,270,137,133,71.2,87,33,80,58,12
Wexford,203,99,104,31.93,44,33,50,55,21
Wexford,240,125,115,46.67,46,27,72,64,31
Wexford,262,137,125,145.37,77,36,93,41,15
Wexford,244,121,123,25.73,53,37,63,64,27
Wexford,370,197,173,59.37,89,38,116,87,40
Wexford,298,146,152,55.8,81,31,86,80,20
Wexford,305,147,158,50.99,70,33,76,81,45
Wexford,234,119,115,36.75,69,26,62,55,22
Wexford,263,135,128,26.93,52,26,80,63,42
Wexford,266,132,134,34.35,64,22,86,68,26
Wexford,193,98,95,28.01,47,29,47,48,22
Wexford,257,120,137,27.16,63,33,75,58,28
Wexford,237,115,122,44.92,65,29,62,52,29
Wexford,351,187,164,46.07,109,29,90,78,45
Wexford,242,126,116,58.27,60,23,70,59,30
Wexford,257,135,122,53.63,75,35,77,56,14
Wexford,215,115,100,22.49,39,24,65,54,33
Wexford,267,131,136,20.99,51,39,74,70,33
Wexford,161,86,75,51.8,40,25,35,45,16
Wexford,143,63,80,32.96,37,20,37,28,21
Wexford,164,87,77,37.04,35,14,49,48,18
Wexford,230,119,111,21.46,42,15,74,64,35
Wexford,204,104,100,39.9,42,22,55,51,34
Wexford,157,79,78,35.77,32,12,40,40,33
Wexford,230,113,117,44.15,62,27,67,49,25
Wexford,320,157,163,172.52,72,67,76,70,35
Wexford,172,87,85,33.68,18,24,48,52,30
Wexford,92,44,48,7.2,21,15,21,23,12
Wexford,292,157,135,27.37,46,41,73,83,49
Wexford,288,149,139,34.59,78,27,89,67,27
Wexford,217,105,112,27.77,42,38,52,59,26
Wexford,233,118,115,42.21,54,27,71,48,33
Wexford,213,107,106,47.19,38,36,48,59,32
Wexford,246,118,128,521.27,70,36,82,43,15
Wexford,252,123,129,210.83,78,28,82,50,14
Wexford,274,140,134,53.78,64,26,74,84,26
Wexford,273,143,130,30.99,74,24,92,59,24
Wexford,351,169,182,65.11,81,49,101,83,37
Wexford,287,157,130,49.15,79,25,89,59,35
Wexford,201,93,108,56.02,49,35,48,48,21
Wexford,257,132,125,36.47,62,26,79,66,24
Wexford,271,136,135,79.99,65,18,91,56,41
Wexford,327,157,170,67.35,94,31,93,56,53
Wexford,116,60,56,38.25,22,16,24,31,23
Wexford,82,36,46,74.46,13,5,28,25,11
Wexford,217,112,105,14.95,46,24,59,63,25
Wexford,307,141,166,28.79,76,25,85,82,39
Wexford,198,101,97,29.49,39,23,45,63,28
Wexford,319,152,167,109.16,82,23,106,83,25
Wexford,257,131,126,138.36,65,26,66,68,32
Wexford,248,122,126,76.8,53,30,56,87,22
Wexford,425,228,197,155.21,94,54,93,112,72
Wexford,300,148,152,186.29,80,19,90,70,41
Wexford,286,147,139,156.15,62,33,55,98,38
Wexford,208,111,97,28.87,43,31,47,54,33
Wexford,326,166,160,30.25,62,56,71,90,47
Wexford,95,50,45,40.15,20,8,25,26,16
Wexford,152,68,84,23.71,27,16,43,39,27
Wexford,311,162,149,42.89,78,37,90,73,33
Wexford,252,127,125,37.32,55,32,66,73,26
Wexford,284,139,145,91.24,64,33,67,77,43
Wexford,239,118,121,30.33,56,27,67,65,24
Wexford,207,102,105,33.13,41,18,74,42,32
Wexford,222,109,113,31.85,55,17,67,54,29
Wexford,192,102,90,32.67,47,19,55,48,23
Wexford,248,128,120,27.03,56,35,70,61,26
Wexford,229,124,105,30.63,58,24,61,61,25
Wexford,160,83,77,52.35,19,14,47,52,28
Wexford,293,136,157,36.33,54,28,85,83,43
Wexford,334,159,175,120.16,84,59,79,93,19
Wexford,227,109,118,24.3,51,29,64,59,24
Wexford,221,113,108,35.88,56,26,56,59,24
Wexford,206,99,107,24.02,39,30,68,42,27
Wexford,294,137,157,237.8,68,39,72,75,40
Wexford,311,161,150,27.26,65,39,82,86,39
Wexford,252,125,127,134.57,80,39,66,37,30
Wexford,223,110,113,22.93,46,21,65,59,32
Wexford,353,166,187,44.03,84,51,99,94,25
Wexford,237,125,112,19.04,46,27,73,60,31
Wexford,249,120,129,56.42,70,28,68,59,24
Wexford,241,122,119,486.71,62,29,62,68,20
Wexford,214,110,104,31.24,56,30,40,56,32
Wexford,162,74,88,569.69,17,19,37,49,40
Wexford,220,110,110,102.28,40,25,53,72,30
Wexford,105,57,48,76.42,25,11,29,33,7
Wexford,135,67,68,58.38,31,15,33,36,20
Wexford,203,105,98,52.67,45,36,35,65,22
Wexford,107,52,55,359.54,23,16,21,30,17
Wexford,295,142,153,173.32,61,56,76,76,26
Wexford,285,126,159,110.22,58,36,66,93,32
Wexford,384,195,189,222.54,94,57,109,92,32
Wexford,234,121,113,23.51,50,22,62,61,39
Wexford,263,134,129,72.48,58,28,58,76,43
Wexford,204,102,102,31.28,48,18,65,51,22
Wexford,155,75,80,188.91,38,17,47,36,17
Wexford,256,135,121,33.81,59,24,80,59,34
Wexford,324,164,160,29.4,98,29,99,65,33
Wexford,186,95,91,36.5,43,27,48,50,18
Wexford,192,103,89,80.11,41,22,52,48,29
Wexford,376,174,202,70.59,105,35,107,81,48
Wexford,223,111,112,37.84,48,30,64,52,29
Wexford,238,113,125,47.68,39,23,46,67,63
Wexford,259,122,137,42.45,85,22,80,46,26
Wexford,185,105,80,64.44,33,30,31,65,26
Wexford,166,85,81,187.39,27,13,33,56,37
Wexford,205,105,100,54.35,38,29,40,75,23
Wexford,231,115,116,70.15,37,33,39,84,38
Wexford,454,207,247,782.19,156,66,160,50,22
Wexford,93,44,49,2175.85,29,15,35,10,4
Wexford,171,85,86,6192.51,51,23,90,5,2
Wexford,212,106,106,1162.45,59,27,108,12,6
Wexford,178,85,93,4435.14,33,34,89,20,2
Wexford,262,117,145,1174.69,72,25,86,54,25
Wexford,226,105,121,1961.24,63,21,78,48,16
Wexford,197,87,110,1662.84,43,31,78,26,19
Wexford,246,125,121,2364.29,51,24,76,53,42
Wexford,191,85,106,1854.62,59,23,76,25,8
Wexford,356,169,187,1812.68,113,42,146,42,13
Wexford,216,99,117,1527.87,42,37,73,44,20
Wexford,370,182,188,43.48,57,55,88,99,71
Wexford,255,139,116,40.55,57,32,50,80,36
Wexford,382,208,174,324.07,74,54,93,107,54
Wexford,150,71,79,55.27,26,6,32,28,58
Wexford,279,127,152,4815.58,68,45,85,70,11
Wexford,256,131,125,2698.69,91,32,102,21,10
Wexford,312,143,169,2358.33,107,55,87,51,12
Wexford,224,109,115,5567.43,20,19,61,90,34
Wexford,299,142,157,4580.83,33,34,69,98,65
Wexford,240,121,119,1820.26,50,29,76,55,30
Wexford,207,95,112,6439.57,56,40,93,15,3
Wexford,222,108,114,7632.28,65,25,110,19,3
Wexford,320,145,175,6110.25,92,83,85,55,5
Wexford,162,77,85,498.36,20,16,28,37,61
Wexford,198,101,97,5366.44,57,25,72,28,16
Wexford,245,117,128,1407.14,70,23,110,37,5
Wexford,208,94,114,3300.17,29,21,82,40,36
Wexford,173,87,86,3196.66,49,23,58,28,15
Wexford,333,168,165,45.5,55,46,70,122,40
Wexford,260,138,122,393.87,76,33,70,57,24
Wexford,269,135,134,802.08,42,31,55,81,60
Wexford,205,93,112,6084.35,39,36,62,58,10
Wexford,192,88,104,6183.77,32,28,48,66,18
Wexford,140,74,66,854.65,26,19,45,29,21
Wexford,87,41,46,330.85,17,13,42,13,2
Wexford,289,124,165,2239.88,26,18,44,41,160
Wexford,240,142,98,5348.79,24,33,58,67,58
Wexford,187,87,100,8226.29,49,10,63,43,22
Wexford,231,103,128,5189.03,23,30,44,67,67
Wexford,184,99,85,3403.81,11,22,50,52,49
Wexford,144,65,79,776.64,18,11,48,35,32
Wexford,85,42,43,1400.79,9,11,16,30,19
Wexford,181,89,92,1536.11,15,22,66,50,28
Wexford,129,78,51,2204.11,17,14,42,33,23
Wexford,124,58,66,1817.01,20,9,31,35,29
Wexford,185,89,96,1373.72,20,24,57,46,38
Wexford,173,93,80,3955.28,19,22,52,58,22
Wexford,232,125,107,2375.25,42,32,60,60,38
Wexford,294,143,151,48.3,50,46,53,81,64
Wexford,180,91,89,69.93,46,13,48,45,28
Wexford,177,92,85,757.97,55,17,69,23,13
Wexford,320,157,163,694.58,84,57,87,56,36
Wexford,215,111,104,2962.21,33,28,57,61,36
Wexford,327,159,168,381.68,86,47,135,36,23
Wexford,93,45,48,43.2,13,13,15,24,28
Wexford,166,87,79,41.36,30,28,40,48,20
Wexford,205,96,109,34.29,49,18,58,38,42
Wexford,178,88,90,1008.06,45,25,46,42,20
Wexford,112,59,53,397.06,20,13,30,27,22
Wexford,136,67,69,40.99,33,15,34,36,18
Wexford,197,96,101,18.11,41,27,52,49,28
Wexford,104,46,58,197.92,16,20,31,24,13
Wexford,119,55,64,75.64,34,10,35,23,17
Wexford,118,63,55,50.9,29,7,31,28,23
Wexford,377,192,185,36.31,98,36,85,112,46
Wexford,486,228,258,99.39,138,56,115,107,70
Wexford,272,125,147,50.73,86,20,70,71,25
Wexford,292,148,144,54.88,93,18,97,60,24
Wexford,283,147,136,21.78,64,29,84,64,42
Wexford,179,93,86,96.05,25,24,41,50,39
Wexford,275,131,144,5153.67,49,39,94,66,27
Wexford,301,150,151,390.34,87,27,107,52,28
Wexford,158,75,83,433.26,38,8,73,22,17
Wexford,255,121,134,243.85,45,34,41,95,40
Wexford,216,103,113,25.54,48,26,54,59,29
Wexford,168,75,93,454.99,45,15,86,19,3
Wexford,235,108,127,1131.66,62,27,95,41,10
Wexford,360,166,194,2656.79,109,45,141,53,12
Wexford,201,92,109,1957.35,65,23,90,21,2
Wexford,283,126,157,5965.56,79,30,140,24,10
Wexford,344,144,200,514.02,118,25,131,50,20
Wexford,238,116,122,1148.97,69,23,128,18,0
Wexford,301,138,163,3769.1,103,25,146,23,4
Wexford,228,115,113,133.72,42,33,51,70,32
Wexford,238,119,119,4886.56,37,26,66,77,32
Wexford,414,210,204,5222.2,193,22,162,28,9
Wexford,268,124,144,6740.78,66,46,58,77,21
Wexford,262,131,131,387.72,65,31,75,70,21
Wexford,310,147,163,6108.13,81,38,153,35,3
Wexford,224,112,112,8326.52,55,37,121,9,2
Wexford,420,214,206,3908.69,116,49,205,48,2
Wexford,375,172,203,6150.16,124,35,155,46,15
Wexford,121,64,57,3037.99,9,17,32,29,34
Wexford,270,125,145,2693.94,52,26,88,58,46
Wexford,214,106,108,2770.48,29,15,60,44,66
Wexford,244,122,122,2035.84,49,29,56,77,33
Wexford,183,85,98,1806.59,44,16,66,38,19
Wexford,229,109,120,4456.21,42,42,67,61,17
Wexford,126,67,59,2419.31,15,26,40,33,12
Wexford,260,137,123,3803.56,69,32,78,35,46
Wexford,188,87,101,1623.95,37,20,39,57,35
Wexford,212,94,118,748.36,23,17,80,53,39
Wexford,223,108,115,1090.93,26,20,90,45,42
Wexford,176,89,87,1381.33,37,25,39,45,30
Wexford,83,38,45,4570.48,3,8,15,22,35
Wexford,114,65,49,1094.13,11,12,27,32,32
Wexford,287,141,146,5685.98,92,34,94,49,18
Wexford,158,76,82,1171.79,32,12,35,42,37
Wexford,270,146,124,41.18,87,26,85,50,22
Wexford,227,116,111,29.12,67,10,79,47,24
Wexford,205,102,103,36.13,27,15,51,58,54
Wexford,309,154,155,30.47,73,29,81,82,44
Wexford,328,170,158,28.31,72,47,93,71,45
Wexford,233,112,121,24.5,47,28,66,63,29
Wexford,319,168,151,26.54,92,19,89,76,43
Wexford,243,127,116,36.26,64,22,69,58,30
Wexford,265,123,142,28.72,64,29,78,62,32
Wexford,390,193,197,29.43,96,44,105,108,37
Wexford,300,148,152,29.2,66,43,82,71,38
Wexford,247,125,122,30.8,67,17,78,58,27
Wexford,205,95,110,36.18,52,29,60,36,28
Wexford,342,166,176,245.77,74,31,82,69,86
Wexford,242,121,121,24.12,76,17,87,50,12
Wexford,168,93,75,21.57,38,16,46,41,27
Wexford,255,127,128,28.68,72,30,68,59,26
Wexford,210,107,103,33.85,47,24,60,57,22
Wexford,259,132,127,34.04,61,23,85,68,22
Wexford,262,127,135,37.2,49,37,70,83,23
Wexford,372,185,187,24.9,95,50,95,82,50
Wexford,84,41,43,30.83,20,9,19,22,14
Wexford,307,158,149,82.07,79,43,85,78,22
Wexford,150,72,78,44.55,32,14,47,35,22
Wexford,262,129,133,36.22,78,33,73,55,23
Wexford,233,119,114,17.82,51,41,61,57,23
Wexford,364,196,168,36.21,55,56,98,98,57
Wexford,220,112,108,24.56,45,29,64,47,35
Wexford,229,119,110,42.77,52,36,52,68,21
Wexford,188,99,89,9.38,43,25,53,42,25
Wexford,253,133,120,21.92,48,35,59,77,34
Wexford,296,150,146,63.94,77,29,77,76,37
Wexford,191,99,92,24.75,34,20,53,54,30
Wexford,165,86,79,37.83,34,23,41,35,32
Wexford,357,183,174,38.75,85,45,82,103,42
Wexford,285,139,146,41.22,70,44,66,67,38
Wexford,132,62,70,45.6,38,12,43,29,10
Wexford,126,55,71,651.09,33,22,28,27,16
Wexford,215,108,107,50.45,43,19,56,69,28
Wexford,205,110,95,45.91,47,27,38,59,34
Wexford,189,97,92,34.1,36,18,52,57,26
Wexford,227,112,115,60.3,54,24,58,58,33
Wexford,367,179,188,39.2,78,45,104,93,47
Wexford,404,213,191,29.12,94,43,108,106,53
Wexford,274,133,141,112.47,62,34,75,70,33
Wexford,431,210,221,37.01,125,41,154,83,28
Wexford,412,197,215,39.41,115,45,136,84,32
Wexford,250,114,136,306.39,69,32,90,41,18
Wexford,297,136,161,71.4,86,33,112,56,10
Wexford,430,215,215,38.86,111,68,121,82,48
Wexford,200,86,114,265.79,66,20,63,34,17
Wexford,191,94,97,524.3,29,24,48,50,40
Wexford,205,111,94,17.77,47,24,59,61,14
Wexford,218,104,114,49.4,47,9,37,54,71
Wexford,178,91,87,109.82,36,23,43,36,40
Wexford,176,92,84,148.33,41,15,50,53,17
Wexford,165,81,84,146.25,34,20,33,56,22
Wexford,164,82,82,1593.5,37,21,46,33,27
Wexford,190,98,92,52.3,44,25,42,55,24
Wexford,224,113,111,40.52,53,29,56,53,33
Wexford,190,99,91,119.84,52,18,52,49,19
Wexford,144,69,75,2044.96,40,21,70,11,2
Wexford,230,104,126,515.57,55,26,72,55,22
Wexford,188,99,89,41.61,34,19,56,50,29
Wexford,409,220,189,25.74,102,51,108,103,45
Wexford,481,227,254,48.26,101,67,109,140,64
Wexford,260,131,129,33.58,50,40,47,92,31
Wexford,208,106,102,41.98,58,13,63,58,16
Wexford,205,109,96,15.48,34,22,67,49,33
Wexford,238,118,120,20.94,47,30,75,56,30
Wexford,211,106,105,19.83,34,37,52,47,41
Wexford,242,109,133,1292.73,79,21,88,31,23
Wexford,204,97,107,85.45,56,25,50,43,30
Wexford,306,164,142,43.2,71,18,89,72,56
Wexford,215,114,101,49.48,31,30,50,65,39
Wexford,249,118,131,30.03,53,30,63,79,24
Wexford,212,104,108,22,38,21,67,53,33
Wexford,166,87,79,25.26,28,17,40,56,25
Wexford,259,126,133,111.83,56,26,77,75,25
Wexford,146,81,65,30.24,15,19,28,53,31
Wexford,355,188,167,30.36,84,45,110,84,32
Wexford,247,123,124,29.37,56,28,78,64,21
Wexford,233,115,118,232.62,77,25,68,44,19
Wexford,203,104,99,75.29,38,37,38,62,28
Wexford,215,111,104,33.84,60,23,47,62,23
Wexford,277,140,137,29.25,62,31,94,62,28
Wexford,378,195,183,58.39,97,48,92,98,43
Wexford,312,155,157,42.54,72,32,100,82,26
Wexford,264,138,126,47.21,59,28,70,76,31
Wexford,310,162,148,35.7,78,37,105,66,24
Wexford,267,140,127,27.51,64,24,71,73,35
Wexford,177,84,93,229.99,46,17,59,35,20
Wexford,372,184,188,25.61,98,39,114,81,40
Wexford,264,141,123,32.71,70,25,78,51,40
Wexford,189,99,90,13.57,40,32,46,53,18
Wexford,255,137,118,29.43,51,33,60,72,39
Wexford,253,125,128,7748.38,59,28,136,22,8
Wexford,244,118,126,813.76,61,34,75,55,19
Wexford,200,97,103,1230.69,58,27,76,28,11
Wexford,252,127,125,1130.99,48,36,90,64,14
Wexford,292,138,154,6306.15,85,29,138,30,10
Wexford,209,94,115,1525.95,53,25,59,53,19
Wexford,327,163,164,2291.47,68,37,129,59,34
Wexford,223,106,117,1668.09,64,21,106,21,11
Wexford,233,109,124,2207.53,73,31,85,39,5
Wexford,238,121,117,1110.04,89,30,81,33,5
Wexford,214,108,106,557.72,53,29,87,36,9
Wexford,212,105,107,39.3,51,27,59,51,24
Wexford,357,151,206,3336.04,144,49,110,47,7
Wexford,368,179,189,74.17,82,49,93,92,52
Wexford,392,193,199,84.29,84,42,74,92,100
Wexford,253,118,135,1546.94,56,30,81,46,40
Wexford,194,91,103,3422.97,25,16,43,65,45
Wexford,227,106,121,4713.36,31,18,57,64,57
Wexford,438,204,234,3761.5,74,41,87,114,122
Wexford,179,85,94,3896.39,34,21,42,43,39
Wexford,199,109,90,3115.85,25,28,73,39,34
Wexford,120,54,66,1295.64,16,11,69,22,2
Wexford,234,116,118,2382.89,44,39,55,62,34
Wexford,114,64,50,2091.63,15,14,23,42,20
Wexford,156,86,70,974.88,22,11,65,41,17
Wexford,185,96,89,6169.75,48,13,57,35,32
Wexford,182,85,97,2922.33,51,18,55,39,19
Wexford,192,91,101,3394.63,30,25,55,51,31
Wexford,283,137,146,4742.75,76,32,84,63,28
Wexford,219,106,113,3024.78,53,18,64,52,32
Wexford,261,129,132,5961.35,47,38,70,72,34
Wexford,136,68,68,886.11,24,18,24,43,27
Wexford,335,164,171,2255.21,48,57,77,121,32
Wexford,195,98,97,18.8,44,23,54,47,27
Wexford,369,195,174,29.89,66,41,90,123,49
Wexford,501,264,237,59.58,113,53,148,133,54
Wexford,227,128,99,609.63,27,21,57,61,61
Wexford,334,163,171,945.44,80,36,106,70,42
Wexford,215,108,107,56.23,46,24,51,64,30
Wexford,266,141,125,1077.53,92,36,82,37,19
Wexford,331,165,166,930.13,58,51,91,70,61
Wexford,300,154,146,34,52,33,73,97,45
Wexford,268,141,127,31.95,51,26,82,67,42
Wexford,140,76,64,75.99,39,23,46,23,9
Wexford,234,115,119,1898.69,60,36,59,44,35
Wexford,245,120,125,44.22,58,28,53,71,35
Wexford,298,146,152,34.45,95,20,90,62,31
Wexford,161,75,86,26.99,48,17,37,45,14
Wexford,226,115,111,32.5,58,31,63,59,15
Wexford,223,115,108,33.15,55,31,59,55,23
Wexford,202,103,99,65.1,30,17,46,69,40
Wexford,267,137,130,697.72,83,27,89,51,17
Wexford,331,170,161,75.64,71,40,96,96,28
Wexford,321,149,172,46.68,109,32,76,78,26
Wexford,316,155,161,95.72,78,29,84,89,36
Wexford,290,137,153,110.4,77,30,72,87,24
Wexford,275,143,132,23.43,48,39,78,61,49
Wexford,238,122,116,31.46,41,35,57,73,32
Wexford,325,164,161,65.3,77,33,88,58,69
Wexford,235,122,113,21.69,62,23,71,47,32
Wexford,100,55,45,380.5,13,23,50,11,3
Wexford,152,81,71,14545.45,33,23,80,16,0
Wexford,177,86,91,1532.45,44,28,48,39,18
Wexford,197,110,87,718.96,21,21,74,41,40
Wexford,199,107,92,17.84,38,19,62,58,22
Wexford,232,126,106,11.93,59,25,66,44,38
Wexford,297,137,160,48.16,64,37,71,88,37
Wexford,178,89,89,102.35,39,20,41,46,32
Wexford,108,51,57,687.01,24,11,27,25,21
Wexford,123,59,64,1002.64,23,14,30,38,18
Wexford,84,43,41,163.5,14,9,25,24,12
Wexford,82,33,49,1278.41,13,10,10,23,26
Wexford,97,47,50,679.25,11,15,33,19,19
Wexford,323,137,186,952.19,56,14,81,93,79
Wexford,231,119,112,29.34,54,32,58,61,26
Wexford,333,163,170,39.01,102,44,93,71,23
Wexford,162,89,73,2019.5,10,20,37,60,35
Wexford,165,77,88,121.02,30,12,38,50,35
Wexford,119,45,74,379.12,22,15,25,24,33
Wexford,133,64,69,319.28,26,9,40,36,22
Wexford,155,77,78,1906.1,33,11,70,29,12
Wexford,128,57,71,689.08,23,7,39,26,33
Wexford,179,83,96,235.32,45,16,62,32,24
Wexford,290,129,161,2307.87,66,45,77,72,30
Wexford,192,97,95,97.5,41,16,47,66,22
Wexford,129,63,66,696.65,19,8,19,42,41
Wexford,380,198,182,23.95,75,61,87,125,32
Wexford,284,153,131,31.52,69,30,97,60,28
Wexford,305,148,157,46.25,72,23,98,64,48
Wexford,190,91,99,185.81,52,21,61,32,24
Wexford,374,182,192,101.57,111,47,83,89,44
Wexford,302,151,151,27.54,65,31,101,73,32
Wexford,212,100,112,68.01,43,25,51,51,42
Wexford,403,211,192,20.65,100,36,139,75,53
Wexford,162,79,83,23.17,38,13,41,46,24
Wexford,111,59,52,25.71,24,13,25,36,13
Wexford,133,64,69,29.35,41,11,43,18,20
Wexford,254,135,119,39.53,42,42,62,81,27
Wexford,221,116,105,24.92,49,27,56,61,28
Wexford,269,125,144,54.05,74,27,65,69,34
Wexford,200,105,95,27.1,43,20,63,46,28
Wexford,266,143,123,26.92,51,28,71,70,46
Wexford,229,124,105,70.07,56,33,61,61,18
Wexford,345,164,181,169.22,89,48,97,75,36
Wexford,336,163,173,25.81,78,37,85,95,41
Wexford,271,149,122,25.46,62,38,68,78,25
Wexford,324,177,147,41.89,60,42,83,92,47
Wexford,264,122,142,35.26,57,20,77,69,41
Wexford,381,182,199,36.73,104,38,101,97,41
Wexford,228,95,133,107.93,64,29,69,39,27
Wexford,342,173,169,36.71,74,41,94,88,45
Wexford,388,193,195,24.37,103,31,99,105,50
Wexford,301,159,142,30.93,60,32,90,83,36
Wexford,187,87,100,32.67,33,25,48,53,28
Wexford,197,93,104,40.79,38,30,53,53,23
Wexford,210,99,111,22.24,56,38,53,46,17
Wexford,221,107,114,31.51,51,33,54,55,28
Wexford,285,149,136,35.63,78,23,88,54,42
Wexford,249,120,129,24.76,64,34,71,48,32
Wexford,339,151,188,4311.66,103,35,160,35,6
Wexford,456,215,241,6393.27,156,74,130,91,5
Wexford,321,166,155,5059.42,102,38,125,42,14
Wexford,278,141,137,5250.24,81,32,138,24,3
Wexford,223,102,121,6723.15,56,27,90,43,7
Wexford,292,127,165,4062.89,68,60,74,71,19
Wexford,229,113,116,3007.38,47,33,61,64,24
Wexford,342,173,169,7496.22,33,30,86,114,79
Wexford,282,139,143,2135.18,31,42,57,81,71
Wexford,214,101,113,324.19,21,24,54,70,45
Wexford,152,75,77,2193.24,32,20,87,13,0
Wexford,242,120,122,7462,38,20,61,60,63
Wexford,266,118,148,3428.94,72,15,90,73,16
Wexford,224,113,111,577.27,16,22,47,82,57
Wexford,320,155,165,1523.32,54,44,73,91,58
Wexford,296,139,157,4757.77,29,44,54,104,65
Wexford,182,88,94,1394.67,32,22,42,50,36
Wexford,260,119,141,2874.87,65,22,81,54,38
Wexford,227,102,125,2245.57,26,27,49,72,53
Wexford,344,168,176,604.16,99,38,149,41,17
Wexford,217,104,113,3358.41,73,13,87,33,11
Wexford,292,140,152,6217.79,51,39,83,96,23
Wexford,323,151,172,3009.47,77,43,95,79,29
Wexford,260,136,124,5292.08,38,35,63,102,22
Wexford,239,109,130,1594.33,62,35,98,34,10
Wexford,345,161,184,349.61,81,54,123,62,25
Wexford,154,65,89,3496.11,48,12,79,13,2
Wexford,298,139,159,966.44,56,50,151,35,6
Wexford,150,70,80,6629.83,41,19,74,13,3
Wexford,164,83,81,5278.23,42,12,87,22,1
Wexford,361,177,184,621.29,90,43,121,82,25
Wexford,191,97,94,420.07,47,12,82,27,23
Wexford,270,109,161,158.8,28,15,42,65,120
Wexford,237,109,128,4791.36,57,26,116,26,12
Wexford,205,110,95,241.81,25,27,27,88,38
Wexford,239,112,127,6255.56,60,25,107,36,11
Wexford,287,134,153,8601.57,90,32,127,30,8
Wexford,264,139,125,4341.25,68,30,121,32,13
Wexford,295,151,144,154.82,65,22,91,78,39
Wexford,350,175,175,5932.4,106,23,192,27,2
Wexford,129,48,81,3113.39,24,7,59,21,18
Wexford,156,61,95,1918.75,17,9,32,38,60
Wexford,218,101,117,1151.67,26,35,45,80,32
Wexford,253,129,124,135.17,59,27,55,84,28
Wexford,258,125,133,1797.9,40,47,88,67,16
Wexford,441,197,244,1192.52,96,41,107,76,121
Wexford,132,75,57,5570.56,9,18,47,30,28
Wexford,155,79,76,4139.74,12,13,35,55,40
Wexford,131,60,71,1921.98,19,11,43,17,41
Wexford,228,102,126,5325.86,25,33,61,59,50
Wexford,320,149,171,1969.01,67,35,107,77,34
Wexford,215,106,109,3881.43,26,20,50,56,63
Wexford,255,116,139,2229.84,31,21,47,70,86
Wexford,252,117,135,29.52,58,36,66,62,30
Wexford,233,124,109,20.68,53,22,70,64,24
Wexford,352,182,170,24.7,98,22,96,94,42
Wexford,234,122,112,28.63,72,14,66,54,28
Wexford,282,155,127,21.42,61,22,80,74,45
Wexford,302,141,161,37.11,88,28,91,70,25
Wexford,377,191,186,16.53,90,46,117,86,38
Wexford,187,82,105,69.55,54,17,60,40,16
Wexford,373,192,181,25.75,115,38,108,76,36
Wexford,148,70,78,3639.22,27,14,77,17,13
Wexford,116,42,74,792.74,26,16,28,25,21
Wexford,108,56,52,1664.48,8,11,17,24,48
Wexford,131,76,55,6314.77,14,15,38,41,23
Wexford,200,102,98,3482.62,34,28,94,29,15
Wexford,251,125,126,8287.11,43,40,81,53,34
Wexford,196,87,109,5740.23,30,24,54,60,28
Wexford,236,136,100,8147.76,37,25,63,71,40
Wexford,162,73,89,3833.32,31,22,37,37,35
Wexford,165,81,84,5198.32,18,20,45,33,49
Wexford,104,56,48,2962.2,15,8,37,30,14
Wexford,137,74,63,7241.01,21,24,38,39,15
Wexford,193,93,100,3336.73,17,23,51,62,40
Wexford,322,151,171,3565.97,59,41,85,106,31
Wexford,195,94,101,6952.37,35,25,54,50,31
Wexford,200,111,89,7430.25,46,33,51,56,14
Wexford,235,112,123,4397.29,43,34,49,70,39
Wexford,181,94,87,3511.97,18,15,71,34,43
Wexford,155,79,76,1415.74,17,15,61,32,30
Wexford,253,123,130,2863.81,13,19,65,70,86
Wexford,244,120,124,5066.13,48,23,52,81,40
Wexford,150,79,71,5589.51,10,10,45,41,44
Wexford,304,153,151,4568.34,45,41,69,96,53
Wexford,265,125,140,2104.13,59,39,83,56,28
Wexford,155,85,70,3375.88,20,25,70,22,18
Wexford,274,132,142,4881.61,69,37,93,49,26
Wicklow,213,116,97,12.85,37,23,58,68,27
Wicklow,363,186,177,18.81,71,40,103,95,54
Wicklow,271,135,136,36.7,76,40,73,59,23
Wicklow,321,177,144,20.49,66,35,106,72,42
Wicklow,275,140,135,11.87,81,23,76,68,27
Wicklow,146,77,69,16.89,20,18,44,39,25
Wicklow,297,147,150,34.03,70,29,105,57,36
Wicklow,366,170,196,6713.63,135,30,168,29,4
Wicklow,401,183,218,5112.25,138,37,172,49,5
Wicklow,354,195,159,4248.27,83,41,101,85,44
Wicklow,316,151,165,7691.93,102,36,133,38,7
Wicklow,331,148,183,6697.96,130,27,150,24,0
Wicklow,240,118,122,4899.86,37,23,67,62,51
Wicklow,248,131,117,2883.29,49,27,101,43,28
Wicklow,150,76,74,1200.07,23,18,45,34,30
Wicklow,267,131,136,4591.97,50,33,74,64,46
Wicklow,187,91,96,5148.68,15,24,34,65,49
Wicklow,200,112,88,889.43,24,27,81,42,26
Wicklow,260,121,139,2112.48,65,48,57,85,5
Wicklow,285,146,139,5202.63,56,34,64,100,31
Wicklow,278,142,136,4290.26,46,27,75,85,45
Wicklow,300,143,157,2565.73,76,45,92,50,37
Wicklow,306,137,169,5363.34,78,27,100,58,43
Wicklow,221,105,116,769.2,76,26,94,21,4
Wicklow,380,164,216,7802.07,124,36,183,33,4
Wicklow,274,133,141,3617.07,86,16,155,13,4
Wicklow,225,109,116,6313.31,32,28,51,81,33
Wicklow,227,120,107,4989.01,39,33,68,70,17
Wicklow,215,106,109,5717.17,25,37,43,68,42
Wicklow,260,132,128,1718.85,91,22,118,23,6
Wicklow,336,156,180,2320.01,88,46,90,75,37
Wicklow,291,136,155,758.39,75,39,79,60,38
Wicklow,196,99,97,1732.37,65,27,56,35,13
Wicklow,283,136,147,3505.38,53,41,85,81,23
Wicklow,392,212,180,2549.61,121,51,133,75,12
Wicklow,204,102,102,6999.97,36,24,59,55,30
Wicklow,347,176,171,3677.6,61,70,82,114,20
Wicklow,209,92,117,3606.81,48,21,70,48,22
Wicklow,179,87,92,183.4,35,16,47,43,38
Wicklow,192,97,95,4360.96,28,22,55,43,44
Wicklow,216,122,94,3363.91,30,17,71,57,41
Wicklow,205,108,97,2443.18,23,23,68,53,38
Wicklow,131,74,57,6811.56,15,16,42,24,34
Wicklow,177,91,86,7261.54,34,26,52,45,20
Wicklow,168,83,85,6363.64,17,32,57,42,20
Wicklow,278,134,144,16.97,54,17,90,71,46
Wicklow,275,137,138,29.93,77,28,81,61,28
Wicklow,219,107,112,581.31,50,15,80,33,41
Wicklow,243,123,120,675.29,45,36,62,82,18
Wicklow,157,73,84,798.51,39,13,46,43,16
Wicklow,310,150,160,1230.9,119,28,102,41,20
Wicklow,278,127,151,3262.72,101,21,100,42,14
Wicklow,378,195,183,20.87,91,26,109,99,53
Wicklow,258,142,116,162.84,65,32,65,66,30
Wicklow,309,148,161,5.93,82,33,90,81,23
Wicklow,255,134,121,18.97,52,28,76,74,25
Wicklow,204,103,101,26.35,49,21,55,61,18
Wicklow,398,205,193,18.57,86,44,114,110,44
Wicklow,230,109,121,13.04,47,32,58,67,26
Wicklow,138,73,65,5.41,36,15,44,30,13
Wicklow,295,143,152,54.78,86,21,101,60,27
Wicklow,284,140,144,234.7,88,31,70,69,26
Wicklow,445,237,208,36.44,102,42,134,111,56
Wicklow,201,110,91,10.9,42,37,39,53,30
Wicklow,269,138,131,19.33,44,32,74,97,22
Wicklow,263,123,140,2342.86,70,46,85,49,13
Wicklow,251,115,136,2810.88,87,19,112,25,8
Wicklow,312,152,160,512.86,119,22,91,52,28
Wicklow,344,154,190,69.05,69,40,99,56,80
Wicklow,267,143,124,53.73,66,35,67,67,32
Wicklow,197,94,103,235.08,38,21,42,52,44
Wicklow,253,127,126,35.1,43,42,54,77,37
Wicklow,281,137,144,2160.13,53,38,97,77,16
Wicklow,242,115,127,2098.13,41,30,69,60,42
Wicklow,204,104,100,396.13,45,20,65,40,34
Wicklow,452,231,221,46.53,118,49,107,110,68
Wicklow,279,135,144,8266.91,44,51,71,93,20
Wicklow,431,216,215,8.46,89,54,105,121,62
Wicklow,242,124,118,267.15,40,30,103,40,29
Wicklow,207,94,113,2763.32,32,24,48,61,42
Wicklow,181,88,93,2121.92,27,24,70,40,20
Wicklow,271,131,140,3899,52,45,62,90,22
Wicklow,334,158,176,1737.16,116,41,108,53,16
Wicklow,437,205,232,6398.71,148,46,174,65,4
Wicklow,199,97,102,6569.39,47,14,108,26,4
Wicklow,340,156,184,295.26,112,28,134,44,22
Wicklow,207,102,105,427.74,54,23,96,28,6
Wicklow,185,92,93,10584.74,45,10,108,18,4
Wicklow,321,158,163,3211.32,81,47,95,85,13
Wicklow,313,148,165,7075.84,93,37,124,50,9
Wicklow,182,91,91,9532.79,18,11,73,41,39
Wicklow,234,102,132,4149.3,51,10,131,34,8
Wicklow,172,82,90,2675.25,16,19,63,29,45
Wicklow,243,122,121,2017.92,47,29,78,63,26
Wicklow,319,162,157,8822.88,39,52,133,70,25
Wicklow,249,117,132,2565.29,18,25,40,83,83
Wicklow,159,71,88,3997.08,19,11,75,27,27
Wicklow,274,124,150,2707.4,60,32,75,59,48
Wicklow,278,141,137,5110.86,39,55,46,97,41
Wicklow,257,113,144,6142.74,36,34,68,65,54
Wicklow,187,91,96,4168.15,30,20,37,58,42
Wicklow,293,153,140,9934.9,39,27,88,81,58
Wicklow,189,100,89,3860.37,24,28,38,60,39
Wicklow,291,132,159,3175.85,28,37,71,87,68
Wicklow,302,153,149,4558.7,42,49,74,91,46
Wicklow,236,124,112,4854.37,40,34,52,69,41
Wicklow,307,155,152,8646.67,57,40,89,75,46
Wicklow,259,133,126,7233.63,51,26,82,61,39
Wicklow,236,109,127,4105.35,36,22,74,47,57
Wicklow,251,127,124,6516.1,39,33,70,63,46
Wicklow,282,134,148,5549.32,43,40,56,98,45
Wicklow,236,115,121,5974.68,35,37,56,77,31
Wicklow,381,191,190,7524.89,101,48,112,106,14
Wicklow,326,161,165,6647.09,77,27,129,71,22
Wicklow,281,142,139,2791.33,93,48,69,68,3
Wicklow,246,127,119,10.98,47,21,76,85,17
Wicklow,306,159,147,5.68,33,52,93,85,43
Wicklow,224,107,117,1588.19,43,35,74,61,11
Wicklow,353,181,172,30.62,87,49,86,99,32
Wicklow,290,134,156,29.44,65,33,94,61,37
Wicklow,311,162,149,1678.95,118,27,113,48,5
Wicklow,235,114,121,876.49,83,17,107,22,6
Wicklow,293,148,145,2481.12,100,18,107,53,15
Wicklow,224,115,109,725.89,69,16,95,36,8
Wicklow,80,43,37,43.72,16,10,41,9,4
Wicklow,302,148,154,8.86,64,28,94,79,37
Wicklow,354,178,176,34.15,68,36,98,105,47
Wicklow,206,109,97,5951.18,40,26,57,63,20
Wicklow,252,135,117,25.94,66,25,70,54,37
Wicklow,208,102,106,1120.04,79,20,81,16,12
Wicklow,171,75,96,3035.2,41,23,46,42,19
Wicklow,215,102,113,201.21,60,23,61,43,28
Wicklow,162,77,85,128.1,22,20,41,36,43
Wicklow,191,102,89,159.92,33,24,46,48,40
Wicklow,290,146,144,18.53,61,38,69,80,42
Wicklow,187,89,98,160.3,41,26,54,45,21
Wicklow,274,149,125,6.93,70,21,78,65,40
Wicklow,277,146,131,29.69,56,39,92,59,31
Wicklow,269,145,124,37.38,77,20,77,51,44
Wicklow,206,102,104,26.9,40,27,59,61,19
Wicklow,272,142,130,46.11,55,42,65,83,27
Wicklow,190,91,99,13.8,40,19,50,48,33
Wicklow,227,110,117,97.78,52,20,48,67,40
Wicklow,197,102,95,39.77,41,18,44,64,30
Wicklow,297,154,143,279.75,63,50,46,103,35
Wicklow,314,142,172,3335.63,69,73,69,91,12
Wicklow,293,134,159,148.28,56,37,60,91,49
Wicklow,308,159,149,4872.72,58,61,54,105,30
Wicklow,289,129,160,1415.93,98,32,104,46,9
Wicklow,385,198,187,4775.02,132,22,168,52,11
Wicklow,189,93,96,2358.61,30,37,45,53,24
Wicklow,262,126,136,5898.91,91,22,103,30,16
Wicklow,286,146,140,5750.02,64,39,80,71,32
Wicklow,249,125,124,3543.37,26,37,49,92,45
Wicklow,294,140,154,3292.35,65,45,86,69,29
Wicklow,257,126,131,1287.15,58,20,119,35,25
Wicklow,197,92,105,4208.86,37,15,56,47,42
Wicklow,278,148,130,8159.43,55,59,64,89,11
Wicklow,283,133,150,1651.11,77,37,55,77,37
Wicklow,354,152,202,2113.82,94,29,115,73,43
Wicklow,355,176,179,1087.23,95,30,127,75,28
Wicklow,338,160,178,1373.73,108,32,107,58,33
Wicklow,396,203,193,22.47,101,38,106,112,39
Wicklow,269,134,135,43.97,61,37,63,81,27
Wicklow,239,117,122,17.87,51,25,66,72,25
Wicklow,316,143,173,24.89,60,13,76,79,88
Wicklow,160,78,82,69.98,40,17,49,32,22
Wicklow,288,155,133,27.43,75,25,77,83,28
Wicklow,216,107,109,89.16,58,26,73,38,21
Wicklow,260,135,125,44.73,71,19,79,57,34
Wicklow,453,237,216,17.9,102,60,104,129,58
Wicklow,521,263,258,51.14,146,60,139,134,42
Wicklow,225,106,119,322.86,66,30,69,39,21
Wicklow,314,159,155,839.81,58,48,74,98,36
Wicklow,267,144,123,40.47,54,37,66,67,43
Wicklow,201,109,92,11.93,55,22,52,51,21
Wicklow,382,193,189,19.3,83,42,93,114,50
Wicklow,235,114,121,43.02,43,34,53,70,35
Wicklow,297,148,149,18.94,63,34,80,77,43
Wicklow,375,184,191,60.91,37,35,118,128,57
Wicklow,270,126,144,176.97,64,42,79,65,20
Wicklow,379,191,188,2125.91,116,82,49,115,17
Wicklow,273,133,140,239.14,80,29,75,59,30
Wicklow,216,103,113,823.65,46,29,43,61,37
Wicklow,323,154,169,267.12,60,36,66,82,79
Wicklow,397,195,202,440.29,87,68,103,96,43
Wicklow,268,139,129,4.33,57,35,69,75,32
Wicklow,338,164,174,77.8,125,19,120,50,24
Wicklow,275,138,137,26.09,58,33,74,78,32
Wicklow,361,196,165,71.16,78,52,92,98,41
Wicklow,345,172,173,4929.7,97,58,106,75,9
Wicklow,375,191,184,839.59,77,53,104,91,50
Wicklow,338,179,159,63.39,70,52,95,89,32
Wicklow,229,119,110,25.78,40,29,72,67,21
Wicklow,489,245,244,94.21,108,51,168,108,54
Wicklow,223,112,111,533.73,56,41,45,68,13
Wicklow,230,112,118,1332.41,39,29,46,66,50
Wicklow,221,114,107,1034.78,34,24,52,62,49
Wicklow,277,129,148,6662.5,66,74,70,58,9
Wicklow,277,133,144,7758.89,66,48,78,74,11
Wicklow,328,169,159,5342.72,48,47,64,125,44
Wicklow,192,93,99,2498.96,32,15,54,47,44
Wicklow,342,170,172,4235.24,50,67,57,142,26
Wicklow,295,152,143,5716.5,66,48,59,93,29
Wicklow,320,141,179,3297.64,70,60,58,101,31
Wicklow,291,155,136,557.34,95,32,63,70,31
Wicklow,188,85,103,4492.34,39,26,43,53,27
Wicklow,278,132,146,4220.69,43,49,50,88,48
Wicklow,263,140,123,2259.97,44,29,42,100,48
Wicklow,321,152,169,2044.05,51,55,83,77,55
Wicklow,267,123,144,1406.25,46,37,77,56,51
Wicklow,325,178,147,3055.8,75,43,66,106,35
Wicklow,300,156,144,2728.76,79,27,97,64,33
Wicklow,289,148,141,6066.33,64,44,69,83,29
Wicklow,297,138,159,5759.27,64,41,69,99,24
Wicklow,288,128,160,515.19,56,32,51,95,54
Wicklow,285,138,147,4102.79,73,38,58,86,30
Wicklow,501,233,268,3377.92,115,41,92,96,157
Wicklow,276,127,149,942.13,56,45,55,74,46
Wicklow,277,120,157,3407.85,48,36,54,74,65
Wicklow,276,135,141,18.96,66,32,70,65,43
Wicklow,381,193,188,18.86,98,49,108,86,40
Wicklow,346,188,158,35.57,87,34,91,89,45
Wicklow,304,155,149,17.68,66,29,86,82,41
Wicklow,235,131,104,4.82,56,20,69,64,26
Wicklow,254,136,118,11.23,46,31,59,76,42
Wicklow,345,177,168,19.61,87,25,108,88,37
Wicklow,529,270,259,12.59,111,63,142,142,71
Wicklow,446,228,218,87.87,79,68,93,122,84
Wicklow,405,248,157,52.52,56,33,152,93,71
Wicklow,284,142,142,37.06,36,32,61,82,73
Wicklow,220,111,109,23.28,51,17,54,63,35
Wicklow,342,175,167,153.48,90,49,60,101,42
Wicklow,254,131,123,150.11,38,44,45,86,41
Wicklow,283,132,151,40.03,52,38,58,101,34
Wicklow,308,151,157,6358.25,95,16,187,7,3
Wicklow,247,131,116,10186.83,69,7,148,20,3
Wicklow,346,164,182,11540.64,67,32,203,41,3
Wicklow,218,100,118,9961.62,66,3,128,11,10
Wicklow,218,101,117,9919.01,66,2,147,3,0
Wicklow,416,206,210,3103.44,85,60,146,102,23
Wicklow,232,120,112,10262.76,63,8,134,20,7
Wicklow,211,95,116,11764.05,36,13,128,26,8
Wicklow,229,108,121,6326.67,80,7,127,6,9
Wicklow,206,98,108,8793.27,57,14,112,21,2
Wicklow,219,108,111,6224.07,32,25,116,33,13
Wicklow,166,84,82,12893.2,15,20,116,12,3
Wicklow,272,129,143,8526.91,99,9,133,26,5
Wicklow,315,145,170,9291.21,83,72,78,68,14
Wicklow,310,145,165,5515.03,122,25,117,43,3
Wicklow,258,122,136,8512.6,94,9,125,22,8
Wicklow,257,138,119,251.59,41,32,56,83,45
Wicklow,248,127,121,798.44,71,23,91,45,18
Wicklow,319,171,148,3500.99,90,18,144,41,26
Wicklow,356,173,183,241.93,130,26,120,49,31
Wicklow,190,100,90,811.62,21,16,105,35,13
Wicklow,264,141,123,222.55,34,40,87,53,50
Wicklow,251,114,137,8987.72,89,6,133,20,3
Wicklow,250,119,131,5213.98,88,10,130,17,5
Wicklow,235,122,113,4082.27,40,22,84,50,39
Wicklow,289,139,150,8839.54,125,29,109,24,2
Wicklow,254,108,146,7068.12,96,28,87,38,5
Wicklow,347,171,176,7151.54,145,23,136,37,6
Wicklow,283,142,141,3285.46,43,47,70,100,23
Wicklow,362,173,189,2783.5,103,45,115,80,19
Wicklow,303,154,149,6568.96,73,47,85,79,19
Wicklow,266,133,133,90.88,60,37,74,77,18
Wicklow,310,153,157,67.27,63,47,100,74,26
Wicklow,340,165,175,19.72,70,44,82,100,44
Wicklow,389,181,208,441.49,88,65,86,113,37
Wicklow,392,190,202,40.14,100,44,97,102,49
Wicklow,257,138,119,19.45,56,27,67,81,26
Wicklow,257,122,135,50.4,48,37,53,81,38
Wicklow,225,117,108,244.63,41,33,45,65,41
Wicklow,245,120,125,35.69,54,19,69,56,47
Wicklow,249,127,122,57.71,54,35,54,66,40
Wicklow,256,123,133,253.13,46,36,58,69,47
Wicklow,423,172,251,5858.32,126,38,213,37,9
Wicklow,237,113,124,5116.36,46,27,86,56,22
Wicklow,336,164,172,6880.59,67,39,123,84,23
Wicklow,259,119,140,2793.6,58,41,87,66,7
Wicklow,320,156,164,7268.43,65,40,108,86,21
Wicklow,328,158,170,6095.75,43,46,83,116,40
Wicklow,289,127,162,10405.79,43,46,75,94,31
Wicklow,271,120,151,3722.32,43,45,68,85,30
Wicklow,270,132,138,3827.13,41,39,65,97,28
Wicklow,265,127,138,6769.01,77,23,103,47,15
Wicklow,277,124,153,16139.37,71,55,85,52,14
Wicklow,232,116,116,9846.36,44,43,71,61,13
Wicklow,222,109,113,3340.76,65,18,86,44,9
Wicklow,321,151,170,3652.25,74,55,95,64,33
Wicklow,543,290,253,356.72,217,89,107,94,36
Wicklow,241,117,124,2207.97,47,43,43,78,30
Wicklow,368,177,191,128.89,102,58,87,87,34
Wicklow,247,118,129,5915.6,76,22,84,50,15
Wicklow,282,150,132,7786.18,63,46,86,74,13
Wicklow,297,137,160,10751.13,52,51,88,88,18
Wicklow,287,139,148,4943.16,86,29,111,53,8
Wicklow,134,58,76,3890.15,17,15,88,13,1
Wicklow,327,162,165,1901.62,83,35,104,90,15
Wicklow,204,105,99,2866.9,51,21,52,54,26
Wicklow,316,158,158,7865.39,45,60,93,99,19
Wicklow,162,90,72,11027.91,20,9,121,12,0
Wicklow,277,146,131,2263.74,80,42,64,71,20
Wicklow,294,149,145,121.98,59,40,94,68,33
Wicklow,354,164,190,6726.97,74,57,107,90,26
Wicklow,310,119,191,7172.77,87,62,97,50,14
Wicklow,254,123,131,1784.17,55,40,84,62,13
Wicklow,288,141,147,6681.82,98,40,99,48,3
Wicklow,368,173,195,9256.93,76,72,101,103,16
Wicklow,332,152,180,4107.59,76,35,102,100,19
Wicklow,199,100,99,3175.01,59,10,102,22,6
Wicklow,261,111,150,9126.51,74,62,60,59,6
Wicklow,321,160,161,3161.53,61,53,97,89,21
Wicklow,343,184,159,6103.85,80,51,99,93,20
Wicklow,321,153,168,3094.57,61,37,91,105,27
Wicklow,367,193,174,6448.78,107,55,104,94,7
Wicklow,346,172,174,427.36,126,19,132,58,11
Wicklow,236,113,123,1132.23,77,41,67,44,7
Wicklow,196,100,96,2184.6,39,26,45,55,31
Wicklow,286,142,144,2382.84,69,43,73,75,26
Wicklow,406,213,193,13.74,93,41,116,99,57
Wicklow,239,129,110,3.37,63,31,67,46,32
Wicklow,228,113,115,4.81,47,24,61,72,24
Wicklow,203,107,96,13.86,49,21,56,42,35
Wicklow,312,160,152,31.73,53,39,82,104,34
Wicklow,155,76,79,4.1,37,28,46,33,11
Wicklow,149,81,68,10.04,26,15,47,43,18
Wicklow,303,157,146,21.7,69,40,76,91,27
Wicklow,330,169,161,26.7,65,42,60,107,56
Wicklow,296,163,133,53.09,62,20,86,104,24
Wicklow,245,127,118,204.09,58,35,55,77,20
Wicklow,221,112,109,64.75,44,20,53,69,35
Wicklow,347,169,178,2798.18,127,26,133,43,18
Wicklow,285,144,141,129.02,41,36,70,94,44
Wicklow,262,136,126,1727.26,57,47,81,64,13
Wicklow,223,110,113,2444.59,58,25,63,59,18
Wicklow,241,125,116,4826.18,43,21,78,58,41
Wicklow,378,186,192,8389.56,94,60,140,74,10
Wicklow,308,147,161,1218.16,106,15,143,26,18
Wicklow,337,175,162,20.98,70,37,109,83,38
Wicklow,333,175,158,49.21,68,47,94,92,32
Wicklow,359,180,179,2222.55,85,57,109,88,20
Wicklow,354,184,170,166.99,78,41,104,98,33
Wicklow,362,197,165,278.95,94,43,79,93,53
Wicklow,326,170,156,1960.97,74,53,67,97,35
Wicklow,276,135,141,4957.34,54,23,94,82,23
Wicklow,310,150,160,1105.23,88,42,100,63,17
Wicklow,301,156,145,30.08,60,42,84,85,30
Wicklow,282,151,131,29.86,55,40,79,70,38
Wicklow,321,166,155,42.3,47,35,90,105,44
Wicklow,361,188,173,50.59,78,43,80,121,39
Wicklow,254,120,134,5.75,48,40,67,83,16
Wicklow,256,123,133,23.82,46,35,65,69,41
Wicklow,261,138,123,16.16,61,23,78,66,33
Wicklow,445,258,187,18.21,92,35,106,111,101
Wicklow,373,190,183,31.83,68,47,91,115,52
Wicklow,398,180,218,355.08,82,52,91,59,114
Wicklow,326,172,154,18.07,74,27,95,95,35
Wicklow,281,137,144,4864.12,58,37,73,85,28
Wicklow,253,131,122,268.04,34,21,71,78,49
Wicklow,205,103,102,1018.63,56,5,109,26,9
Wicklow,310,162,148,100.03,75,36,97,76,26
Wicklow,79,41,38,78.02,19,12,29,16,3
Wicklow,223,108,115,195.22,84,23,75,32,9
Wicklow,269,126,143,17.89,58,22,76,74,39
Wicklow,293,138,155,113.64,88,28,97,57,23
Wicklow,302,154,148,22.85,56,29,91,91,35
Wicklow,212,101,111,93.51,42,38,65,43,24
Wicklow,218,110,108,30.81,48,25,73,50,22
Wicklow,395,205,190,27.02,87,50,117,100,41
Wicklow,419,207,212,23.48,87,51,113,117,51
Wicklow,205,109,96,29.3,37,20,60,59,29
Wicklow,235,108,127,389.01,63,33,75,47,17
Wicklow,281,141,140,18.39,56,31,71,76,47
Wicklow,320,159,161,19.58,66,43,88,74,49
Wicklow,295,138,157,858.95,103,27,85,59,21
Wicklow,200,102,98,203.51,37,17,60,49,37
Wicklow,524,267,257,26.87,150,65,143,133,33
Wicklow,332,185,147,16.38,66,43,91,90,42
Wicklow,276,141,135,49.18,68,24,107,45,32
Wicklow,287,149,138,23.56,65,21,94,70,37
Wicklow,285,127,158,4023.89,102,25,109,41,8
Wicklow,356,186,170,101.77,113,28,139,44,32
Wicklow,348,178,170,17.19,93,41,101,77,36
Wicklow,246,137,109,21.17,68,19,80,49,30
Wicklow,327,151,176,70.64,79,41,60,107,40
Wicklow,339,164,175,59.5,90,27,99,86,37
Wicklow,256,133,123,35.63,73,29,80,52,22
Wicklow,243,125,118,1975.61,44,32,70,65,32
Wicklow,251,138,113,334.23,37,33,65,76,40
Wicklow,240,110,130,4063.66,61,30,80,48,21
Wicklow,387,182,205,3677.69,108,44,177,54,4
Wicklow,378,202,176,2977.36,76,55,101,120,26
Wicklow,402,191,211,3528.82,157,35,130,59,21
Wicklow,323,166,157,2839.81,94,33,90,71,35
Wicklow,290,136,154,5812.79,68,51,71,80,20
Wicklow,287,147,140,4046.59,104,30,103,47,3
Wicklow,242,119,123,319.77,53,22,89,60,18
Wicklow,315,153,162,4718.96,103,30,134,37,11
Wicklow,379,191,188,740.01,118,43,127,79,12
Wicklow,344,168,176,3080.95,108,40,164,28,4
Wicklow,311,138,173,2388.47,113,13,160,24,1
Wicklow,474,215,259,1242.11,184,57,157,70,6
Wicklow,321,168,153,242.59,97,44,71,71,38
Wicklow,277,143,134,803.33,80,44,66,74,13
Wicklow,224,113,111,71.91,38,20,90,60,16
Wicklow,140,72,68,19.83,29,16,39,35,21
Wicklow,202,94,108,818.7,71,14,106,11,0
Wicklow,287,139,148,6088.51,76,28,162,19,2
Wicklow,310,164,146,944.31,42,59,68,118,23
Wicklow,249,122,127,5803.65,49,36,63,53,48
Wicklow,191,95,96,4387.98,48,19,56,49,19
Wicklow,159,79,80,3135.35,14,29,49,43,24
Wicklow,116,69,47,5231.59,9,16,52,20,19
Wicklow,184,80,104,1535.39,23,16,42,56,47
Wicklow,186,80,106,1743.45,24,18,51,45,48
Wicklow,254,130,124,680.41,42,48,67,62,35
Wicklow,394,187,207,4491.21,94,82,121,79,18
Wicklow,258,122,136,2468.43,37,24,67,60,70
Wicklow,245,132,113,4762.65,45,30,59,85,26
Wicklow,312,152,160,6682.37,41,43,88,99,41
Wicklow,170,82,88,2724.05,18,17,42,51,42
Wicklow,249,112,137,1288.68,41,16,64,58,70
Wicklow,375,174,201,7917.24,121,44,125,72,13
Wicklow,314,151,163,6478.9,80,30,115,69,20
Wicklow,401,210,191,6706.47,106,80,109,99,7
Wicklow,216,104,112,3692.88,95,21,79,20,1
Wicklow,372,181,191,4824.53,75,46,132,99,20
Wicklow,255,122,133,974.1,42,27,94,58,34
Wicklow,228,115,113,658.27,67,23,60,56,22
Wicklow,209,100,109,3537.94,44,25,56,57,27
Wicklow,322,166,156,1768.01,58,32,117,69,46
Wicklow,257,125,132,3508.2,35,36,56,84,46
Wicklow,290,143,147,3164.45,67,37,76,61,49
Wicklow,245,124,121,1076.65,39,30,48,68,60
Wicklow,256,119,137,3988.72,79,26,106,30,15
Wicklow,366,171,195,6482.58,83,89,84,90,20
Wicklow,249,125,124,3149.39,71,26,71,59,22
Wicklow,209,90,119,4304.75,78,7,109,14,1
Wicklow,207,96,111,4454.87,64,21,64,46,12
Wicklow,244,121,123,1635.45,27,27,145,38,7
Wicklow,345,164,181,562.91,32,30,93,107,83
Wicklow,244,121,123,1853.67,42,27,45,78,52
Wicklow,213,103,110,2962.37,44,41,50,61,17
Wicklow,289,119,170,2660.92,66,29,77,76,41
Wicklow,331,153,178,323.26,87,47,105,63,29
Wicklow,194,103,91,8489.04,29,17,75,44,29
Wicklow,263,139,124,3612.74,44,30,81,80,28
Wicklow,117,50,67,7696.86,10,11,41,24,31
Wicklow,341,167,174,5860.31,58,51,135,64,33
Wicklow,241,117,124,5278.14,46,37,73,56,29
Wicklow,184,99,85,633.84,28,17,60,50,29
Wicklow,272,146,126,6981.16,46,38,103,55,30
Wicklow,134,69,65,9359.5,11,12,34,52,25
Wicklow,237,112,125,4373.34,28,33,60,68,48
Wicklow,307,148,159,3709.61,62,33,94,86,32
Wicklow,373,182,191,2314.44,49,76,73,124,51
Wicklow,391,187,204,6722.72,41,30,81,82,157
Wicklow,280,125,155,6346.76,46,38,74,84,38
Wicklow,330,174,156,5166.5,28,38,166,53,45
Wicklow,438,211,227,5005.6,64,66,91,120,97
Wicklow,327,154,173,420.87,49,49,72,91,66
Wicklow,214,108,106,6272.72,42,34,62,42,34
Wicklow,210,96,114,3501.98,28,22,82,45,33
Wicklow,242,119,123,3718.56,39,33,107,43,20
Wicklow,275,134,141,4404.02,43,34,105,54,39
Wicklow,211,103,108,2034.26,34,32,58,49,38
Wicklow,381,164,217,3928.48,43,37,119,102,80
Wicklow,218,101,117,4245.21,30,24,62,50,52
Wicklow,164,74,90,12641.64,29,14,97,17,7
Wicklow,243,120,123,6650.61,70,11,104,35,23
Wicklow,291,145,146,3813.44,60,32,62,81,56
Wicklow,305,140,165,4380.61,24,19,46,61,155
Wicklow,257,116,141,2086.73,28,23,82,62,62
Wicklow,191,78,113,1406.22,19,33,30,61,48
Wicklow,307,147,160,4767.67,44,32,91,93,47
Wicklow,176,89,87,14121.8,29,21,108,16,2
Wicklow,403,186,217,8906.67,126,76,112,59,30
Wicklow,243,117,126,5497.24,33,33,57,59,61
Wicklow,329,160,169,6067.54,90,58,91,74,16
Wicklow,369,177,192,7010.28,100,68,108,66,27
Wicklow,358,167,191,8140.25,92,65,107,79,15
Wicklow,274,135,139,6230.39,40,36,68,86,44
Wicklow,228,117,111,10391.98,43,29,56,47,53
Dublin,163,79,84,12683.84,19,17,116,9,2
Dublin,195,97,98,14886.63,28,25,124,14,4
Dublin,203,99,104,10532.87,30,31,129,13,0
Dublin,216,104,112,25040.58,26,11,151,19,9
Dublin,262,124,138,15292.13,36,30,176,18,2
Dublin,230,113,117,13751.87,24,25,162,18,1
Dublin,141,73,68,16404.89,21,18,94,6,2
Dublin,182,86,96,14443.3,32,7,131,12,0
Dublin,"1,049",580,469,140.05,118,134,395,213,189
Dublin,176,85,91,10750.06,43,26,92,13,2
Dublin,356,199,157,39.88,79,45,98,97,37
Dublin,307,138,169,62.57,85,34,104,62,22
Dublin,299,128,171,14140.46,109,26,143,17,4
Dublin,290,149,141,12741.65,116,18,139,16,1
Dublin,235,114,121,11212.9,84,13,116,21,1
Dublin,313,150,163,9166.79,111,11,162,26,3
Dublin,527,258,269,14869.36,240,29,221,36,1
Dublin,220,108,112,12402.75,67,12,123,17,1
Dublin,286,155,131,12908.47,83,16,160,27,0
Dublin,318,159,159,8103.98,114,21,160,19,4
Dublin,203,95,108,11923.64,66,15,107,15,0
Dublin,276,134,142,9452.05,114,16,115,30,1
Dublin,248,128,120,11387.12,100,15,122,9,2
Dublin,189,86,103,9331.49,51,16,107,12,3
Dublin,375,166,209,13462.57,145,33,155,40,2
Dublin,437,209,228,10291.07,183,29,185,39,1
Dublin,283,134,149,9055.71,104,21,143,14,1
Dublin,242,123,119,7876.58,84,14,123,19,2
Dublin,289,140,149,9663.94,85,24,161,17,2
Dublin,313,151,162,6217.35,90,31,162,27,3
Dublin,262,120,142,3792.43,112,16,120,13,1
Dublin,302,152,150,10281.55,100,28,154,17,3
Dublin,348,174,174,12234.14,105,36,184,23,0
Dublin,307,146,161,10096.03,113,28,143,23,0
Dublin,343,167,176,2508.17,58,47,90,120,28
Dublin,156,73,83,12417.42,52,9,87,6,2
Dublin,510,244,266,10531.75,194,38,256,22,0
Dublin,199,94,105,6198.6,53,20,107,19,0
Dublin,441,217,224,2044.06,183,46,156,42,14
Dublin,459,222,237,4723,169,30,220,35,5
Dublin,388,179,209,8063.68,142,20,201,22,3
Dublin,259,122,137,7876.41,88,19,117,30,5
Dublin,233,116,117,5621.64,58,32,74,65,4
Dublin,240,125,115,53.85,44,36,50,85,25
Dublin,283,138,145,8771.93,107,8,133,28,7
Dublin,340,157,183,3112.58,101,31,129,53,26
Dublin,519,259,260,630.13,99,52,122,113,133
Dublin,248,131,117,3018.54,41,53,57,79,18
Dublin,400,179,221,7125.3,129,49,191,28,3
Dublin,303,152,151,6386.61,94,32,124,46,7
Dublin,536,265,271,123.19,182,72,126,132,24
Dublin,247,123,124,1511.19,56,34,58,83,16
Dublin,224,98,126,1336.07,58,15,138,10,3
Dublin,344,165,179,9298.05,124,35,145,37,3
Dublin,295,145,150,8670.61,73,47,73,84,18
Dublin,266,127,139,5301.87,72,63,66,59,6
Dublin,341,157,184,4790.47,146,27,144,20,4
Dublin,341,162,179,7915.87,108,55,89,87,2
Dublin,448,216,232,7280.76,168,30,209,38,3
Dublin,420,193,227,10007.86,160,40,154,56,10
Dublin,435,215,220,6352.41,136,45,143,89,22
Dublin,298,133,165,10128.13,132,18,127,19,2
Dublin,389,185,204,2215.73,138,33,173,40,5
Dublin,250,121,129,1270.38,38,31,62,88,31
Dublin,175,93,82,1268.96,18,17,35,57,48
Dublin,297,135,162,6778.66,92,18,139,34,14
Dublin,186,102,84,1861.84,18,22,70,49,27
Dublin,140,76,64,19577.68,34,14,86,4,2
Dublin,207,108,99,3956.5,33,27,83,40,24
Dublin,140,59,81,11216.15,35,25,61,16,3
Dublin,128,64,64,1717.77,22,11,57,20,18
Dublin,259,137,122,3259.09,28,45,51,113,22
Dublin,338,173,165,4128.85,54,24,97,115,48
Dublin,140,66,74,571.04,22,15,59,20,24
Dublin,182,89,93,1933.06,25,20,39,48,50
Dublin,264,128,136,2042.06,53,39,64,74,34
Dublin,246,132,114,6236.69,27,30,55,95,39
Dublin,251,117,134,7884.9,74,14,135,21,7
Dublin,297,153,144,4408.42,55,40,52,91,59
Dublin,274,136,138,3589.86,52,34,66,78,44
Dublin,338,161,177,4251.25,86,37,90,69,56
Dublin,362,178,184,9171.76,91,62,96,104,9
Dublin,292,160,132,3568.46,45,37,90,80,40
Dublin,223,111,112,3534.24,48,14,61,53,47
Dublin,320,169,151,5785.68,60,53,94,95,18
Dublin,256,123,133,5908.97,57,46,67,67,19
Dublin,298,127,171,4461.41,88,40,101,58,11
Dublin,296,141,155,4411.59,59,25,83,76,53
Dublin,303,158,145,6990.59,42,35,81,79,66
Dublin,264,129,135,1579.54,34,22,67,71,70
Dublin,221,113,108,4522.39,30,13,67,67,44
Dublin,390,187,203,6918.57,112,60,123,83,12
Dublin,226,99,127,3674.92,31,22,60,61,52
Dublin,241,120,121,586.41,32,35,62,63,49
Dublin,151,67,84,3819.5,22,7,106,15,1
Dublin,323,159,164,1477.65,89,15,200,12,7
Dublin,138,66,72,168.98,24,13,89,9,3
Dublin,145,67,78,9713.29,27,6,101,9,2
Dublin,195,98,97,16239.17,33,12,138,10,2
Dublin,205,100,105,11455.07,41,25,132,6,1
Dublin,354,171,183,6121.28,43,39,74,91,107
Dublin,248,124,124,6211.65,36,31,41,67,73
Dublin,305,155,150,8131.82,36,47,88,103,31
Dublin,298,141,157,6860.67,65,33,95,84,21
Dublin,373,168,205,8177.13,102,47,118,77,29
Dublin,289,135,154,3838.39,56,22,89,72,50
Dublin,261,126,135,3899.01,38,34,70,72,47
Dublin,162,70,92,3396.3,18,29,34,52,29
Dublin,318,156,162,7047.4,78,34,98,88,20
Dublin,287,143,144,8164.77,58,32,83,84,30
Dublin,254,146,108,2694.56,44,26,74,48,62
Dublin,261,125,136,7291.11,51,32,79,85,14
Dublin,244,118,126,9514.9,58,38,56,85,7
Dublin,636,306,330,74.7,83,65,188,200,100
Dublin,288,136,152,6212.25,128,13,121,22,4
Dublin,307,154,153,355.72,106,29,97,60,15
Dublin,298,139,159,3947.44,68,17,195,17,1
Dublin,113,52,61,139.59,33,4,37,20,19
Dublin,324,162,162,4731.58,148,19,132,24,1
Dublin,330,176,154,14.87,54,40,89,96,51
Dublin,297,157,140,152.33,95,30,107,45,20
Dublin,177,87,90,2202.12,54,18,81,21,3
Dublin,236,107,129,5106.68,28,30,50,67,61
Dublin,198,99,99,6330.33,37,21,48,64,28
Dublin,358,178,180,10489.92,146,9,165,30,8
Dublin,161,76,85,7662.29,11,8,107,19,16
Dublin,165,73,92,9769.67,15,6,119,16,9
Dublin,168,83,85,19559.9,20,9,119,12,8
Dublin,172,80,92,11687.16,30,7,114,7,14
Dublin,147,76,71,5304.75,18,8,92,21,8
Dublin,315,158,157,5297.95,31,60,44,109,71
Dublin,250,122,128,4033.1,48,40,50,80,32
Dublin,252,117,135,8140.06,56,42,49,83,22
Dublin,362,176,186,2867.15,51,39,81,101,90
Dublin,268,138,130,3350.38,31,31,64,69,73
Dublin,188,87,101,8823.81,33,13,101,19,22
Dublin,367,161,206,8194.89,112,51,119,75,10
Dublin,220,110,110,7628.29,36,12,101,40,31
Dublin,407,204,203,7266.43,79,49,126,99,54
Dublin,338,164,174,3088.82,107,47,97,69,18
Dublin,309,155,154,5652.3,46,40,77,97,49
Dublin,237,111,126,9461.46,63,44,60,62,8
Dublin,174,82,92,2752.51,27,29,39,54,25
Dublin,242,115,127,3522,41,38,73,72,18
Dublin,326,148,178,8288.42,36,47,83,128,32
Dublin,297,136,161,8992.64,42,49,62,101,43
Dublin,370,179,191,9715.11,50,55,73,137,55
Dublin,316,152,164,9060.41,50,48,91,91,36
Dublin,290,147,143,7649.29,40,32,88,102,28
Dublin,440,219,221,2036.45,67,75,111,153,34
Dublin,376,176,200,3501.16,71,53,97,125,30
Dublin,225,112,113,4967.44,44,22,70,50,39
Dublin,276,136,140,4751.74,53,23,90,66,44
Dublin,267,123,144,5886.89,38,34,66,65,64
Dublin,247,121,126,3325.26,29,34,46,58,80
Dublin,246,116,130,4525.97,33,29,52,69,63
Dublin,300,151,149,3777.77,40,27,65,47,121
Dublin,201,97,104,4677.79,39,12,52,29,69
Dublin,270,128,142,4049.31,28,34,57,86,65
Dublin,362,197,165,378.97,54,69,79,121,39
Dublin,275,139,136,3786.63,40,41,42,107,45
Dublin,255,125,130,4470.7,41,33,65,81,35
Dublin,289,141,148,5238.16,36,47,64,108,34
Dublin,281,133,148,7140.5,52,51,61,86,31
Dublin,394,190,204,7204.9,80,65,95,133,21
Dublin,191,95,96,4867.48,25,17,29,76,44
Dublin,291,138,153,6496.26,57,50,75,92,17
Dublin,210,98,112,4539.66,26,30,32,48,74
Dublin,192,96,96,5431.09,25,22,41,44,60
Dublin,260,123,137,3829.78,40,39,62,58,61
Dublin,344,160,184,4192.72,46,34,83,106,75
Dublin,250,119,131,4617.06,40,24,70,59,57
Dublin,274,150,124,4771.19,28,28,65,59,94
Dublin,221,99,122,4473.23,39,27,52,64,39
Dublin,352,165,187,13446.92,122,68,108,46,8
Dublin,234,115,119,2566.18,36,26,64,77,31
Dublin,251,132,119,9432.19,33,36,68,60,54
Dublin,178,82,96,4666.28,21,23,40,46,48
Dublin,235,110,125,3473.35,30,16,58,47,84
Dublin,331,159,172,3391.39,48,42,64,94,83
Dublin,289,140,149,2589.35,46,29,97,83,34
Dublin,255,120,135,5986.06,61,39,61,78,16
Dublin,257,128,129,5869.05,44,44,58,82,29
Dublin,408,184,224,7225.46,109,80,86,114,19
Dublin,191,96,95,3802.58,37,15,34,38,67
Dublin,374,176,198,5032.63,66,62,97,125,24
Dublin,193,85,108,8733.03,30,17,115,29,2
Dublin,225,111,114,3747.63,47,45,61,63,9
Dublin,302,139,163,4882.31,76,53,75,91,7
Dublin,214,108,106,3223.52,34,23,33,49,75
Dublin,327,145,182,4734.6,65,52,129,68,13
Dublin,301,141,160,4320.12,31,41,47,91,91
Dublin,333,166,167,3315.08,42,53,71,119,48
Dublin,314,167,147,8214.09,51,67,51,122,23
Dublin,216,102,114,5666.02,29,42,31,96,18
Dublin,510,253,257,2044.44,115,97,102,184,12
Dublin,376,183,193,6067.65,75,102,67,120,12
Dublin,267,141,126,53.99,62,36,77,61,31
Dublin,450,225,225,42.06,103,56,96,104,91
Dublin,294,148,146,74.61,74,39,72,79,30
Dublin,218,110,108,3997.14,49,23,65,37,44
Dublin,335,156,179,8846.75,75,62,80,54,64
Dublin,304,143,161,1775.43,41,40,66,94,63
Dublin,318,157,161,4938.12,61,44,63,90,60
Dublin,353,181,172,7109.63,48,54,72,109,70
Dublin,298,142,156,5504.55,48,38,80,77,55
Dublin,229,109,120,4832.45,35,18,64,66,46
Dublin,369,192,177,5067.36,67,38,96,102,66
Dublin,427,202,225,8226.41,66,80,77,162,42
Dublin,429,221,208,35.49,94,72,103,119,41
Dublin,238,125,113,61.27,61,24,62,65,26
Dublin,147,60,87,5429.16,23,17,41,43,23
Dublin,176,86,90,3832.84,25,21,55,45,30
Dublin,231,111,120,4734.96,42,11,57,60,61
Dublin,256,122,134,4444.83,40,25,79,64,48
Dublin,345,156,189,3463.58,78,40,82,86,59
Dublin,302,146,156,4325.16,48,35,62,91,66
Dublin,269,115,154,5690.95,77,31,55,70,36
Dublin,287,142,145,4539.13,56,27,61,82,61
Dublin,191,81,110,7738.75,15,12,108,34,22
Dublin,185,81,104,4966.31,29,17,79,40,20
Dublin,244,117,127,4060.44,34,17,89,65,39
Dublin,222,103,119,2652.08,33,22,87,50,30
Dublin,218,78,140,3565.76,25,15,77,63,38
Dublin,180,81,99,3003.4,40,17,49,47,27
Dublin,230,114,116,2143.92,30,42,45,85,28
Dublin,156,73,83,5665.72,27,20,56,37,16
Dublin,190,88,102,2960.47,28,27,38,65,32
Dublin,209,101,108,6983.89,57,14,78,41,19
Dublin,225,109,116,8286.38,54,29,63,56,23
Dublin,248,119,129,4788.85,33,49,69,70,27
Dublin,211,92,119,6028.4,28,45,50,56,32
Dublin,309,147,162,4665.7,43,35,95,65,71
Dublin,184,75,109,10856.74,10,52,98,16,8
Dublin,199,94,105,5439.54,16,18,137,17,11
Dublin,277,127,150,3636.94,21,44,145,51,16
Dublin,167,74,93,5935.67,3,41,87,31,5
Dublin,203,97,106,2936.84,20,13,147,21,2
Dublin,248,111,137,7170.53,49,34,103,46,16
Dublin,369,169,200,6681.15,85,76,99,81,28
Dublin,176,81,95,8357.47,25,24,71,32,24
Dublin,202,84,118,1781.51,27,29,47,56,43
Dublin,246,120,126,4651.6,47,29,77,51,42
Dublin,337,170,167,2304.95,65,59,53,99,61
Dublin,200,91,109,4608.19,33,34,55,39,39
Dublin,226,105,121,4225.56,48,35,37,69,37
Dublin,224,97,127,4921.56,41,31,88,44,20
Dublin,224,103,121,4118.93,36,29,69,48,42
Dublin,285,137,148,6644.44,80,36,92,67,10
Dublin,369,175,194,3477.52,83,50,70,101,65
Dublin,324,142,182,3581.57,66,25,71,73,89
Dublin,258,125,133,3571.03,48,40,116,47,7
Dublin,458,221,237,9394.68,126,72,122,128,10
Dublin,243,124,119,6779.19,44,42,86,56,15
Dublin,217,103,114,4708.38,56,26,74,39,22
Dublin,334,171,163,6087,81,43,131,69,10
Dublin,354,167,187,4343.77,68,53,68,88,77
Dublin,405,175,230,9649.98,25,21,165,53,141
Dublin,289,141,148,3379.88,40,56,52,81,60
Dublin,294,141,153,5514.29,63,53,81,73,24
Dublin,300,149,151,5277.6,46,55,71,101,27
Dublin,584,281,303,2624,82,95,113,184,110
Dublin,235,110,125,4063.42,44,29,44,60,58
Dublin,255,123,132,3599.05,48,32,66,64,45
Dublin,371,163,208,7832.62,87,38,149,88,9
Dublin,305,153,152,6101.71,78,46,85,72,24
Dublin,462,227,235,6609.16,134,93,71,145,19
Dublin,274,128,146,1598.57,10,137,75,18,34
Dublin,289,135,154,3342.78,63,45,52,88,41
Dublin,308,141,167,3384.62,57,41,104,71,35
Dublin,193,90,103,4962.84,42,21,50,44,36
Dublin,277,127,150,4683.25,47,38,99,64,29
Dublin,292,133,159,3801.93,41,44,63,77,67
Dublin,435,196,239,2759.99,78,89,74,129,65
Dublin,193,86,107,7972.9,16,13,107,21,36
Dublin,187,94,93,2116.46,12,22,67,40,46
Dublin,204,86,118,5645.81,18,24,80,30,52
Dublin,114,44,70,1657.65,17,29,25,23,20
Dublin,209,98,111,5399.54,42,42,50,43,32
Dublin,244,120,124,3067.95,54,39,42,72,37
Dublin,399,169,230,8714.83,117,73,110,85,14
Dublin,372,177,195,4501.34,74,84,75,97,42
Dublin,253,127,126,3049.92,42,44,80,59,28
Dublin,283,125,158,3133.13,33,49,55,78,68
Dublin,334,154,180,4622.52,60,41,66,106,61
Dublin,259,134,125,5302.16,55,46,46,72,40
Dublin,248,110,138,4250.07,58,18,63,55,54
Dublin,428,190,238,4609.78,73,51,71,110,123
Dublin,323,153,170,5614.95,58,42,102,84,37
Dublin,289,135,154,3660.41,52,48,55,81,53
Dublin,264,126,138,4729.91,47,25,53,76,63
Dublin,272,136,136,4191.39,44,22,64,54,88
Dublin,384,188,196,4111.79,91,48,79,111,55
Dublin,188,90,98,6616.69,34,4,97,27,26
Dublin,182,73,109,3724.85,13,20,63,63,23
Dublin,291,138,153,3592.28,27,41,50,80,93
Dublin,353,179,174,3463.77,64,54,98,92,45
Dublin,365,174,191,4557.83,58,56,108,90,53
Dublin,225,100,125,3726.46,36,43,54,67,25
Dublin,416,199,217,3368.99,78,58,75,122,83
Dublin,241,104,137,4646.14,38,61,51,64,27
Dublin,345,147,198,2200.63,41,38,76,83,107
Dublin,150,69,81,2921.87,20,15,60,26,29
Dublin,216,102,114,3635.87,44,21,76,46,29
Dublin,214,79,135,6545.54,20,25,112,47,10
Dublin,170,83,87,3800.5,38,17,54,39,22
Dublin,286,133,153,2557.27,41,52,104,49,40
Dublin,203,100,103,4568.88,25,28,102,31,17
Dublin,221,113,108,4361.04,47,38,61,51,24
Dublin,284,153,131,4658.33,19,37,133,63,32
Dublin,525,313,212,1350.07,78,109,73,113,152
Dublin,112,46,66,3920.47,6,7,65,19,15
Dublin,276,116,160,4531.87,42,27,100,61,46
Dublin,247,120,127,2203.82,34,32,57,60,64
Dublin,263,125,138,5479.17,47,38,105,48,25
Dublin,322,153,169,3097.2,60,58,71,78,55
Dublin,240,95,145,1223.35,32,24,101,46,37
Dublin,164,69,95,10394.22,17,15,89,26,17
Dublin,243,102,141,3773.7,57,38,70,35,43
Dublin,307,158,149,1792.77,50,28,115,73,41
Dublin,489,217,272,140.28,111,57,130,73,118
Dublin,314,157,157,2964.92,48,39,130,60,37
Dublin,191,93,98,1305.29,35,14,69,37,36
Dublin,341,170,171,12629.63,101,25,194,18,3
Dublin,192,93,99,1826.78,55,17,113,7,0
Dublin,302,152,150,8835.83,95,19,165,23,0
Dublin,223,105,118,9519.74,42,20,136,22,3
Dublin,243,132,111,13886.51,50,29,148,16,0
Dublin,243,117,126,14909.8,58,26,131,26,2
Dublin,308,156,152,9350.9,79,12,199,17,1
Dublin,199,95,104,6704.17,47,18,114,19,1
Dublin,171,90,81,14336.02,40,6,119,6,0
Dublin,178,83,95,11556.19,36,11,119,12,0
Dublin,183,90,93,12381.6,55,14,101,13,0
Dublin,573,263,310,197.99,57,32,182,97,205
Dublin,413,188,225,6698.67,172,44,161,32,4
Dublin,300,148,152,3570.37,84,25,117,64,10
Dublin,258,114,144,2043.66,35,57,64,89,13
Dublin,305,144,161,4196.65,34,82,58,119,12
Dublin,321,159,162,3120.78,69,51,116,69,16
Dublin,285,139,146,5503.74,82,40,80,73,10
Dublin,294,146,148,8339.72,60,37,93,89,15
Dublin,337,148,189,8556.99,82,79,68,94,14
Dublin,287,145,142,6572.02,57,57,73,77,23
Dublin,245,133,112,9255.06,49,43,74,69,10
Dublin,308,158,150,7223.43,59,54,92,81,22
Dublin,352,177,175,7515.59,90,60,105,92,5
Dublin,246,117,129,8280.32,56,41,53,80,16
Dublin,328,159,169,10052.1,88,62,104,67,7
Dublin,382,198,184,10252.83,109,60,130,76,7
Dublin,351,166,185,11000.72,94,54,115,77,11
Dublin,231,109,122,11726.48,44,51,56,68,12
Dublin,288,147,141,7030.22,36,51,87,96,18
Dublin,225,113,112,836.49,47,31,71,62,14
Dublin,371,186,185,8675.32,65,67,99,120,20
Dublin,225,110,115,8009.97,41,46,55,77,6
Dublin,238,121,117,2549.46,33,33,70,89,13
Dublin,251,126,125,7653.84,52,47,86,59,7
Dublin,253,124,129,7754.55,27,47,81,82,16
Dublin,266,124,142,6453.8,50,44,84,79,9
Dublin,299,158,141,6061.59,46,55,74,100,24
Dublin,291,148,143,7586.62,112,19,121,37,2
Dublin,270,145,125,8356.8,50,53,76,82,9
Dublin,224,107,117,6937.13,30,31,64,79,20
Dublin,313,164,149,8466.55,101,43,116,48,5
Dublin,296,151,145,5826.89,82,38,104,63,9
Dublin,269,130,139,7383.21,97,19,128,21,4
Dublin,290,148,142,6903.78,113,16,144,17,0
Dublin,410,202,208,7226.96,156,45,165,44,0
Dublin,335,167,168,8312.45,133,42,118,35,7
Dublin,293,159,134,2414.4,91,44,119,36,3
Dublin,361,197,164,4784.94,127,30,156,43,5
Dublin,362,179,183,8849.99,148,31,160,23,0
Dublin,329,154,175,9274.92,134,27,147,19,2
Dublin,278,139,139,830.84,116,27,116,18,1
Dublin,272,132,140,9038.65,109,17,125,19,2
Dublin,310,159,151,9802.68,124,15,143,22,6
Dublin,255,127,128,4584.35,84,17,122,30,2
Dublin,272,130,142,8204.63,115,16,114,25,2
Dublin,344,170,174,7125.55,115,44,113,64,8
Dublin,333,162,171,8663.08,117,28,149,37,2
Dublin,426,212,214,8490.96,147,45,178,51,5
Dublin,342,182,160,9598.11,126,44,136,35,1
Dublin,306,148,158,8124.04,101,32,138,34,1
Dublin,218,96,122,8907.05,56,31,75,45,11
Dublin,414,205,209,7638.24,150,37,173,52,2
Dublin,382,209,173,9383.9,149,26,162,39,6
Dublin,311,155,156,7069.95,114,36,126,32,3
Dublin,284,141,143,7232.17,58,55,71,95,5
Dublin,256,127,129,7566.13,57,48,64,80,7
Dublin,284,123,161,8354.17,77,49,83,68,7
Dublin,300,136,164,6774.3,60,54,88,89,9
Dublin,212,111,101,6061.47,41,31,54,62,24
Dublin,248,119,129,5712.18,71,31,75,58,13
Dublin,398,194,204,7511.42,150,36,155,53,4
Dublin,367,177,190,12683.16,146,34,147,37,3
Dublin,261,135,126,11669.5,93,22,120,25,1
Dublin,310,140,170,11150.28,119,22,151,18,0
Dublin,308,158,150,7912.04,106,28,150,24,0
Dublin,289,144,145,7318.49,102,28,126,30,3
Dublin,373,176,197,2298.34,80,22,256,12,3
Dublin,310,148,162,8163.05,132,16,146,14,2
Dublin,317,159,158,7740.01,123,11,149,29,5
Dublin,283,141,142,8780.64,110,22,130,19,2
Dublin,312,147,165,5381.72,114,22,159,16,1
Dublin,291,130,161,6995.53,79,16,178,16,2
Dublin,212,98,114,7757.33,63,12,125,10,2
Dublin,276,132,144,9907.39,89,35,111,38,3
Dublin,346,169,177,10125.25,107,50,140,48,1
Dublin,233,117,116,4057.4,73,11,138,8,3
Dublin,386,182,204,5070.07,121,21,233,10,1
Dublin,353,161,192,5761.1,100,28,210,11,4
Dublin,344,172,172,9599.55,113,23,189,15,4
Dublin,419,210,209,4201.6,164,40,146,67,2
Dublin,285,141,144,3350.02,72,32,148,25,8
Dublin,318,167,151,7774.87,79,52,118,64,5
Dublin,281,143,138,6970.97,85,37,104,51,4
Dublin,311,158,153,3970.48,79,43,131,50,8
Dublin,257,114,143,6374.8,87,28,107,34,1
Dublin,332,161,171,9584.3,111,43,124,52,2
Dublin,254,130,124,1556.39,61,40,81,59,13
Dublin,338,166,172,7933.53,93,51,108,79,7
Dublin,336,166,170,9998.21,87,60,94,91,4
Dublin,350,169,181,9203.02,115,25,153,52,5
Dublin,322,155,167,7658.1,118,20,157,22,5
Dublin,355,190,165,8833.26,137,35,163,19,1
Dublin,279,134,145,8551.99,80,30,144,18,7
Dublin,197,103,94,10795.11,36,16,130,11,4
Dublin,294,141,153,8444.64,62,21,193,17,1
Dublin,263,121,142,6672.08,85,30,108,40,0
Dublin,281,134,147,8136.44,81,22,148,29,1
Dublin,414,206,208,5264.09,143,40,163,58,10
Dublin,490,263,227,9979.63,180,43,213,51,3
Dublin,352,186,166,11117.43,121,37,151,41,2
Dublin,223,103,120,6372.7,52,31,77,50,13
Dublin,289,150,139,8006.65,68,47,102,69,3
Dublin,255,119,136,7996.74,84,33,104,31,3
Dublin,321,156,165,8154.87,85,23,189,22,2
Dublin,257,128,129,9426.7,73,27,135,21,1
Dublin,224,107,117,12750.46,65,27,110,22,0
Dublin,225,120,105,10316.84,43,25,131,23,3
Dublin,294,151,143,2648.58,51,44,69,75,55
Dublin,227,115,112,7728.45,36,51,62,72,6
Dublin,138,74,64,2766.86,30,9,88,11,0
Dublin,306,153,153,11953.13,79,25,187,15,0
Dublin,278,141,137,10413.55,95,14,149,17,3
Dublin,205,96,109,2219.05,77,12,105,11,0
Dublin,203,100,103,14496.89,56,12,120,15,0
Dublin,180,82,98,10212.77,58,15,91,14,2
Dublin,350,173,177,5477.05,112,28,193,16,1
Dublin,320,164,156,5267.06,96,35,166,23,0
Dublin,352,156,196,6124.93,102,16,198,30,6
Dublin,256,133,123,4343.84,75,23,145,13,0
Dublin,339,170,169,7494.2,62,87,98,81,11
Dublin,252,130,122,7182.56,85,17,117,25,8
Dublin,277,136,141,9092.4,94,27,131,22,3
Dublin,290,139,151,7858.44,98,29,132,31,0
Dublin,285,138,147,6725.35,49,53,70,99,14
Dublin,273,139,134,2456.27,55,40,75,80,23
Dublin,299,159,140,8852.96,78,50,90,67,14
Dublin,467,213,254,2561.89,144,67,135,96,25
Dublin,283,138,145,4764.63,72,41,102,54,14
Dublin,250,135,115,3900.16,34,38,65,68,45
Dublin,242,120,122,4290.55,30,33,71,58,50
Dublin,291,143,148,6264.8,41,41,87,57,65
Dublin,327,171,156,5973.15,65,57,97,79,29
Dublin,328,221,107,338.25,33,38,199,45,13
Dublin,359,178,181,8477.78,133,32,158,29,7
Dublin,259,128,131,7800.5,95,15,105,43,1
Dublin,441,222,219,6490.93,99,80,117,119,26
Dublin,325,164,161,10735.28,68,54,96,91,16
Dublin,341,157,184,10234.4,107,54,93,74,13
Dublin,195,101,94,7723.38,58,15,101,20,1
Dublin,275,121,154,9045.76,79,35,75,72,14
Dublin,472,223,249,9331.94,128,78,141,109,16
Dublin,299,143,156,8641.87,87,43,109,57,3
Dublin,395,193,202,9435.77,100,70,105,109,11
Dublin,237,114,123,3472.78,42,31,81,70,13
Dublin,284,125,159,6332.08,80,64,68,60,12
Dublin,304,151,153,9236.47,52,62,75,93,22
Dublin,208,105,103,4994.84,45,28,99,36,0
Dublin,227,114,113,2990.15,56,34,81,39,17
Dublin,337,170,167,2607.59,89,55,161,27,5
Dublin,333,171,162,7373.95,83,60,87,86,17
Dublin,233,113,120,17872.21,60,29,126,17,1
Dublin,181,92,89,13533.72,51,15,100,10,5
Dublin,191,96,95,9488.8,42,20,116,12,1
Dublin,312,155,157,7248.57,85,46,101,68,12
Dublin,402,209,193,6500.96,107,54,172,58,11
Dublin,345,178,167,7851.26,61,58,91,109,26
Dublin,272,135,137,4809.31,46,38,74,83,31
Dublin,272,120,152,6028.5,36,32,78,92,34
Dublin,297,154,143,7422.4,44,34,88,98,33
Dublin,254,124,130,1112.02,41,25,66,87,35
Dublin,308,145,163,4791.54,62,37,88,93,28
Dublin,463,193,270,8314.33,194,69,131,61,8
Dublin,349,181,168,6978.6,106,84,86,69,4
Dublin,339,166,173,5317.23,65,54,100,97,23
Dublin,335,146,189,1813.96,60,55,79,119,22
Dublin,327,151,176,8233.04,79,54,96,83,15
Dublin,291,141,150,4195.99,60,30,104,81,16
Dublin,281,147,134,507,50,43,80,88,20
Dublin,295,140,155,5411.16,38,39,83,111,24
Dublin,265,133,132,5714.53,20,41,54,108,42
Dublin,296,160,136,3150.11,24,44,66,133,29
Dublin,204,94,110,4239.58,19,30,42,70,43
Dublin,205,97,108,2487.65,29,35,45,73,23
Dublin,220,115,105,5705.69,23,29,48,75,45
Dublin,236,116,120,5955.69,22,31,43,90,50
Dublin,378,186,192,4392.03,50,62,71,123,72
Dublin,269,136,133,10193.64,53,25,164,23,4
Dublin,154,66,88,1914.35,38,16,87,11,2
Dublin,244,128,116,8235.45,46,22,160,15,1
Dublin,239,112,127,8536.32,59,26,134,18,2
Dublin,265,145,120,5426.77,32,34,60,82,57
Dublin,255,114,141,5183.03,31,16,55,65,88
Dublin,398,205,193,4385.58,80,40,254,24,0
Dublin,400,192,208,6687.96,117,43,188,46,6
Dublin,453,241,212,9582.43,135,40,232,41,5
Dublin,268,125,143,4390.28,34,26,62,72,74
Dublin,337,156,181,9523.27,131,37,140,28,1
Dublin,304,158,146,5453.7,102,40,131,31,0
Dublin,311,151,160,5359.67,109,23,152,25,2
Dublin,344,170,174,3503.73,125,33,160,22,4
Dublin,281,140,141,3540.07,81,26,138,35,1
Dublin,255,119,136,9511.73,99,22,114,18,2
Dublin,236,114,122,8594.95,73,20,122,19,2
Dublin,199,93,106,7267.81,57,20,98,14,10
Dublin,358,173,185,11269.91,95,81,97,80,5
Dublin,251,122,129,4578.87,62,29,101,54,5
Dublin,523,257,266,406.17,160,97,159,97,10
Dublin,199,88,111,7428.7,69,9,91,23,7
Dublin,268,115,153,10110.54,91,19,121,33,4
Dublin,262,123,139,3069.93,22,38,53,85,64
Dublin,367,183,184,6488.46,28,46,91,134,68
Dublin,285,120,165,2616.19,51,37,77,79,41
Dublin,197,101,96,5756.87,9,24,46,76,42
Dublin,280,141,139,4495.03,22,45,63,86,64
Dublin,291,141,150,2286.69,29,23,54,82,103
Dublin,554,273,281,149.02,191,65,229,53,16
Dublin,295,142,153,4654.61,101,58,66,64,6
Dublin,317,152,165,13159.53,112,66,84,53,2
Dublin,361,161,200,10258.6,141,67,114,28,11
Dublin,291,133,158,7077.36,76,67,72,66,10
Dublin,294,123,171,5758.04,115,57,81,34,7
Dublin,401,214,187,14.45,92,37,116,100,56
Dublin,226,116,110,47.59,43,27,58,68,30
Dublin,262,122,140,3045.34,91,19,110,36,6
Dublin,188,85,103,5068.89,54,24,94,16,0
Dublin,440,240,200,3090.08,164,35,195,39,7
Dublin,475,221,254,991.02,121,40,151,65,98
Dublin,372,187,185,9614.89,143,33,171,24,1
Dublin,233,110,123,8053.64,41,38,61,81,12
Dublin,379,186,193,4088.81,78,64,114,107,16
Dublin,381,187,194,8704.79,76,78,102,110,15
Dublin,319,161,158,138.39,57,32,94,78,58
Dublin,372,183,189,46.1,80,47,99,107,39
Dublin,239,110,129,7164.05,87,21,90,31,10
Dublin,305,152,153,3186.34,106,34,97,52,16
Dublin,427,213,214,6313.49,73,72,94,126,62
Dublin,265,120,145,19792.37,49,12,166,20,18
Dublin,187,90,97,5435.1,22,24,65,35,41
Dublin,244,126,118,2655.46,42,29,51,57,65
Dublin,245,115,130,4436.56,42,31,56,46,70
Dublin,324,165,159,2430.46,74,29,75,75,71
Dublin,278,133,145,4215.7,45,50,43,81,59
Dublin,273,127,146,4978.84,49,32,54,50,88
Dublin,238,116,122,4648.89,41,27,55,44,71
Dublin,350,190,160,1830.37,64,40,84,85,77
Dublin,303,145,158,1013.25,57,52,61,78,55
Dublin,194,87,107,811.17,41,21,50,47,35
Dublin,212,108,104,2578.29,30,46,27,69,40
Dublin,469,222,247,4325.69,114,70,111,104,70
Dublin,346,169,177,7229.87,53,33,92,62,106
Dublin,407,215,192,6657.62,69,64,112,96,66
Dublin,442,220,222,9714.5,67,67,118,140,50
Dublin,133,67,66,190.98,12,14,70,24,13
Dublin,316,164,152,2517.09,67,31,154,48,16
Dublin,250,139,111,108.58,50,27,115,37,21
Dublin,243,121,122,155.59,54,42,55,68,24
Dublin,115,54,61,6077.9,19,11,82,2,1
Dublin,292,134,158,16564.56,52,29,196,12,3
Dublin,310,145,165,683.93,78,29,111,58,34
Dublin,217,103,114,10108.07,44,22,116,33,2
Dublin,269,130,139,2800.68,72,28,127,41,1
Dublin,243,116,127,394.76,34,22,170,14,3
Dublin,208,104,104,1083.22,47,32,47,58,24
Dublin,267,130,137,6007.56,49,7,183,19,9
Dublin,208,102,106,2310.26,48,23,101,27,9
Dublin,234,113,121,13246.53,34,17,165,15,3
Dublin,251,127,124,13246.08,49,34,146,19,3
Dublin,250,122,128,5333.45,47,19,163,20,1
Dublin,416,189,227,5597.94,97,71,90,133,25
Dublin,319,155,164,6419.42,68,33,109,89,20
Dublin,266,122,144,4677.75,54,54,40,92,26
Dublin,345,166,179,8328.71,114,29,102,67,33
Dublin,373,178,195,4831.73,63,72,68,96,74
Dublin,212,107,105,1633.99,39,35,42,53,43
Dublin,361,158,203,1774.76,56,47,67,69,122
Dublin,306,155,151,2796.23,45,41,55,87,78
Dublin,242,119,123,6778.14,34,38,60,64,46
Dublin,238,117,121,2677.65,39,35,56,59,49
Dublin,257,122,135,5171.34,36,41,51,90,39
Dublin,281,146,135,3082.12,28,45,68,84,56
Dublin,381,201,180,1487.84,57,60,105,92,67
Dublin,291,140,151,3652.11,53,25,117,65,31
Dublin,314,149,165,1354.03,49,33,72,77,83
Dublin,231,114,117,5942.12,37,32,51,76,35
Dublin,263,130,133,8567.61,63,9,173,18,0
Dublin,238,104,134,6314.84,58,15,153,11,1
Dublin,278,133,145,3054.78,48,39,177,12,2
Dublin,389,192,197,252.41,74,48,114,114,39
Dublin,315,153,162,3097.56,25,70,51,137,32
Dublin,217,93,124,6082.35,32,24,89,51,21
Dublin,294,153,141,6270.13,65,43,91,85,10
Dublin,242,120,122,9456.45,45,37,68,76,16
Dublin,264,130,134,8894.58,43,53,66,86,16
Dublin,234,120,114,6474.64,42,36,61,86,9
Dublin,307,161,146,9200.43,80,51,80,86,10
Dublin,210,109,101,2644.84,44,25,53,68,20
Dublin,357,174,183,8983.62,65,61,102,101,28
Dublin,272,132,140,8298.5,50,54,78,72,18
Dublin,226,103,123,7876.21,46,32,62,75,11
Dublin,309,132,177,8180.66,67,65,81,87,9
Dublin,229,119,110,6694.93,51,38,63,72,5
Dublin,223,106,117,4328.5,34,46,46,79,18
Dublin,266,142,124,9311.12,52,70,33,106,5
Dublin,211,95,116,3528.84,39,45,40,81,6
Dublin,255,108,147,3894.02,30,32,70,91,32
Dublin,213,99,114,5448.27,20,44,30,92,27
Dublin,234,109,125,3073.89,17,28,67,64,58
Dublin,228,117,111,1755.9,32,23,47,75,51
Dublin,369,197,172,2155.61,104,69,85,102,9
Dublin,228,104,124,2108.53,76,19,81,42,10
Dublin,472,237,235,5428.53,107,111,99,144,11
Dublin,360,185,175,8500.59,69,92,64,129,6
Dublin,287,139,148,10648.96,64,47,75,92,9
Dublin,337,164,173,6908.85,87,60,62,121,7
Dublin,290,137,153,2936.14,77,54,54,94,11
Dublin,375,180,195,8192.42,120,48,116,87,4
Dublin,282,140,142,6609.94,84,30,103,59,6
Dublin,360,173,187,7979.25,119,29,162,44,6
Dublin,305,147,158,9559.93,92,29,141,40,3
Dublin,410,224,186,9691.07,132,41,157,78,2
Dublin,357,185,172,7866.73,148,28,126,50,5
Dublin,332,163,169,8894.84,126,20,141,45,0
Dublin,338,167,171,6986.07,121,35,124,54,4
Dublin,351,174,177,6674.4,126,31,117,72,5
Dublin,290,149,141,5491.8,99,32,92,61,6
Dublin,264,127,137,668.63,87,33,84,58,2
Dublin,419,220,199,5943.35,135,43,165,67,9
Dublin,302,140,162,8498.66,102,20,154,23,3
Dublin,350,182,168,6069.33,131,28,138,49,4
Dublin,243,114,129,10348.79,58,19,150,14,2
Dublin,243,108,135,10475.04,60,27,126,29,1
Dublin,266,130,136,8892.16,73,12,168,12,1
Dublin,273,130,143,8476.94,64,12,175,17,5
Dublin,309,148,161,7937.32,64,68,72,90,15
Dublin,236,102,134,3778.12,35,28,81,70,22
Dublin,187,91,96,14604.81,27,12,125,19,4
Dublin,193,83,110,1892.18,20,6,139,23,5
Dublin,205,99,106,7268.21,69,14,103,19,0
Dublin,321,153,168,6827.9,59,43,167,44,8
Dublin,289,138,151,2125.33,30,51,47,95,66
Dublin,269,132,137,2001.64,62,46,37,80,44
Dublin,153,74,79,9089.83,23,7,115,6,2
Dublin,241,119,122,6456.8,41,27,158,14,1
Dublin,214,57,157,139.11,21,9,47,89,48
Dublin,163,84,79,4847.87,18,6,104,24,11
Dublin,209,105,104,4603.22,43,18,110,26,12
Dublin,320,157,163,4830.12,64,38,91,77,50
Dublin,385,196,189,1104.7,137,7,170,52,19
Dublin,256,123,133,3663.53,30,44,49,91,42
Dublin,180,90,90,1741.3,19,23,41,62,35
Dublin,186,97,89,2212.28,16,42,59,62,7
Dublin,278,147,131,2414.62,45,51,35,92,55
Dublin,344,174,170,3531.68,42,66,95,93,48
Dublin,317,157,160,3217.88,40,33,76,98,70
Dublin,241,125,116,6447.99,18,48,34,96,45
Dublin,234,117,117,4787.43,27,36,52,85,34
Dublin,261,131,130,6586.58,44,46,57,88,26
Dublin,257,125,132,4967.05,47,29,58,81,42
Dublin,431,224,207,1035.12,69,65,195,94,8
Dublin,294,139,155,5813.61,45,60,60,95,34
Dublin,306,144,162,1931.76,43,30,129,57,47
Dublin,433,203,230,3301.54,52,64,158,120,39
Dublin,445,230,215,523.42,78,74,139,123,31
Dublin,272,136,136,10941.71,31,18,197,22,4
Dublin,145,78,67,16315.97,10,10,118,5,2
Dublin,244,119,125,5319.84,18,16,193,17,0
Dublin,196,88,108,406.53,28,25,45,47,51
Dublin,316,144,172,2358.98,54,30,94,80,58
Dublin,272,134,138,4081.2,50,39,61,67,55
Dublin,171,82,89,2159.5,27,16,42,53,33
Dublin,177,81,96,3492.43,35,10,52,46,34
Dublin,155,72,83,5188.63,36,13,59,25,22
Dublin,225,110,115,4082,44,35,38,72,36
Dublin,212,103,109,4107.41,36,42,40,60,34
Dublin,204,99,105,2507.93,31,33,32,63,45
Dublin,179,86,93,2269.5,22,22,59,44,32
Dublin,294,140,154,2800.91,72,39,66,78,39
Dublin,194,83,111,4561.81,47,16,52,42,37
Dublin,179,93,86,3516.7,35,19,55,42,28
Dublin,333,163,170,4680.98,47,72,85,108,21
Dublin,261,120,141,7888.53,43,27,77,71,43
Dublin,324,162,162,1270.13,55,36,105,75,53
Dublin,182,84,98,6464.22,30,11,56,50,35
Dublin,340,179,161,3834.53,54,39,97,52,98
Dublin,219,111,108,7532.24,24,26,54,51,64
Dublin,321,164,157,9121.39,49,37,111,63,61
Dublin,347,165,182,6733.03,64,49,97,79,58
Dublin,344,178,166,4277.7,62,57,116,71,38
Dublin,229,117,112,4509.47,46,29,62,58,34
Dublin,327,143,184,2859.14,43,28,93,70,93
Dublin,198,94,104,4682.07,28,21,61,50,38
Dublin,294,140,154,4289.34,59,48,63,78,46
Dublin,273,126,147,1189.71,38,30,65,73,67
Dublin,278,130,148,4674.7,49,21,56,71,81
Dublin,187,93,94,563.05,15,19,45,66,42
Dublin,237,124,113,2246.13,52,42,34,72,37
Dublin,230,109,121,2320.4,26,41,41,72,50
Dublin,212,100,112,4533.4,40,25,64,54,29
Dublin,226,111,115,2763.82,39,27,36,57,67
Dublin,225,113,112,4016.64,49,38,70,49,19
Dublin,206,94,112,5230.28,34,27,67,51,27
Dublin,285,128,157,2994.74,62,36,82,74,31
Dublin,359,174,185,7948.98,72,53,123,100,11
Dublin,243,121,122,8982.37,50,42,83,60,8
Dublin,294,152,142,4870.29,51,51,61,107,24
Dublin,333,177,156,8974.05,77,56,112,75,13
Dublin,252,121,131,8269.07,54,42,63,81,12
Dublin,434,236,198,149.03,66,75,134,127,32
Dublin,414,173,241,275.33,190,56,133,32,3
Dublin,241,103,138,13453.92,100,37,77,24,3
Dublin,281,125,156,5208.14,39,32,58,74,78
Dublin,229,101,128,719.96,23,26,42,63,75
Dublin,303,127,176,4139.46,169,12,107,15,0
Dublin,365,159,206,10553.4,176,45,114,28,2
Dublin,334,155,179,5323.64,64,95,72,98,5
Dublin,438,201,237,8003.22,108,109,102,102,17
Dublin,253,130,123,101.28,56,31,127,27,12
Dublin,322,160,162,8774.56,119,38,124,37,4
Dublin,218,96,122,7254.82,69,30,82,35,2
Dublin,227,114,113,9342.33,82,29,99,16,1
Dublin,317,152,165,7501.54,105,54,105,47,6
Dublin,314,144,170,6127.07,98,48,137,26,5
Dublin,245,122,123,8522.33,77,25,105,36,2
Dublin,177,90,87,1139.47,36,17,92,24,8
Dublin,197,94,103,3910.75,25,25,57,36,54
Dublin,287,147,140,4783.65,37,40,91,95,24
Dublin,188,92,96,4367.83,17,23,35,62,51
Dublin,312,152,160,4119.46,39,36,93,93,51
Dublin,290,152,138,4443.76,33,59,75,108,15
Dublin,316,167,149,4214.68,52,48,86,116,14
Dublin,294,149,145,13532.17,80,26,172,16,0
Dublin,225,116,109,2353.26,34,31,65,82,13
Dublin,371,174,197,11931.18,139,45,157,30,0
Dublin,307,141,166,10734.64,119,30,121,37,0
Dublin,233,125,108,4472.94,69,31,97,33,3
Dublin,215,100,115,4082.41,53,35,68,51,8
Dublin,261,126,135,4286.84,75,39,83,58,6
Dublin,340,166,174,3131.13,130,19,176,15,0
Dublin,393,199,194,13489.86,174,25,167,27,0
Dublin,313,151,162,10764.52,75,85,71,74,8
Dublin,335,143,192,6440.2,108,56,117,44,10
Dublin,332,163,169,7817.28,68,46,99,106,13
Dublin,236,104,132,6987.83,49,44,59,73,11
Dublin,301,147,154,2149.29,65,39,78,102,17
Dublin,414,212,202,3893.69,68,49,141,125,31
Dublin,311,139,172,6342.54,77,45,117,58,14
Dublin,297,145,152,4745.93,60,32,105,79,21
Dublin,268,119,149,9318.82,110,28,84,42,4
Dublin,389,191,198,6554.45,98,79,125,80,7
Dublin,234,112,122,7073.55,72,31,67,53,11
Dublin,230,117,113,5473.45,60,45,58,55,12
Dublin,437,212,225,4103.83,99,71,120,126,21
Dublin,214,106,108,1859.77,42,16,138,17,1
Dublin,264,123,141,1867.41,67,61,70,57,9
Dublin,226,109,117,3722.49,30,33,48,64,51
Dublin,189,106,83,1948.15,30,18,83,39,19
Dublin,207,106,101,8614.23,45,33,116,12,1
Dublin,352,170,182,8864.04,63,58,96,128,7
Dublin,266,120,146,2588.3,47,37,99,43,40
Dublin,257,136,121,27949.97,71,25,134,27,0
Dublin,437,193,244,6616.2,140,65,210,20,2
Dublin,352,178,174,1923.85,74,44,102,113,19
Dublin,383,185,198,1211.08,77,47,176,73,10
Dublin,302,160,142,10836.41,42,27,204,23,6
Dublin,228,122,106,7133.02,22,35,54,84,33
Dublin,216,115,101,4845.55,26,35,44,97,14
Dublin,372,181,191,8404.88,79,48,182,57,6
Dublin,411,195,216,3868.24,68,60,88,127,68
Dublin,224,102,122,4946.56,33,29,49,55,58
Dublin,274,139,135,5015.19,40,27,62,65,80
Dublin,364,177,187,3975.1,61,39,85,102,77
Dublin,210,105,105,5887.3,26,25,55,72,32
Dublin,259,135,124,3779.75,28,27,57,70,77
Dublin,320,150,170,12405.02,84,50,114,68,4
Dublin,357,176,181,9023.35,81,43,125,93,15
Dublin,413,204,209,6242.44,117,64,159,66,7
Dublin,440,224,216,9345.99,116,40,201,76,7
Dublin,296,152,144,4818.02,55,61,80,91,9
Dublin,319,151,168,12500.98,86,44,125,54,10
Dublin,397,200,197,10138.67,71,64,130,120,12
Dublin,373,186,187,5645.95,78,72,110,97,16
Dublin,275,121,154,13090.25,62,52,82,72,7
Dublin,201,105,96,21636.17,43,30,113,14,1
Dublin,249,121,128,6033,52,50,85,60,2
Dublin,180,87,93,11707.32,35,30,58,57,0
Dublin,188,87,101,11984.45,45,27,97,19,0
Dublin,195,102,93,8027.33,48,22,74,48,3
Dublin,241,127,114,3449.02,54,30,90,59,8
Dublin,278,124,154,5244.19,48,33,70,71,56
Dublin,358,187,171,9432.47,86,37,141,69,25
Dublin,295,164,131,160.64,74,22,153,38,8
Dublin,306,158,148,356.69,54,30,115,67,40
Dublin,359,176,183,6116.89,67,64,98,114,16
Dublin,452,208,244,3264.79,131,60,138,111,12
Dublin,362,190,172,8608.39,71,70,113,99,9
Dublin,273,131,142,1270.05,75,56,90,46,6
Dublin,290,138,152,6405.73,50,42,83,77,38
Dublin,377,197,180,5232.84,77,73,107,87,33
Dublin,79,45,34,3573.85,1,2,2,29,45
Dublin,610,295,315,2963.15,171,99,177,142,21
Dublin,388,191,197,7782.26,114,65,121,77,11
Dublin,285,138,147,5174.57,88,40,95,61,1
Dublin,282,126,156,3462.2,58,56,83,77,8
Dublin,414,219,195,7882.71,104,88,121,84,17
Dublin,263,127,136,3554.97,77,33,89,62,2
Dublin,275,133,142,2293.56,63,53,79,60,20
Dublin,296,143,153,8813.46,82,52,92,61,9
Dublin,237,123,114,7449.08,46,36,79,50,26
Dublin,301,145,156,5181.17,80,63,100,53,5
Dublin,248,126,122,3088.57,38,42,53,83,32
Dublin,376,190,186,5244.07,74,67,107,104,24
Dublin,274,133,141,4598.24,41,42,83,90,18
Dublin,349,176,173,5931.74,81,50,101,91,26
Dublin,325,150,175,6067.96,70,56,74,93,32
Dublin,358,162,196,4867.77,89,68,92,91,18
Dublin,297,149,148,7641.44,60,65,86,77,9
Dublin,337,157,180,8032.22,81,58,92,83,23
Dublin,419,208,211,6850.21,69,87,108,116,39
Dublin,307,148,159,4929.98,101,40,113,49,4
Dublin,231,113,118,5521.16,57,33,79,48,14
Dublin,236,105,131,9702.35,61,47,84,37,7
Dublin,270,139,131,60.53,41,26,80,80,43
Dublin,407,205,202,3174.65,65,53,123,122,44
Dublin,226,104,122,2810.07,39,14,51,63,59
Dublin,411,201,210,11398.3,135,43,163,66,4
Dublin,294,145,149,8913.68,67,50,94,76,7
Dublin,217,108,109,9189.07,54,31,82,42,8
Dublin,205,104,101,9934.1,43,38,67,54,3
Dublin,247,129,118,7128.63,51,22,99,66,9
Dublin,221,98,123,7773.75,45,15,90,61,10
Dublin,238,115,123,4870.06,50,37,61,69,21
Dublin,348,170,178,11101.19,88,53,102,104,1
Dublin,241,125,116,2972.67,46,35,83,57,20
Dublin,347,171,176,7722.61,70,52,98,106,21
Dublin,331,162,169,9866.75,55,60,118,80,18
Dublin,231,114,117,11812.84,62,38,76,51,4
Dublin,189,91,98,12577.36,50,20,75,36,8
Dublin,204,94,110,2126,24,29,45,47,59
Dublin,228,115,113,11421.13,51,29,76,65,7
Dublin,146,62,84,9894.95,33,15,53,36,9
Dublin,305,146,159,11053.93,82,33,130,59,1
Dublin,325,166,159,5442.06,67,42,126,67,23
Dublin,172,86,86,9456.78,40,17,93,16,6
Dublin,382,193,189,7381.07,113,45,125,92,7
Dublin,377,190,187,11611.08,85,47,134,101,10
Dublin,224,100,124,8434.37,44,36,70,66,8
Dublin,217,100,117,7350.95,36,25,62,74,20
Dublin,214,103,111,6530.16,48,26,81,46,13
Dublin,321,133,188,1779.96,39,53,73,125,31
Dublin,283,139,144,6176.21,38,45,86,94,20
Dublin,393,192,201,11166.04,112,50,153,69,9
Dublin,278,128,150,1160.49,48,22,96,71,41
Dublin,296,163,133,22.95,51,53,63,97,32
Dublin,324,156,168,100,82,34,97,74,37
Dublin,170,87,83,229.62,64,18,63,16,9
Dublin,297,144,153,6087.19,48,75,94,60,20
Dublin,219,104,115,2219.52,51,19,88,41,20
Dublin,363,174,189,3337.29,99,51,59,101,53
Dublin,262,132,130,6866.37,41,81,99,35,6
Dublin,242,120,122,2836.18,45,45,54,73,25
Dublin,132,63,69,4348.69,7,14,67,26,18
Dublin,210,98,112,4476.94,52,28,62,42,26
Dublin,250,119,131,4155.79,66,29,56,57,42
Dublin,189,91,98,238.44,0,182,5,2,0
Dublin,304,161,143,699.58,59,74,66,60,45
Dublin,308,152,156,4902.12,70,68,79,80,11
Dublin,363,156,207,1823.58,28,89,74,61,111
Dublin,547,253,294,2493.13,20,448,39,19,21
Dublin,235,110,125,8297.73,1,228,6,0,0
Dublin,273,126,147,3343.7,47,46,67,82,31
Dublin,177,74,103,1996.12,20,17,87,38,15
Dublin,198,98,100,3701.28,16,32,64,45,41
Dublin,213,102,111,7636.6,34,36,77,44,22
Dublin,164,76,88,2982.85,22,17,49,43,33
Dublin,246,104,142,8798.6,23,40,69,69,45
Dublin,230,102,128,6816.83,20,17,68,61,64
Dublin,223,114,109,1043.47,32,35,50,55,51
Dublin,264,130,134,3229.4,43,39,55,72,55
Dublin,340,179,161,4050.75,58,51,86,84,61
Dublin,229,102,127,4516.94,30,55,52,62,30
Dublin,247,118,129,2427.9,49,44,24,92,38
Dublin,356,149,207,5469.01,94,44,131,64,23
Dublin,285,145,140,4402.16,55,51,57,75,47
Dublin,191,94,97,6865.07,10,62,92,19,8
Dublin,233,109,124,6737.02,30,28,128,30,17
Dublin,188,88,100,13070.99,41,16,101,15,15
Dublin,215,96,119,4226.71,27,27,70,44,47
Dublin,238,99,139,4204.72,32,47,55,63,41
Dublin,295,146,149,4084.57,41,42,92,64,56
Dublin,262,130,132,8204.16,42,26,125,47,22
Dublin,417,240,177,1845.21,64,41,137,103,72
Dublin,251,122,129,5053.86,30,34,85,73,29
Dublin,168,74,94,2760.25,13,26,58,39,32
Dublin,150,70,80,4414.88,18,21,43,38,30
Dublin,239,97,142,2247.95,35,64,46,66,28
Dublin,286,119,167,9397.69,41,122,92,24,7
Dublin,411,192,219,530.3,66,23,103,114,105
Dublin,218,86,132,4968.89,22,13,45,37,101
Dublin,171,73,98,3752.63,30,25,29,44,43
Dublin,153,74,79,2049.29,16,9,44,53,31
Dublin,249,118,131,2807.94,33,24,54,89,49
Dublin,321,158,163,1939.18,42,41,62,101,75
Dublin,183,77,106,3528.66,24,16,50,50,43
Dublin,290,140,150,4379.21,54,52,52,87,45
Dublin,375,176,199,3033.71,70,60,51,119,75
Dublin,391,184,207,4024.7,84,53,66,119,69
Dublin,232,110,122,3858.69,41,32,43,54,62
Dublin,308,142,166,3781.93,68,29,65,72,74
Dublin,338,170,168,3279.77,62,41,65,95,75
Dublin,258,112,146,2983.73,47,49,35,83,44
Dublin,255,122,133,1386.58,41,42,28,74,70
Dublin,330,150,180,3005.03,69,47,57,84,73
Dublin,278,142,136,4324.63,44,36,49,74,75
Dublin,229,114,115,3169.86,29,25,36,75,64
Dublin,217,105,112,1736.94,43,49,30,60,35
Dublin,352,171,181,6777.57,64,35,95,95,63
Dublin,251,112,139,2166.95,46,34,40,81,50
Dublin,210,103,107,2839.45,27,24,55,58,46
Dublin,293,116,177,3134.23,34,10,46,59,144
Dublin,186,83,103,2531.58,23,8,53,55,47
Dublin,192,87,105,4666.2,28,17,53,52,42
Dublin,304,140,164,1637.8,45,46,48,106,59
Dublin,306,154,152,3896.15,58,32,74,78,64
Dublin,234,102,132,5149.99,28,19,77,64,46
Dublin,304,145,159,2704.24,46,33,69,87,69
Dublin,280,143,137,32.45,47,47,65,84,37
Dublin,372,174,198,6274.03,82,74,77,115,24
Dublin,230,115,115,3402.57,46,37,104,33,10
Dublin,376,180,196,6376.45,95,65,96,104,16
Dublin,139,65,74,2692.08,11,23,38,49,18
Dublin,456,215,241,1358.98,152,60,119,101,24
Dublin,305,158,147,7444.11,124,21,111,42,7
Dublin,271,129,142,60.01,63,31,65,77,35
Dublin,384,186,198,2231.75,101,40,129,100,14
Dublin,396,226,170,135.41,31,42,105,156,62
Dublin,191,101,90,138.11,66,11,82,29,3
Dublin,100,56,44,5387.93,10,11,61,13,5
Dublin,141,60,81,3028.03,25,5,95,10,6
Dublin,151,80,71,9877.67,12,10,103,25,1
Dublin,468,237,231,5720.64,174,57,159,69,9
Dublin,365,178,187,5746.4,124,23,154,47,17
Dublin,82,40,42,4304.91,5,7,43,23,4
Dublin,343,163,180,7343.34,136,22,146,34,5
Dublin,322,151,171,6313.11,102,25,109,62,24
Dublin,287,138,149,8029.09,94,6,145,32,10
Dublin,472,230,242,612.97,181,25,217,48,1
Dublin,343,171,172,5976.13,153,12,128,42,8
Dublin,421,208,213,801.83,130,43,135,103,10
Dublin,297,147,150,1924.96,129,13,122,25,8
Dublin,253,126,127,4183.41,90,24,85,44,10
Dublin,248,98,150,5548.72,95,30,81,34,8
Dublin,226,109,117,283.82,59,20,67,50,30
Dublin,248,125,123,663.13,52,18,70,73,35
Dublin,195,99,96,1847.59,16,17,45,71,46
Dublin,288,148,140,25.32,27,24,50,81,106
Dublin,298,150,148,11917.62,100,25,142,29,2
Dublin,277,130,147,3796.65,69,23,165,16,4
Dublin,310,149,161,8120.28,89,29,154,34,4
Dublin,184,86,98,8503.17,34,24,116,10,0
Dublin,185,88,97,12766.54,49,25,92,18,1
Dublin,309,158,151,9734.74,100,21,164,23,1
Dublin,244,108,136,14616.91,67,17,149,10,1
Dublin,233,102,131,362.18,89,11,121,12,0
Dublin,202,111,91,13087.14,44,23,123,11,1
Dublin,311,171,140,4497.08,65,39,182,22,3
Dublin,357,177,180,4631.73,73,34,226,23,1
Dublin,430,213,217,12315.62,114,65,190,54,7
Dublin,232,105,127,10954.76,51,23,148,7,3
Dublin,297,135,162,7977.01,72,31,174,19,1
Dublin,387,205,182,76.23,67,65,134,73,48
Dublin,305,138,167,13433.76,69,27,198,9,2
Dublin,363,176,187,7816.37,94,36,218,15,0
Dublin,474,238,236,1234.32,72,49,325,25,3
Dublin,320,162,158,10994.67,91,37,150,39,3
Dublin,353,160,193,18014.8,87,26,212,22,6
Dublin,334,150,184,6559.7,34,33,121,88,58
Dublin,281,133,148,2584.57,34,37,117,55,38
Dublin,213,115,98,10002.82,27,23,98,44,21
Dublin,210,96,114,5606.13,37,22,85,54,12
Dublin,176,78,98,9139.06,18,19,89,32,18
Dublin,165,90,75,7609.3,18,22,62,52,11
Dublin,156,80,76,3703.09,24,24,47,40,21
Dublin,158,73,85,6168.5,27,11,64,39,17
Dublin,196,84,112,4706.22,22,33,57,48,36
Dublin,166,73,93,6460.15,26,15,50,49,26
Dublin,318,129,189,3342.48,56,30,50,64,118
Dublin,234,105,129,2970.52,39,19,81,65,30
Dublin,98,59,39,6548.18,10,6,57,22,3
Dublin,199,99,100,5211.06,19,28,62,47,43
Dublin,244,126,118,5784.18,55,29,48,62,50
Dublin,217,108,109,3739.9,33,24,61,60,39
Dublin,190,80,110,9052.79,20,7,81,44,38
Dublin,326,150,176,6497.91,63,27,94,91,51
Dublin,318,124,194,4442.52,38,39,69,76,96
Dublin,353,164,189,1910.49,43,69,57,111,73
Dublin,263,124,139,3150.27,69,33,55,71,35
Dublin,296,126,170,1220.59,37,43,79,74,63
Dublin,389,172,217,6392.87,66,44,97,89,93
Dublin,299,146,153,4059.91,51,44,60,86,58
Dublin,214,93,121,4156.07,36,30,46,66,36
Dublin,262,145,117,7325.19,57,34,86,56,29
Dublin,243,124,119,3981.52,46,30,66,76,25
Dublin,219,105,114,3745.89,50,22,45,59,43
Dublin,208,106,102,13797.68,26,52,82,39,9
Dublin,172,83,89,3885.43,24,24,56,29,39
Dublin,315,147,168,6216.57,54,26,119,54,62
Dublin,259,124,135,4107.39,39,15,72,65,68
Dublin,280,136,144,6686.41,27,36,74,76,67
Dublin,229,112,117,7589.06,39,26,79,48,37
Dublin,264,136,128,4993.57,46,40,77,60,41
Dublin,368,172,196,8688.47,80,33,162,60,33
Dublin,283,135,148,2158.23,54,39,64,82,44
Dublin,303,148,155,9445.14,56,44,87,64,52
Dublin,289,129,160,7642.27,52,49,99,58,31
Dublin,228,111,117,5470.77,41,35,56,66,30
Dublin,354,151,203,5988.02,104,56,110,52,32
Dublin,277,128,149,8233.51,70,63,81,45,18
Dublin,209,95,114,1404.58,51,26,63,46,23
Dublin,340,174,166,5262.02,73,59,89,82,37
Dublin,229,105,124,8805.66,40,28,64,68,29
Dublin,349,165,184,7892.18,69,46,103,78,53
Dublin,325,161,164,4337.61,44,41,70,86,84
Dublin,312,162,150,4029.81,39,73,30,117,53
Dublin,349,167,182,2660.08,57,39,51,102,100
Dublin,402,144,258,3089.22,92,104,37,99,70
Dublin,351,166,185,6328.77,59,55,83,127,27
Dublin,239,107,132,2366.48,51,28,67,68,25
Dublin,123,59,64,5240.51,10,22,20,36,35
Dublin,298,149,149,5444.81,37,38,79,87,57
Dublin,232,113,119,4485,40,15,105,44,28
Dublin,229,106,123,2980.76,30,16,60,47,76
Dublin,233,113,120,2406.38,27,26,44,53,83
Dublin,368,180,188,2048.87,72,69,78,113,36
Dublin,180,76,104,1901.78,21,24,33,73,29
Dublin,263,127,136,6253.86,51,31,59,82,40
Dublin,302,144,158,6282.5,56,28,98,84,36
Dublin,343,170,173,5574.52,40,53,86,78,86
Dublin,262,124,138,1572.73,30,32,65,79,56
Dublin,166,68,98,8246.81,28,11,51,49,27
Dublin,260,118,142,1734.55,40,29,55,85,51
Dublin,142,63,79,7654.99,14,5,60,24,39
Dublin,176,86,90,3785.84,36,21,53,49,17
Dublin,169,85,84,3360.44,28,26,23,54,38
Dublin,218,111,107,3453.68,26,19,64,73,36
Dublin,173,81,92,7903.51,17,4,94,34,24
Dublin,169,75,94,3172.7,25,21,66,34,23
Dublin,186,102,84,1297.12,21,30,105,20,10
Dublin,130,63,67,17184.4,13,9,76,25,7
Dublin,251,123,128,2566.36,51,30,54,75,41
Dublin,198,92,106,3426.91,46,22,30,54,46
Dublin,275,131,144,2196.73,48,38,44,85,60
Dublin,330,170,160,3063.36,62,42,70,77,79
Dublin,218,103,115,4806.1,43,26,43,68,38
Dublin,155,71,84,3357.89,17,10,42,42,44
Dublin,135,66,69,5745.17,17,11,17,34,56
Dublin,166,81,85,8934.82,15,5,30,56,60
Dublin,210,107,103,6783.6,38,20,55,61,36
Dublin,209,94,115,3945.7,35,36,48,58,32
Dublin,323,162,161,3908.38,70,47,63,112,31
Dublin,384,188,196,4758.13,93,46,91,102,52
Dublin,329,160,169,3728.97,54,50,70,85,70
Dublin,266,131,135,4442.81,60,29,72,70,35
Dublin,241,90,151,4410.61,32,28,37,58,86
Dublin,376,170,206,5187.92,40,19,178,56,83
Dublin,158,67,91,9025.48,20,20,48,42,28
Dublin,250,108,142,11073.71,32,30,71,75,42
Dublin,216,100,116,3379.38,44,21,92,34,25
Dublin,282,129,153,4039.83,44,25,73,76,64
Dublin,345,152,193,5592.75,51,41,80,82,91
Dublin,165,82,83,15407.6,25,20,34,53,33
Dublin,215,103,112,3413.73,20,23,102,45,25
Dublin,156,73,83,1767.85,15,13,70,27,31
Dublin,205,101,104,10752.69,20,7,143,27,8
Dublin,234,114,120,2711.31,59,28,50,64,33
Dublin,385,191,194,3757.82,85,55,95,104,46
Dublin,363,185,178,1646.38,62,46,112,96,47
Dublin,253,114,139,3082.06,47,29,82,75,20
Dublin,335,152,183,4942.61,88,46,106,62,33
Dublin,224,109,115,6332.69,45,26,66,47,40
Dublin,315,161,154,3936.22,65,46,107,60,37
Dublin,225,111,114,1717.26,51,27,70,66,11
Dublin,261,129,132,1434,35,38,101,70,17
Dublin,239,118,121,5252.75,35,30,43,67,64
Dublin,423,221,202,570.1,26,42,226,55,74
Dublin,210,96,114,6231.08,37,19,81,48,25
Dublin,191,90,101,5882.53,25,13,62,37,54
Dublin,233,120,113,8779.53,40,37,66,80,10
Dublin,253,140,113,6264.55,42,45,76,77,13
Dublin,276,135,141,6779.83,48,26,58,53,91
Dublin,220,107,113,2615.87,37,20,63,40,60
Dublin,208,103,105,5005.41,24,18,43,40,83
Dublin,307,151,156,2155.48,37,66,59,124,21
Dublin,194,115,79,60342.15,20,28,132,14,0
Dublin,414,205,209,91857.11,47,57,281,24,5
Dublin,253,126,127,4551.26,23,28,165,27,10
Dublin,192,97,95,1753.87,34,22,44,56,36
Dublin,214,97,117,13771.8,22,26,147,12,7
Dublin,187,97,90,15697.14,11,14,147,12,3
Dublin,129,64,65,20295.78,7,17,94,10,1
Dublin,192,98,94,3764.93,38,25,36,44,49
Dublin,292,147,145,5431.35,58,77,78,67,12
Dublin,274,134,140,3530.25,43,43,63,69,56
Dublin,259,119,140,1029.7,66,40,53,76,24
Dublin,360,169,191,8162.34,97,44,116,90,13
Dublin,150,72,78,4538.44,14,22,86,24,4
Dublin,250,118,132,2564.71,41,28,80,53,48
Dublin,220,103,117,3923.11,37,21,54,54,54
Dublin,224,113,111,4618.46,28,31,43,66,56
Dublin,346,172,174,541.93,57,36,171,52,30
Dublin,473,228,245,1118.99,92,163,58,139,21
Dublin,375,181,194,4339.37,104,62,90,107,12
Dublin,168,76,92,8712.79,26,17,113,11,1
Dublin,166,72,94,4591.47,38,7,112,8,1
Dublin,236,116,120,4717.55,69,12,129,23,3
Dublin,321,146,175,32778.52,23,27,248,17,6
Dublin,206,113,93,1301.14,21,18,133,17,17
Dublin,264,126,138,4353.35,35,41,59,74,55
Dublin,251,116,135,4797.95,39,40,101,52,19
Dublin,244,123,121,11817.7,18,18,188,16,4
Dublin,208,107,101,1599.3,27,23,66,53,39
Dublin,225,98,127,6506.84,14,19,137,36,19
Dublin,233,120,113,6172.68,24,44,58,66,41
Dublin,238,118,120,6177.49,22,33,50,92,41
Dublin,275,137,138,1808.88,20,45,63,90,57
Dublin,392,198,194,3213.51,41,50,80,150,71
Dublin,370,188,182,4119.72,75,46,122,103,24
Dublin,244,129,115,5436.36,33,25,78,90,18
Dublin,146,63,83,14520.14,26,8,105,6,1
Dublin,162,72,90,21750.81,22,13,111,11,5
Dublin,171,90,81,6230.19,18,16,132,3,2
Dublin,276,140,136,9724.13,61,27,152,34,2
Dublin,271,131,140,11725.51,44,27,180,15,5
Dublin,270,120,150,4551.81,53,35,53,72,57
Dublin,214,110,104,3735.84,24,24,51,51,64
Dublin,187,99,88,5063.36,31,29,43,50,34
Dublin,268,124,144,4274.39,42,26,89,51,60
Dublin,352,172,180,4890.04,76,30,96,70,80
Dublin,285,135,150,5256.27,60,30,73,68,54
Dublin,155,75,80,2480.83,15,21,109,7,3
Dublin,328,152,176,2201.27,62,32,63,72,99
Dublin,293,154,139,4062.28,51,40,90,76,36
Dublin,221,98,123,4492.33,43,18,53,48,59
Dublin,304,146,158,3573.53,45,58,82,88,31
Dublin,363,191,172,6455.17,73,51,108,85,46
Dublin,186,82,104,5953.91,22,14,85,39,26
Dublin,236,106,130,3914.67,30,39,45,55,67
Dublin,293,140,153,3957.37,47,44,74,73,55
Dublin,328,156,172,2933,52,37,80,85,74
Dublin,261,113,148,4644.38,55,46,56,70,34
Dublin,179,79,100,4149.76,35,29,35,38,42
Dublin,215,107,108,5663.11,42,45,58,56,14
Dublin,84,43,41,4803.29,20,12,28,18,6
Dublin,382,181,201,242.21,50,30,62,91,149
Dublin,212,95,117,186.59,54,23,74,53,8
Dublin,257,129,128,8075.41,96,22,105,33,1
Dublin,358,181,177,7180.39,138,28,138,51,3
Dublin,425,202,223,8804.46,151,49,149,74,2
Dublin,175,71,104,3047.67,27,22,54,61,11
Dublin,224,108,116,4101.14,64,14,91,48,7
Dublin,402,207,195,3270.9,69,59,100,133,41
Dublin,418,204,214,8601.53,81,81,120,125,11
Dublin,210,96,114,381.41,50,25,76,45,14
Dublin,139,75,64,2343.18,18,3,39,34,45
Dublin,359,169,190,3982.69,56,47,106,89,61
Dublin,260,129,131,9685.23,43,45,70,82,20
Dublin,202,107,95,6146.54,36,32,54,66,14
Dublin,233,118,115,9142.27,39,53,59,71,11
Dublin,245,126,119,9366.88,49,45,59,77,15
Dublin,205,96,109,3697.16,19,29,59,63,35
Dublin,307,149,158,9284.46,59,59,75,104,10
Dublin,477,224,253,7216.99,143,91,132,104,7
Dublin,222,113,109,1326.16,71,18,91,36,6
Dublin,297,151,146,1636.35,56,52,83,72,34
Dublin,420,206,214,6982.89,124,53,172,61,10
Dublin,316,160,156,5410.77,118,60,84,51,3
Dublin,278,142,136,3639.65,109,17,116,29,7
Dublin,307,163,144,9489.37,132,9,153,11,2
Dublin,252,113,139,12004,96,44,87,25,0
Dublin,243,122,121,8004.22,90,10,126,15,2
Dublin,407,198,209,12975.83,174,23,184,24,2
Dublin,449,220,229,8916.34,174,48,167,56,4
Dublin,348,172,176,10081.11,125,21,150,47,5
Dublin,244,119,125,8199.2,91,18,102,30,3
Dublin,308,159,149,9057.76,97,43,100,63,5
Dublin,317,156,161,6462.66,87,44,158,24,4
Dublin,221,111,110,7409.89,61,11,134,13,2
Dublin,310,143,167,9744.75,93,22,171,24,0
Dublin,255,117,138,7683.73,38,32,172,13,0
Dublin,238,110,128,6583.68,42,35,63,74,24
Dublin,433,214,219,7584.78,152,51,150,76,4
Dublin,402,194,208,6287.54,145,54,125,72,6
Dublin,171,77,94,8962.26,35,9,124,2,1
Dublin,294,136,158,4799.84,82,14,181,12,5
Dublin,173,90,83,9182.1,20,11,132,10,0
Dublin,274,138,136,6949.2,51,31,78,87,27
Dublin,397,203,194,4124.08,69,69,89,140,30
Dublin,342,178,164,5535.59,73,52,100,91,26
Dublin,136,66,70,2724.2,26,8,90,10,2
Dublin,309,150,159,4063.81,105,40,116,44,4
Dublin,288,140,148,1865.13,73,36,95,72,12
Dublin,229,101,128,9273.51,43,55,60,65,6
Dublin,265,132,133,9099.02,45,44,77,85,14
Dublin,246,130,116,6910.11,50,43,53,77,23
Dublin,171,84,87,1692.72,34,25,55,43,14
Dublin,246,122,124,7468.58,47,29,73,65,32
Dublin,214,111,103,7693.41,35,33,48,82,16
Dublin,298,138,160,7099.46,54,30,85,97,32
Dublin,420,208,212,4673.26,67,61,120,119,53
Dublin,255,125,130,6815.27,57,28,80,71,19
Dublin,217,107,110,5391.84,23,41,52,92,9
Dublin,312,137,175,896.84,62,37,77,67,69
Dublin,346,168,178,3791.07,59,58,110,97,22
Dublin,432,208,224,8420.72,173,26,182,49,2
Dublin,221,103,118,5616.69,71,22,97,28,3
Dublin,401,195,206,7526.84,139,40,158,57,7
Dublin,287,146,141,8169.66,116,18,129,21,3
Dublin,189,82,107,9020.62,50,10,120,6,3
Dublin,372,187,185,5827.25,106,67,77,114,8
Dublin,328,156,172,3670.01,89,54,79,103,3
Dublin,320,168,152,2937.29,74,63,84,93,6
Dublin,208,103,105,214.95,50,22,113,12,11
Dublin,434,222,212,5323.19,84,107,74,155,14
Dublin,300,153,147,6214.4,83,20,148,44,5
Dublin,259,121,138,8562.83,63,45,67,78,6
Dublin,270,128,142,6372.58,65,50,52,91,12
Dublin,283,141,142,4079.93,43,70,56,108,6
Dublin,251,123,128,4985.3,35,56,53,97,10
Dublin,281,143,138,9638.47,51,66,50,105,9
Dublin,314,160,154,2838.16,61,36,90,91,36
Dublin,232,113,119,6678.37,38,37,43,82,32
Dublin,293,139,154,8170.66,60,77,51,99,6
Dublin,260,136,124,3730.49,52,61,55,82,10
Dublin,233,109,124,4845.79,71,9,129,19,5
Dublin,362,172,190,3985.64,87,69,75,118,13
Dublin,404,201,203,1645.09,124,48,122,95,15
Dublin,214,100,114,2364.25,17,24,39,72,62
Dublin,344,168,176,5811.3,50,53,71,121,49
Dublin,198,102,96,5073.28,30,33,45,72,18
Dublin,328,149,179,4808.68,67,66,74,100,21
Dublin,295,141,154,1055.47,38,48,59,100,50
Dublin,236,114,122,6500.3,33,47,39,95,22
Dublin,292,150,142,5367.35,38,46,54,117,37
Dublin,226,113,113,2023.19,31,27,50,77,41
Dublin,243,124,119,5295.73,44,31,65,77,26
Dublin,289,137,152,2069.04,31,43,71,112,32
Dublin,292,147,145,3488.27,59,44,55,100,34
Dublin,421,208,213,5677.22,63,57,101,152,48
Dublin,224,104,120,6655.77,30,35,49,85,25
Dublin,277,125,152,2209.48,45,41,39,70,82
Dublin,417,196,221,3947.18,89,58,90,105,75
Dublin,221,108,113,2349.99,34,19,40,58,70
Dublin,206,105,101,2957.77,31,36,22,50,67
Dublin,212,110,102,3103.36,41,26,29,61,55
Dublin,320,157,163,4148.46,51,39,45,90,95
Dublin,458,218,240,3561.24,139,93,78,133,15
Dublin,269,124,145,1262.23,72,39,59,71,28
Dublin,226,129,97,2274.35,53,40,56,53,24
Dublin,412,199,213,7343.9,82,71,93,135,31
Dublin,236,116,120,1204.16,51,36,34,71,44
Dublin,226,106,120,1573.56,33,17,42,79,55
Dublin,247,116,131,2463.2,26,32,35,75,79
Dublin,389,192,197,4493.89,48,73,62,124,82
Dublin,151,70,81,2258.59,37,18,41,40,15
Dublin,366,167,199,1590.58,47,64,62,89,104
Dublin,319,161,158,2722.26,39,53,63,114,50
Dublin,357,167,190,1389.42,75,39,63,120,60
Dublin,521,261,260,3169.47,157,97,93,153,21
Dublin,157,73,84,803.65,22,11,34,43,47
Dublin,305,145,160,4720.56,115,40,83,58,9
Dublin,262,133,129,1386.48,43,43,65,77,34
Dublin,411,189,222,1265.33,96,67,107,117,24
Dublin,225,96,129,4344.64,39,31,48,67,40
Dublin,214,102,112,3037.27,34,40,42,79,19
Dublin,337,162,175,5522.69,59,74,59,120,25
Dublin,281,144,137,1951.21,40,62,39,94,46
Dublin,309,160,149,895.16,60,47,64,75,63
Dublin,328,161,167,2601.87,52,45,59,85,87
Dublin,241,119,122,5067.6,44,31,71,71,24
Dublin,356,160,196,4086.13,65,57,65,94,75
Dublin,227,102,125,5083.42,47,40,59,59,22
Dublin,383,184,199,7050.16,89,39,90,79,86
Dublin,309,150,159,1911.34,50,38,66,76,79
Dublin,295,137,158,3647.2,53,29,108,59,46
Dublin,259,122,137,1171.26,57,39,51,76,36
Dublin,267,128,139,899.2,46,45,79,71,26
Dublin,375,172,203,2222.5,72,52,68,127,56
Dublin,243,115,128,1221.42,38,28,50,81,46
Dublin,389,200,189,26.1,88,45,107,105,44
Dublin,357,173,184,201.18,118,31,118,63,27
Dublin,365,187,178,30.33,105,31,96,88,45
Dublin,327,167,160,47.31,84,37,103,72,31
Dublin,437,212,225,38.92,90,70,111,126,40
Dublin,296,153,143,64.91,43,40,75,83,55
Dublin,205,99,106,72.71,42,16,90,31,26
Dublin,200,97,103,159.97,35,15,50,64,36
Dublin,345,168,177,81.13,70,51,85,93,46
Dublin,340,170,170,9527.01,87,14,206,28,5
Dublin,274,123,151,6137.99,50,23,178,22,1
Dublin,249,122,127,930.9,35,30,112,47,25
Dublin,194,95,99,1187.39,43,19,87,31,14
Dublin,163,74,89,9687.39,42,5,101,12,3
Dublin,127,61,66,5099.17,14,6,86,12,9
Dublin,310,158,152,9788.44,91,8,193,18,0
Dublin,234,117,117,8392.51,74,10,131,16,3
Dublin,295,145,150,12504.77,87,8,185,12,3
Dublin,361,155,206,8112.72,78,22,228,31,2
Dublin,205,97,108,13512.62,24,7,159,10,5
Dublin,189,91,98,19800.94,24,16,136,10,3
Dublin,318,171,147,2816.38,85,52,76,83,22
Dublin,219,109,110,3297.8,56,22,93,37,11
Dublin,241,107,134,206.21,38,20,51,53,79
Dublin,415,200,215,208.68,140,48,132,69,26
Dublin,299,150,149,5767.86,125,26,77,63,8
Dublin,234,112,122,4508.93,82,11,109,29,3
Dublin,207,97,110,3656.6,31,34,47,59,36
Dublin,214,97,117,3433.56,33,14,120,26,21
Dublin,301,145,156,9537.39,86,19,146,43,7
Dublin,200,95,105,9270.85,57,10,115,14,4
Dublin,202,88,114,8054.23,35,10,143,13,1
Dublin,358,181,177,6007.82,128,17,152,53,8
Dublin,321,159,162,2283.62,90,74,90,61,6
Dublin,277,129,148,4297.64,89,24,102,55,7
Dublin,308,139,169,9360.28,99,26,127,54,2
Dublin,291,138,153,9695.48,104,29,106,51,1
Dublin,246,114,132,8429.28,87,23,96,36,4
Dublin,348,181,167,9173.34,149,24,132,39,4
Dublin,408,209,199,5307.04,141,41,133,75,18
Dublin,438,219,219,7719.97,142,56,137,99,4
Dublin,130,57,73,25038.52,21,9,92,6,2
Dublin,433,219,214,6575.65,137,66,122,98,10
Dublin,432,210,222,7570.98,159,36,162,71,4
Dublin,444,218,226,2149.17,152,34,197,55,6
Dublin,402,199,203,8251.23,109,64,116,110,3
Dublin,267,134,133,2860.91,55,45,69,87,11
Dublin,470,232,238,8092.98,191,28,180,67,4
Dublin,471,237,234,8017.43,163,42,165,95,6
Dublin,325,154,171,1270.86,76,49,118,72,10
Dublin,385,190,195,4758.26,150,28,149,52,6
Dublin,179,81,98,6290.63,19,9,137,10,4
Dublin,119,60,59,1112.23,32,4,72,11,0
Dublin,246,120,126,233.24,60,29,50,61,46
Dublin,395,191,204,3553.88,128,94,106,62,5
Dublin,302,141,161,9235.76,84,65,80,61,12
Dublin,356,161,195,6595.52,92,88,90,80,6
Dublin,391,206,185,22.39,77,58,104,102,50
Dublin,315,157,158,55.74,79,31,101,76,28
Dublin,278,144,134,48.38,56,51,53,101,17
Dublin,275,131,144,229.44,67,19,97,68,24
Dublin,283,145,138,76.4,76,57,49,77,24
Dublin,376,189,187,63.37,82,50,91,113,40
Dublin,296,139,157,121.6,61,29,95,77,34
Dublin,386,193,193,342.03,42,70,55,154,65
Dublin,423,207,216,532.65,98,64,93,132,36
Dublin,217,115,102,92.48,51,20,52,64,30
Dublin,231,127,104,3683.68,31,40,33,114,13
Dublin,295,138,157,4983.28,43,38,42,105,67
Dublin,297,149,148,5500.71,43,37,53,81,83
Dublin,214,98,116,2494.06,31,31,36,58,58
Dublin,269,133,136,1754.74,56,25,56,77,55
Dublin,292,150,142,4799.16,57,34,52,64,85
Dublin,191,95,96,196.82,31,33,25,63,39
Dublin,387,183,204,103.68,63,57,75,135,57
Dublin,311,145,166,3524.92,56,34,53,67,101
Dublin,402,192,210,338.35,68,84,57,138,55
Dublin,266,119,147,3124.38,44,27,40,69,86
Dublin,207,103,104,2134.46,39,27,37,45,59
Dublin,280,135,145,1841.25,43,31,49,68,89
Dublin,275,124,151,1144.45,49,37,39,94,56
Dublin,266,141,125,6553.18,48,17,61,71,69
Dublin,316,164,152,6052.48,41,40,94,83,58
Dublin,261,121,140,4481.07,51,31,68,64,47
Dublin,275,129,146,4132.79,42,32,64,90,47
Dublin,242,121,121,2426.53,44,26,55,64,53
Dublin,217,94,123,4983.92,23,15,74,44,61
Dublin,328,163,165,1812.74,61,53,49,92,73
Dublin,280,126,154,694.23,58,37,67,66,52
Dublin,190,88,102,982.69,15,16,95,44,20
Dublin,216,101,115,1119.64,43,24,46,64,39
Dublin,180,90,90,1449.95,36,19,43,49,33
Dublin,369,174,195,2366.19,77,47,83,106,56
Dublin,269,131,138,2566.55,50,35,45,100,39
Dublin,295,126,169,435.03,56,30,58,74,77
Dublin,190,94,96,3085.77,26,10,71,42,41
Dublin,133,66,67,7756.46,18,13,45,35,22
Dublin,207,112,95,3900.73,37,25,31,62,52
Dublin,202,98,104,469.11,23,28,39,60,52
Dublin,196,88,108,2422.32,31,29,32,56,48
Dublin,294,132,162,719.19,49,31,70,63,81
Dublin,277,121,156,802.08,52,48,41,79,57
Dublin,270,129,141,6056.39,44,45,80,64,37
Dublin,205,96,109,1712.61,38,25,37,62,43
Dublin,250,124,126,1522.48,37,28,75,59,51
Dublin,300,151,149,2671.42,49,45,62,94,50
Dublin,302,131,171,745.78,47,28,74,91,62
Dublin,251,114,137,659.59,37,27,50,59,78
Dublin,248,117,131,808.99,46,28,48,84,42
Dublin,350,178,172,3586.47,67,55,77,98,53
Dublin,219,103,116,2864.62,32,33,41,61,52
Dublin,395,181,214,4047.17,79,66,79,116,55
Dublin,300,136,164,3397.28,52,48,48,109,43
Dublin,345,173,172,1865.6,61,29,79,69,107
Dublin,226,94,132,5836.48,52,21,93,44,16
Dublin,429,201,228,4149.34,89,86,97,137,20
Dublin,404,188,216,7418.56,90,72,97,128,17
Dublin,343,165,178,1833.7,77,74,117,63,12
Dublin,206,91,115,3329.24,37,19,60,51,39
Dublin,356,178,178,10085.27,92,72,92,90,10
Dublin,347,173,174,8125.51,60,66,91,114,16
Dublin,386,198,188,3767.18,67,56,112,134,17
Dublin,395,198,197,6383.74,63,50,104,125,53
Dublin,182,86,96,2980.53,46,18,60,42,16
Dublin,155,68,87,5112.98,27,17,43,51,17
Dublin,154,62,92,4984.3,28,10,54,49,13
Dublin,356,172,184,4210.48,68,72,91,109,16
Dublin,374,185,189,1468.98,86,49,93,102,44
Dublin,179,87,92,13452.58,36,18,104,18,3
Dublin,278,141,137,5623.55,59,26,92,84,17
Dublin,318,153,165,10084.03,77,43,90,84,24
Dublin,282,136,146,8061.29,53,42,93,72,22
Dublin,473,206,267,10913.96,167,85,129,82,10
Dublin,290,135,155,5716.99,78,46,88,66,12
Dublin,341,166,175,44.97,66,51,92,106,26
Dublin,435,229,206,53.59,105,54,107,113,56
Dublin,419,189,230,164.33,107,54,126,82,50
Dublin,289,147,142,193.33,65,46,72,72,34
Dublin,300,139,161,75.82,48,33,47,78,94
Dublin,421,205,216,102.61,70,56,121,113,61
Dublin,267,132,135,4822.28,59,52,77,75,4
Dublin,180,86,94,8986.07,44,11,109,16,0
Dublin,244,114,130,7346.74,56,14,157,17,0
Dublin,181,83,98,10391.55,41,10,115,14,1
Dublin,185,84,101,10163.16,32,16,124,11,2
Dublin,167,75,92,3974.39,38,4,119,6,0
Dublin,107,46,61,6084.04,22,6,73,5,1
Dublin,246,114,132,5327.33,61,16,153,16,0
Dublin,307,145,162,4760.5,71,48,103,77,8
Dublin,406,199,207,8479,94,71,131,102,8
Dublin,222,97,125,2143.37,60,10,117,31,4
Dublin,190,93,97,8488.59,45,16,115,13,1
Dublin,210,106,104,6352.28,61,14,122,11,2
Dublin,278,131,147,2598.62,60,21,184,12,1
Dublin,537,280,257,242.59,74,56,190,90,127
Dublin,238,119,119,10074.93,63,14,150,6,5
Dublin,288,137,151,7765.52,60,67,66,94,1
Dublin,166,81,85,4870.75,46,7,105,8,0
Dublin,220,105,115,7627.5,60,16,132,12,0
Dublin,345,182,163,121.66,87,37,168,33,20
Dublin,366,187,179,569.28,97,26,149,68,26
Dublin,216,110,106,4820.14,65,24,80,46,1
Dublin,273,143,130,9995.24,65,55,86,65,2
Dublin,197,90,107,9892.04,45,11,123,14,4
Dublin,241,118,123,10695.9,68,13,140,18,2
Dublin,357,164,193,1682.23,79,39,173,55,11
Dublin,341,162,179,697.28,91,60,74,87,29
Dublin,374,161,213,177.9,81,40,73,71,109
Dublin,173,84,89,9745.93,31,10,120,10,2
Dublin,154,71,83,18796.53,16,7,111,14,6
Dublin,259,125,134,193.83,66,34,72,69,18
Dublin,185,89,96,376.78,33,12,104,24,12
Dublin,355,177,178,5775.74,72,58,101,94,30
Dublin,187,90,97,4612.84,48,14,114,8,3
Dublin,281,125,156,7077.02,88,16,160,16,1
Dublin,318,163,155,383.87,128,39,108,38,5
Dublin,269,142,127,7803.66,76,32,107,48,6
Dublin,252,119,133,4784.96,83,18,120,30,1
Dublin,273,137,136,3654.96,104,12,129,27,1
Dublin,328,155,173,1688.28,138,21,145,23,1
Dublin,307,151,156,5811.75,124,19,140,24,0
Dublin,277,146,131,2743.12,88,27,139,20,3
Dublin,382,178,204,4167.62,143,41,146,46,6
Dublin,237,117,120,4003.99,44,43,71,46,33
Dublin,274,130,144,7368.76,57,21,89,69,38
Dublin,367,179,188,4414.35,56,43,99,91,78
Dublin,416,196,220,7792.45,149,35,165,63,4
Dublin,289,149,140,8415.6,97,24,118,46,4
Dublin,294,151,143,10429.23,119,9,139,25,2
Dublin,358,172,186,5705.36,125,27,186,18,2
Dublin,495,238,257,2305.94,196,44,213,39,3
Dublin,259,128,131,8866.83,98,10,136,14,1
Dublin,291,140,151,9191.7,98,25,153,13,2
Dublin,446,239,207,8203.51,178,26,201,39,2
Dublin,304,155,149,7562.75,128,25,121,27,3
Dublin,239,124,115,9096.45,76,19,110,25,9
Dublin,357,171,186,10270.13,129,25,145,49,9
Dublin,449,213,236,3746.35,148,35,223,39,4
Dublin,449,212,237,6741.13,164,37,182,60,6
Dublin,386,197,189,7084.26,148,29,162,43,4
Dublin,267,138,129,8392.27,98,13,132,21,3
Dublin,263,125,138,9433.96,92,14,131,24,2
Dublin,278,132,146,9102.22,107,17,122,29,3
Dublin,323,163,160,7506.04,96,40,108,75,4
Dublin,298,142,156,3090.68,58,29,165,39,7
Dublin,298,154,144,7902.62,97,29,139,29,4
Dublin,322,158,164,8019.13,119,15,147,33,8
Dublin,285,137,148,6346.45,91,28,107,45,14
Dublin,289,139,150,3937.87,90,28,136,31,4
Dublin,409,213,196,7757.08,123,49,158,74,5
Dublin,274,144,130,6684.56,81,19,125,45,4
Dublin,293,132,161,6227.95,96,24,106,51,16
Dublin,350,177,173,8267.2,114,30,157,46,3
Dublin,307,157,150,3878.71,97,36,129,41,4
Dublin,356,180,176,10805.89,133,29,164,30,0
Dublin,344,166,178,7705.4,101,27,149,57,10
Dublin,465,241,224,7330.57,164,53,186,54,8
Dublin,293,136,157,7321.52,105,13,154,19,2
Dublin,293,145,148,9219.63,101,30,130,27,5
Dublin,349,178,171,7590.26,129,19,165,34,2
Dublin,277,132,145,8115.08,101,16,137,23,0
Dublin,391,204,187,11145.63,139,57,153,39,3
Dublin,377,178,199,6817.98,131,28,168,47,3
Dublin,371,176,195,7637.36,118,24,189,33,7
Dublin,287,147,140,5943.01,92,15,139,33,8
Dublin,336,158,178,5260.93,118,35,167,15,1
Dublin,314,164,150,9560.93,124,31,126,33,0
Dublin,329,154,175,8360.01,88,31,137,66,7
Dublin,363,171,192,8005.47,110,25,137,81,10
Dublin,305,139,166,5969.04,83,18,167,33,4
Dublin,257,132,125,7720.27,70,14,131,33,9
Dublin,309,142,167,3989.1,69,56,76,86,22
Dublin,348,157,191,6196.47,103,53,97,92,3
Dublin,363,180,183,2840,106,58,110,86,3
Dublin,332,152,180,7552.15,105,39,119,62,7
Dublin,329,163,166,7181.99,126,35,114,54,0
Dublin,343,169,174,7437.12,75,50,111,93,14
Dublin,362,176,186,4167.96,88,79,91,94,10
Dublin,294,149,145,7926.02,97,27,117,49,4
Dublin,349,178,171,11777.01,132,30,132,53,2
Dublin,283,122,161,7390.19,97,48,101,32,5
Dublin,344,176,168,7325.23,129,19,173,20,3
Dublin,285,138,147,4741.07,55,65,59,101,5
Dublin,366,186,180,2330.07,95,67,117,83,4
Dublin,354,170,184,9049.54,100,19,204,29,2
Dublin,365,185,180,4881.18,96,26,208,31,4
Dublin,237,121,116,11438.78,68,26,118,22,3
Dublin,322,165,157,6241.52,109,34,121,51,7
Dublin,259,126,133,8675.26,91,28,104,34,2
Dublin,388,190,198,11353.33,140,45,144,59,0
Dublin,391,202,189,9218.87,154,40,152,42,3
Dublin,408,197,211,7862.94,156,28,180,40,4
Dublin,405,195,210,9440.78,143,53,152,53,4
Dublin,299,154,145,452.58,100,29,125,41,4
Dublin,294,149,145,14304.48,86,26,165,17,0
Dublin,359,169,190,6969.25,97,48,157,49,8
Dublin,202,93,109,6368.22,42,33,118,8,1
Dublin,250,117,133,13731.74,58,22,156,12,2
Dublin,360,167,193,8967.94,118,39,164,37,2
Dublin,388,186,202,10343.36,128,35,185,33,7
Dublin,432,222,210,10151.09,166,33,194,38,1
Dublin,434,213,221,10106.89,174,37,191,31,1
Dublin,305,146,159,5991.79,85,33,132,51,4
Dublin,189,93,96,12811.82,35,12,135,7,0
Dublin,125,50,75,741.31,21,25,72,7,0
Dublin,256,120,136,1188.67,47,61,76,62,10
Dublin,454,224,230,3939.5,133,68,140,95,18
Dublin,255,135,120,2835.76,39,26,132,25,33
Dublin,353,158,195,3733.16,88,77,79,88,21
Dublin,417,204,213,4110.4,70,92,102,139,14
Dublin,337,166,171,4437.42,44,42,100,109,42
Dublin,303,159,144,4632.46,39,40,70,89,65
Dublin,308,150,158,6433.69,45,50,62,85,66
Dublin,213,97,116,5530.31,17,32,40,67,57
Dublin,243,126,117,3683.6,27,26,42,46,102
Dublin,215,108,107,3271.6,30,25,43,63,54
Dublin,204,105,99,1845.95,26,29,34,68,47
Dublin,346,160,186,1483.07,74,46,107,83,36
Dublin,196,92,104,4576.55,28,21,39,49,59
Dublin,197,99,98,2220.47,26,23,48,50,50
Dublin,168,78,90,1851.2,37,21,53,51,6
Dublin,289,151,138,4387.56,41,17,82,61,88
Dublin,235,95,140,116.66,26,20,97,65,27
Dublin,228,114,114,5677.71,52,25,88,42,21
Dublin,338,141,197,36.95,41,35,66,75,121
Dublin,381,190,191,1852.49,152,36,140,53,0
Dublin,317,163,154,4540.38,128,21,140,27,1
Dublin,322,154,168,3611,121,26,114,58,3
Dublin,452,236,216,71.74,90,48,255,50,9
Dublin,441,229,212,1440.81,104,75,114,125,23
Dublin,386,178,208,384.37,55,39,89,80,123
Dublin,255,120,135,720.51,74,19,140,19,3
Dublin,343,152,191,7714.11,82,66,61,120,14
Dublin,310,160,150,2446.59,51,33,66,88,72
Dublin,237,118,119,5066.27,39,30,62,83,23
Dublin,285,146,139,2568.03,54,32,69,87,43
Dublin,230,114,116,1367.87,45,23,79,74,9
Dublin,216,109,107,4560.52,28,23,59,81,25
Dublin,322,158,164,1115.87,77,57,74,94,20
Dublin,360,174,186,5020.99,105,28,207,17,3
Dublin,361,175,186,10689.64,149,27,158,26,1
Dublin,420,197,223,11569.93,149,19,226,26,0
Dublin,362,183,179,3386.82,71,92,61,129,9
Dublin,266,131,135,12536.53,99,15,144,6,2
Dublin,351,171,180,14061.94,126,19,186,16,4
Dublin,310,162,148,11030.46,103,28,155,23,1
Dublin,228,124,104,3926.7,28,38,71,79,12
Dublin,249,127,122,4726.56,30,37,63,88,31
Dublin,294,129,165,4961.94,53,38,85,83,35
Dublin,274,140,134,5709.88,31,37,72,107,27
Dublin,203,108,95,4777.93,28,30,50,67,28
Dublin,233,114,119,7933,40,36,50,80,27
Dublin,214,107,107,8936.4,27,28,63,81,15
Dublin,217,107,110,7906.15,31,25,59,85,17
Dublin,252,131,121,8579.31,48,36,64,90,14
Dublin,391,194,197,5794.82,49,68,113,140,21
Dublin,216,113,103,1133.01,26,24,117,36,13
Dublin,189,86,103,2809.07,28,23,62,46,30
Dublin,400,189,211,50.71,115,45,117,90,33
Dublin,339,166,173,40.76,72,47,83,99,38
Dublin,344,177,167,31.66,85,55,81,96,27
Dublin,287,136,151,7109.59,85,9,177,15,1
Dublin,262,114,148,9976.77,98,15,123,23,3
Dublin,287,148,139,8123.64,102,10,153,20,2
Dublin,382,178,204,6543.67,96,50,68,101,67
Dublin,331,164,167,10049.79,52,63,76,131,9
Dublin,370,179,191,10106.25,118,37,117,78,20
Dublin,329,159,170,2577.7,78,29,155,54,13
Dublin,286,125,161,5475.68,105,11,139,27,4
Dublin,196,93,103,10110.39,47,19,111,13,6
Dublin,261,135,126,7994.36,86,8,146,19,2
Dublin,308,141,167,515.18,96,11,180,18,3
Dublin,333,175,158,66.85,72,41,92,86,42
Dublin,277,137,140,2505.38,84,8,168,16,1
Dublin,479,248,231,66.45,116,60,104,130,69
Dublin,283,142,141,1494.71,70,26,91,52,44
Dublin,539,265,274,387.55,143,78,151,113,54
Dublin,355,186,169,8883.88,122,15,193,22,3
Dublin,222,106,116,6521.93,56,46,61,55,4
Dublin,285,154,131,6399.6,55,30,77,83,40
Dublin,196,93,103,6892.91,56,11,109,20,0
Dublin,270,129,141,7874.7,97,10,151,7,5
Dublin,412,194,218,7343.64,139,18,222,28,5
Dublin,373,175,198,8336.69,142,24,178,29,0
Dublin,408,195,213,7146.86,128,27,204,37,12
Dublin,260,132,128,3255.94,42,32,53,70,63
Dublin,281,133,148,1979.97,39,35,74,79,54
Dublin,458,229,229,3614.1,78,58,109,167,46
Dublin,247,122,125,3188.99,26,39,53,86,43
Dublin,357,177,180,5212.59,53,51,51,130,72
Dublin,248,122,126,5240.47,27,36,49,82,54
Dublin,306,148,158,6033.6,43,47,57,92,67
Dublin,327,164,163,3604.58,58,51,55,100,63
Dublin,314,151,163,5376.71,46,48,56,95,69
Dublin,245,119,126,1235.65,27,31,44,76,67
Dublin,196,98,98,3440.89,50,7,100,35,4
Dublin,398,184,214,1011.64,106,61,97,96,38
Dublin,179,87,92,3174.49,34,15,74,29,27
Dublin,353,172,181,4000.54,111,9,163,64,6
Dublin,140,67,73,266.81,22,14,68,20,16
Dublin,220,109,111,7007.93,58,7,111,32,12
Dublin,419,202,217,734.24,81,58,93,120,67
Dublin,240,97,143,3734.89,59,18,114,36,13
Dublin,313,146,167,1964.93,43,47,54,110,59
Dublin,211,98,113,2330,29,24,100,33,25
Dublin,237,114,123,1460.6,86,18,93,38,2
Dublin,252,123,129,8338.02,99,20,87,38,8
Dublin,135,63,72,17968.85,17,4,76,22,16
Dublin,107,51,56,15705.27,9,6,57,23,12
Dublin,135,66,69,6040.54,15,1,94,16,9
Dublin,150,66,84,11485.45,23,15,76,24,12
Dublin,284,147,137,9249.01,52,70,63,91,8
Dublin,317,164,153,7218.65,60,74,68,107,8
Dublin,303,150,153,5719.36,106,36,92,49,20
Dublin,318,160,158,3309.74,39,60,38,102,79
Dublin,361,175,186,286.16,58,54,53,118,78
Dublin,274,133,141,5098.05,36,16,78,52,92
Dublin,276,139,137,4991.23,39,61,39,86,51
Dublin,172,81,91,2916.79,22,26,45,52,27
Dublin,271,129,142,6534.37,43,35,45,83,65
Dublin,186,94,92,2804.5,33,16,58,50,29
Dublin,89,45,44,3118.1,1,1,70,16,1
Dublin,243,124,119,4552.86,32,28,50,68,65
Dublin,215,103,112,2777.45,32,23,34,56,70
Dublin,360,189,171,3057.3,81,39,71,99,70
Dublin,222,99,123,7576.79,41,7,121,41,12
Dublin,235,117,118,8629.55,90,21,63,54,7
Dublin,285,135,150,5323.02,87,31,86,71,10
Dublin,377,189,188,9650.58,78,94,85,108,12
Dublin,359,183,176,2688.55,64,88,70,123,14
Dublin,323,161,162,10949.52,67,74,71,105,6
Dublin,253,120,133,2504.38,55,37,63,73,25
Dublin,337,168,169,2856.32,35,37,75,117,73
Dublin,213,106,107,5385.86,29,25,35,69,55
Dublin,300,160,140,60.11,67,38,60,101,34
Dublin,411,237,174,31.04,64,91,106,105,45
Dublin,310,156,154,419.29,82,13,161,34,20
Dublin,223,110,113,328.84,42,17,100,43,21
Dublin,581,306,275,53.38,59,53,117,198,154
Dublin,193,97,96,295.72,8,19,47,77,42
Dublin,229,112,117,1126.36,26,18,60,77,48
Dublin,299,147,152,1325.29,103,9,167,18,2
Dublin,280,140,140,10008.58,96,10,144,28,2
Dublin,345,166,179,903.43,92,29,156,51,17
Dublin,258,117,141,4721.38,87,18,128,20,5
Dublin,166,79,87,537.74,36,29,39,46,16
Dublin,220,114,106,4748.54,25,18,36,35,106
Dublin,174,74,100,3442.14,19,19,43,50,43
Dublin,258,128,130,5012.63,33,35,58,72,60
Dublin,216,109,107,5525.71,43,27,58,39,49
Dublin,288,142,146,5570.28,46,35,59,63,85
Dublin,250,124,126,3216.84,36,22,57,56,79
Dublin,273,123,150,5234.4,48,36,60,60,69
Dublin,227,108,119,7434.34,25,45,53,81,23
Dublin,260,131,129,7412.9,54,39,62,83,22
Dublin,160,68,92,7748.18,23,25,37,57,18
Dublin,270,130,140,2632.53,74,40,90,62,4
Dublin,270,126,144,3834.85,47,34,62,62,65
Dublin,247,116,131,4988.99,21,28,50,67,81
Dublin,181,85,96,1196.92,14,20,28,47,72
Dublin,163,83,80,4175.31,21,7,38,39,58
Dublin,323,156,167,5329.15,88,66,92,72,5
Dublin,288,133,155,2808.28,75,48,82,74,9
Dublin,454,220,234,11249.04,142,86,121,86,19
Dublin,316,154,162,6786.07,56,72,82,96,10
Dublin,"1,029",515,514,561.45,169,317,209,207,127
Dublin,425,200,225,9079.45,143,79,128,65,10
Dublin,378,199,179,7507,90,87,107,92,2
Dublin,384,181,203,5840.48,70,90,107,105,12
Dublin,421,207,214,6968.93,98,74,112,128,9
Dublin,403,202,201,6790.23,105,48,144,96,10
Dublin,358,159,199,2398.72,84,70,92,98,14
Dublin,423,206,217,6624.28,56,95,98,158,16
Dublin,283,127,156,5081.61,33,34,76,97,43
Dublin,284,147,137,6311.67,36,43,70,96,39
Dublin,374,203,171,496.67,26,39,78,175,56
Dublin,443,227,216,7406.91,58,94,87,176,28
Dublin,310,152,158,6612.63,47,35,93,89,46
Dublin,423,200,223,4560.6,81,66,114,134,28
Dublin,274,136,138,981.31,68,38,87,69,12
Dublin,259,144,115,7134.59,53,36,60,100,10
Dublin,293,146,147,6893.31,44,55,47,115,32
Dublin,361,173,188,7066.93,40,67,68,151,35
Dublin,302,155,147,4847.36,31,47,55,115,54
Dublin,193,98,95,3274.85,21,29,56,53,34
Dublin,340,172,168,3178.28,66,85,49,128,12
Dublin,307,157,150,3096.76,35,31,60,97,84
Dublin,259,126,133,5957.17,39,30,55,91,44
Dublin,248,131,117,4726.78,43,29,49,90,37
Dublin,385,192,193,6678.11,52,51,66,152,64
Dublin,433,222,211,1317.47,41,46,98,169,79
Dublin,214,109,105,4372.08,16,30,42,87,39
Dublin,292,144,148,5886.03,40,32,62,115,43
Dublin,232,119,113,4515.02,18,43,40,79,52
Dublin,229,110,119,133.94,33,23,65,82,26
Dublin,189,90,99,172.35,26,25,100,26,12
Dublin,267,140,127,3117.27,41,40,45,94,47
Dublin,429,223,206,5144.01,75,62,87,149,56
Dublin,358,184,174,216.15,46,62,67,125,58
Dublin,222,94,128,5025.58,31,10,158,21,2
Dublin,262,125,137,2607.12,52,26,67,66,51
Dublin,280,139,141,5088.5,50,31,66,92,41
Dublin,304,152,152,3329.39,63,35,71,87,48
Dublin,364,183,181,6600.06,48,14,264,30,8
Dublin,261,127,134,816.33,33,31,51,93,53
Dublin,300,150,150,6468.86,45,34,64,95,62
Dublin,366,194,172,37.69,69,42,107,108,40
Dublin,355,184,171,90.83,59,51,95,109,41
Dublin,237,133,104,3953.62,30,28,70,80,29
Dublin,379,178,201,8002.2,132,32,139,65,11
Dublin,356,175,181,1378.81,97,37,161,39,22
Dublin,280,136,144,4033.01,56,24,142,45,13
Dublin,279,146,133,7335.54,47,50,78,70,34
Dublin,901,440,461,726.77,69,100,359,236,137
Dublin,223,114,109,4743.97,45,35,59,49,35
Dublin,224,108,116,3136.03,28,29,64,74,29
Dublin,184,99,85,6708.96,40,18,76,41,9
Dublin,198,102,96,10940.44,31,17,126,18,6
Dublin,149,68,81,1344.03,33,17,49,26,24
Dublin,354,167,187,3366.88,37,32,64,85,136
Dublin,255,126,129,4247.73,32,18,62,69,74
Dublin,242,115,127,4093.44,54,25,53,56,54
Dublin,264,125,139,3179.65,41,24,50,72,77
Dublin,274,136,138,2488.1,54,40,58,60,62
Dublin,234,108,126,4040.26,34,27,32,59,82
Dublin,220,111,109,3750.81,39,27,54,62,38
Dublin,181,88,93,4916.07,33,10,38,42,58
Dublin,180,92,88,3068.37,21,16,44,36,63
Dublin,239,102,137,4928.14,31,22,43,61,82
Dublin,248,118,130,3350.26,45,24,54,63,62
Dublin,411,188,223,3467.21,75,64,61,124,87
Dublin,259,120,139,4377.81,42,25,42,73,77
Dublin,229,101,128,3682.68,32,20,62,50,65
Dublin,318,140,178,5973.51,64,33,89,82,50
Dublin,228,107,121,3319.7,31,12,39,41,105
Dublin,186,93,93,4323.97,36,15,34,42,59
Dublin,259,127,132,4016.62,42,33,59,54,71
Dublin,185,98,87,2062.55,34,24,31,45,51
Dublin,194,93,101,3017.72,20,25,35,40,74
Dublin,277,143,134,3483.53,33,35,60,78,71
Dublin,184,91,93,3222.3,21,29,26,66,42
Dublin,246,124,122,5083.06,56,50,39,71,30
Dublin,207,99,108,9521.18,16,16,134,25,16
Dublin,434,202,232,5777.5,125,44,122,93,50
Dublin,265,132,133,6702.24,86,30,92,50,7
Dublin,330,153,177,6491.72,16,61,66,145,42
Dublin,236,115,121,10028.9,58,34,52,76,16
Dublin,173,74,99,4635.21,19,4,111,11,28
Dublin,293,142,151,8007.87,41,53,66,114,19
Dublin,259,131,128,6701.68,46,48,52,98,15
Dublin,298,137,161,6067.52,45,50,56,86,61
Dublin,265,131,134,4738.74,49,36,61,66,53
Dublin,438,204,234,5639.32,69,88,88,165,28
Dublin,343,176,167,5210.71,54,74,69,132,14
Dublin,297,151,146,4384.15,61,65,44,111,16
Dublin,281,132,149,7789.11,67,48,60,85,21
Dublin,198,82,116,21194.61,31,8,133,15,11
Dublin,134,59,75,6289.9,16,4,94,16,4
Dublin,271,140,131,5268.68,52,44,70,74,31
Dublin,250,121,129,4382.43,80,23,73,67,7
Dublin,273,141,132,4242.62,61,41,69,73,29
Dublin,220,105,115,5692.26,53,19,44,49,55
Dublin,205,102,103,3664.97,36,20,54,49,46
Dublin,430,201,229,5909.84,68,75,82,152,53
Dublin,172,80,92,4147.28,25,16,39,51,41
Dublin,353,164,189,4248.25,51,45,80,89,88
Dublin,210,102,108,3043.65,28,34,47,79,22
Dublin,204,99,105,5192.82,32,28,66,41,37
Dublin,212,95,117,3891.41,48,17,51,53,43
Dublin,340,164,176,5826.81,59,41,93,72,75
Dublin,206,97,109,4069.14,34,29,57,51,35
Dublin,415,203,212,1527.5,78,77,93,144,23
Dublin,246,125,121,2677.67,49,36,68,73,20
Dublin,247,114,133,3755.23,40,39,74,72,22
Dublin,262,132,130,6251.79,47,44,57,92,22
Dublin,121,48,73,3745.78,14,6,65,25,11
Dublin,137,68,69,4244.51,8,9,50,46,24
Dublin,275,130,145,3054.88,47,28,65,76,59
Dublin,212,101,111,5391.11,18,29,58,73,34
Dublin,144,62,82,4876.89,12,10,60,37,25
Dublin,297,146,151,6062.21,73,58,68,88,10
Dublin,319,156,163,4118.47,64,32,84,77,62
Dublin,169,91,78,1781.63,15,19,105,24,6
Dublin,326,146,180,7147.87,39,65,55,116,51
Dublin,227,105,122,3247.03,41,26,73,62,25
Dublin,204,93,111,2721.56,22,16,75,43,48
Dublin,357,159,198,3824.97,63,46,44,108,96
Dublin,326,168,158,4128.99,58,41,81,83,63
Dublin,304,155,149,1175.91,83,38,61,92,30
Dublin,242,116,126,809.47,56,34,60,72,20
Dublin,328,167,161,1048.42,77,35,97,79,40
Dublin,335,168,167,598.47,78,50,80,95,32
Dublin,331,166,165,721.89,70,40,104,85,32
Dublin,309,136,173,3473.47,98,30,111,36,34
Dublin,325,154,171,1507.87,74,40,79,97,35
Dublin,452,218,234,3486.98,113,61,151,99,28
Dublin,341,167,174,1906.01,57,68,86,89,41
Dublin,230,119,111,2652.86,47,22,66,66,29
Dublin,254,128,126,2367.06,84,22,108,36,4
Dublin,445,223,222,4863.65,115,74,135,103,18
Dublin,272,138,134,1558.58,45,41,82,68,36
Dublin,343,174,169,2118.71,74,37,136,64,32
Dublin,331,168,163,2458.59,77,42,118,71,23
Dublin,361,170,191,3826.54,87,48,128,77,21
Dublin,295,152,143,352.56,83,31,111,60,10
Dublin,256,129,127,8468.13,73,14,145,22,2
Dublin,253,129,124,2867.21,56,30,56,70,41
Dublin,304,157,147,5505.25,39,31,81,75,78
Dublin,249,112,137,3759.28,84,19,114,18,14
Dublin,306,150,156,8282.36,108,18,140,32,8
Dublin,99,52,47,419.78,18,14,28,31,8
Dublin,233,92,141,1951.78,41,13,96,29,54
Dublin,261,134,127,2335.53,65,15,146,27,8
Dublin,430,229,201,3305.73,109,82,127,98,14
Dublin,263,128,135,212.86,72,28,101,50,12
Dublin,343,166,177,8029.03,100,52,94,87,10
Dublin,333,146,187,4286.98,115,36,121,56,5
Dublin,368,181,187,952.28,93,54,119,69,33
Dublin,220,126,94,79.59,47,23,70,49,31
Dublin,331,164,167,71.61,75,30,110,74,42
Dublin,285,109,176,83.09,34,24,57,68,102
Dublin,193,110,83,337.61,43,21,84,30,15
Dublin,179,94,85,3888.18,45,18,104,12,0
Dublin,303,143,160,1736.91,60,24,186,27,6
Dublin,293,147,146,1014.75,73,31,111,42,36
Dublin,165,86,79,10752.69,48,5,99,13,0
Dublin,297,156,141,14122.68,86,14,183,14,0
Dublin,199,108,91,4955.55,49,30,107,13,0
Dublin,207,104,103,9651.25,42,26,113,23,3
Dublin,131,58,73,3545.43,15,21,65,24,6
Dublin,257,138,119,218.05,49,40,102,41,25
Dublin,305,144,161,55.16,49,43,68,95,50
Dublin,269,134,135,200.61,68,38,43,89,31
Dublin,279,128,151,376.55,45,50,75,84,25
Dublin,264,129,135,60.72,55,43,65,67,34
Dublin,296,143,153,4048.42,78,37,96,68,17
Dublin,348,169,179,9200.75,115,24,133,53,23
Dublin,290,138,152,6616.17,91,57,87,46,9
Dublin,358,183,175,568.96,100,57,105,62,34
Dublin,251,121,130,332.84,48,26,104,50,23
Dublin,436,196,240,3484.54,84,66,96,119,71
Dublin,227,101,126,17493.83,25,11,172,13,6
Dublin,244,109,135,3689.2,54,21,84,58,27
Dublin,587,279,308,3088.03,202,65,178,105,37
Dublin,297,154,143,406.62,40,70,40,111,36
Dublin,356,163,193,6765.87,63,41,132,79,41
Dublin,226,107,119,2763.11,60,33,64,57,12
Dublin,320,157,163,1762.28,62,44,77,85,52
Dublin,329,167,162,1955.61,57,57,85,110,20
Dublin,395,190,205,4527.69,77,72,99,128,19
Dublin,320,125,195,2873.02,50,39,69,58,104
Dublin,330,164,166,6784.54,58,47,102,95,28
Dublin,304,155,149,4999.26,71,35,96,63,39
Dublin,348,161,187,2528.37,52,59,82,100,55
Dublin,406,205,201,3682.27,126,53,95,98,34
Dublin,277,115,162,3286.78,45,37,63,77,55
Dublin,296,156,140,3452.26,57,42,69,87,41
Dublin,245,124,121,2420.23,56,35,63,49,42
Dublin,372,190,182,2061.65,60,46,149,79,38
Dublin,411,207,204,7486.61,104,56,138,103,10
Dublin,348,171,177,309.83,93,54,101,93,7
Dublin,342,170,172,777.1,67,50,82,105,38
Dublin,310,153,157,4004.81,65,26,120,53,46
Dublin,260,129,131,3635.75,42,23,54,53,88
Dublin,282,139,143,6268.9,46,33,97,49,57
Dublin,217,113,104,3582.63,37,24,28,69,59
Dublin,273,127,146,8332.32,82,27,79,68,17
Dublin,272,128,144,565.92,66,43,85,61,17
Dublin,451,235,216,4814.52,95,86,93,152,25
Dublin,256,133,123,5057.99,49,46,70,85,6
Dublin,369,174,195,5860.86,67,43,92,100,67
Dublin,222,100,122,6694.21,49,34,69,61,9
Dublin,296,140,156,7773.72,64,56,69,92,15
Dublin,335,163,172,12427.2,58,51,111,98,17
Dublin,318,163,155,3018.71,78,50,100,85,5
Dublin,207,102,105,7013.15,62,26,101,16,2
Dublin,284,125,159,11475.21,101,20,126,28,9
Dublin,384,185,199,9339.2,152,13,189,26,4
Dublin,395,184,211,4998.86,168,30,153,38,6
Dublin,427,199,228,4409.97,113,108,92,106,8
Dublin,293,141,152,11210.16,129,14,113,29,8
Dublin,274,118,156,8324.47,110,12,98,35,19
Dublin,284,137,147,2533.38,92,30,72,57,33
Dublin,362,188,174,7139.62,61,65,95,104,37
Dublin,310,143,167,5869.88,95,42,95,70,8
Dublin,263,130,133,5336.31,95,25,81,50,12
Dublin,449,218,231,7652.45,165,59,108,104,13
Dublin,303,154,149,6961.84,93,53,71,78,8
Dublin,214,98,116,4788.11,46,22,60,50,36
Dublin,412,207,205,4391.11,75,94,76,152,15
Dublin,284,142,142,6775.94,73,40,65,84,22
Dublin,212,95,117,3794.25,36,19,55,66,36
Dublin,155,77,78,1952.24,30,21,48,41,15
Dublin,229,114,115,2903.03,46,24,76,52,31
Dublin,287,143,144,2262.98,40,45,47,84,71
Dublin,223,114,109,2606.39,37,29,47,68,42
Dublin,190,94,96,716.44,25,8,32,62,63
Dublin,249,130,119,2049.6,38,28,76,68,39
Dublin,235,120,115,2264.51,26,36,51,85,37
Dublin,351,180,171,2358.11,96,37,101,96,21
Dublin,196,89,107,4585.65,25,28,44,63,36
Dublin,163,76,87,3543.63,19,25,28,62,29
Dublin,145,69,76,5650.38,23,13,56,34,19
Dublin,163,80,83,2702.97,35,21,53,31,23
Dublin,182,81,101,4418.01,16,14,58,54,40
Dublin,208,101,107,1237.77,29,23,46,73,37
Dublin,319,155,164,4739.13,38,55,61,110,55
Dublin,182,58,124,870.53,16,25,24,43,74
Dublin,261,124,137,2982.18,15,45,40,90,71
Dublin,298,140,158,3335.76,63,52,47,80,56
Dublin,243,108,135,1315.39,50,38,54,65,36
Dublin,411,197,214,4131.94,85,66,76,103,81
Dublin,226,109,117,3890.31,57,43,41,58,27
Dublin,325,155,170,3866.61,78,31,68,94,54
Dublin,178,84,94,3107.98,35,19,33,44,47
Dublin,350,158,192,4187.15,77,55,69,96,53
Dublin,222,106,116,4009.83,37,25,52,50,58
Dublin,251,128,123,6199.52,51,44,52,70,34
Dublin,249,134,115,1950.88,57,24,112,39,17
Dublin,242,124,118,5426.5,39,37,46,75,45
Dublin,259,129,130,2990.9,29,37,52,72,69
Dublin,188,84,104,4481.42,30,31,46,45,36
Dublin,261,127,134,4981.49,41,41,65,55,59
Dublin,254,126,128,5470.48,34,25,45,79,71
Dublin,258,134,124,5695.99,43,36,54,68,57
Dublin,240,115,125,3826.84,28,40,36,77,59
Dublin,253,118,135,5433.85,32,41,55,67,58
Dublin,152,68,84,9412.93,19,31,88,12,2
Dublin,254,114,140,6266.81,58,25,96,45,30
Dublin,325,155,170,3924.74,67,42,81,74,61
Dublin,190,88,102,2595.34,34,26,40,47,43
Dublin,230,110,120,4544.11,35,24,60,57,54
Dublin,210,106,104,2409.09,43,22,51,46,48
Dublin,212,104,108,3577.7,34,44,31,61,42
Dublin,251,105,146,3933.68,27,21,111,43,49
Dublin,307,150,157,4909.02,38,25,69,79,96
Dublin,229,102,127,5496.22,24,46,41,93,25
Dublin,326,160,166,4103.05,62,49,72,98,45
Dublin,142,66,76,28710.07,16,18,84,20,4
Dublin,398,194,204,3086.52,43,60,86,122,87
Dublin,224,105,119,14906.5,20,23,158,17,6
Dublin,324,153,171,4413.87,58,53,59,103,51
Dublin,384,187,197,3431.6,73,56,60,128,67
Dublin,253,119,134,676.96,76,33,58,69,17
Dublin,236,106,130,3803.87,50,26,60,58,42
Dublin,230,111,119,2479.44,51,30,54,45,50
Dublin,152,64,88,2636.19,13,20,33,45,41
Dublin,163,71,92,1448.46,38,18,65,23,19
Dublin,267,112,155,3736.25,33,45,116,47,26
Dublin,307,150,157,8050.35,99,54,73,73,8
Dublin,234,107,127,2411.23,34,35,54,79,32
Dublin,194,104,90,4728.94,22,36,27,45,64
Dublin,354,167,187,3964.79,79,63,67,104,41
Dublin,385,187,198,3316.14,83,66,67,118,51
Dublin,324,147,177,2209.9,47,64,75,83,55
Dublin,261,124,137,2589.49,60,39,58,71,33
Dublin,188,91,97,2396.77,28,32,56,47,25
Dublin,233,110,123,2173.39,51,28,44,56,54
Dublin,318,137,181,3434.16,61,49,45,98,65
Dublin,344,147,197,2432.51,61,53,59,90,81
Dublin,255,115,140,3039.88,45,42,64,64,40
Dublin,392,178,214,3291.63,72,69,58,134,59
Dublin,334,168,166,4814.48,51,46,112,72,53
Dublin,262,128,134,3925.92,40,36,68,67,51
Dublin,243,118,125,2445.33,43,35,49,70,46
Dublin,351,167,184,4129.85,61,45,122,79,44
Dublin,237,114,123,13678.07,45,13,159,16,4
Dublin,155,65,90,17245.22,11,8,105,19,12
Dublin,204,90,114,1340.17,32,23,67,46,36
Dublin,385,192,193,7084.24,49,48,95,132,61
Dublin,310,157,153,4182.52,45,31,68,88,78
Dublin,213,102,111,7592.23,22,22,49,91,29
Dublin,288,140,148,9017.19,48,40,62,93,45
Dublin,228,113,115,5266.56,42,21,56,62,47
Dublin,201,88,113,4077.58,35,24,55,64,23
Dublin,249,122,127,6421.99,42,33,69,63,42
Dublin,174,81,93,6366.86,35,27,55,39,18
Dublin,235,117,118,5579.3,33,21,68,72,41
Dublin,292,131,161,4714.47,51,38,66,84,53
Dublin,253,121,132,6234.6,45,29,52,57,70
Dublin,175,86,89,4076.02,29,12,62,37,35
Dublin,198,85,113,1500.56,34,32,31,52,49
Dublin,284,137,147,6116.47,41,33,51,79,80
Dublin,199,102,97,3745.46,19,23,37,51,69
Dublin,281,127,154,5894.82,67,29,41,72,72
Dublin,337,158,179,3582.25,49,34,83,85,86
Dublin,298,147,151,1256.94,52,34,92,76,44
Dublin,289,129,160,4891.01,47,40,85,71,46
Dublin,241,111,130,4814.9,44,20,66,79,32
Dublin,275,136,139,8079.92,46,20,108,69,32
Dublin,460,247,213,138.87,113,59,194,73,21
Dublin,195,101,94,2544.26,11,30,33,52,69
Dublin,324,167,157,4177.3,36,38,68,98,84
Dublin,250,126,124,4728.31,33,22,54,71,70
Dublin,269,138,131,4642.57,34,21,84,73,57
Dublin,249,126,123,6028.91,41,29,64,80,35
Dublin,216,106,110,4023.99,33,18,46,61,58
Dublin,272,149,123,6209.05,43,24,73,58,74
Dublin,388,187,201,7241.37,92,52,105,115,24
Dublin,422,205,217,7327.53,112,58,134,85,33
Dublin,258,134,124,8555.8,75,27,124,29,3
Dublin,274,133,141,7721.35,111,21,90,49,3
Dublin,340,175,165,4208.55,50,41,108,98,43
Dublin,317,168,149,4090.38,56,53,88,91,29
Dublin,278,144,134,9038.59,90,27,141,18,2
Dublin,274,119,155,9782.57,85,17,149,21,2
Dublin,225,112,113,6495.19,52,43,70,57,3
Dublin,311,155,156,9075.52,88,56,85,70,12
Dublin,305,153,152,10382.98,105,51,91,55,3
Dublin,301,156,145,10116.97,105,45,105,44,2
Dublin,428,210,218,9149.21,147,58,154,66,3
Dublin,272,139,133,3206.79,73,57,62,69,11
Dublin,310,174,136,10545.65,90,51,94,68,7
Dublin,438,219,219,10535.43,101,80,114,124,19
Dublin,372,189,183,5877.8,99,62,128,78,5
Dublin,476,239,237,190.44,163,40,203,61,9
Dublin,536,272,264,1444.58,241,35,197,60,3
Dublin,322,155,167,6957.5,40,62,63,136,21
Dublin,355,170,185,5676.09,40,52,87,126,50
Dublin,414,198,216,5961.04,67,79,82,176,10
Dublin,267,137,130,13144.29,47,32,169,15,4
Dublin,225,115,110,13357.08,51,15,145,12,2
Dublin,187,90,97,9868.59,32,17,123,12,3
Dublin,309,149,160,11541.91,91,10,188,17,3
Dublin,270,129,141,10297.48,77,18,153,21,1
Dublin,257,123,134,222.05,54,18,164,20,1
Dublin,259,114,145,4055.43,66,17,144,29,3
Dublin,292,144,148,4014.24,48,53,76,79,36
Dublin,253,120,133,9052.2,55,14,160,20,4
Dublin,255,122,133,8370.54,50,17,165,21,2
Dublin,273,135,138,9745.48,92,20,136,20,5
Dublin,246,110,136,8937.65,62,27,126,27,4
Dublin,298,151,147,6177.06,103,23,132,36,4
Dublin,245,134,111,10491.16,43,63,52,81,6
Dublin,305,148,157,8214.6,49,62,77,106,11
Dublin,329,157,172,10014,73,78,89,81,8
Dublin,301,143,158,3808.05,82,65,66,81,7
Dublin,346,178,168,12120.36,75,66,80,114,11
Dublin,224,111,113,5834.4,35,33,76,69,11
Dublin,260,129,131,9520.32,42,54,66,86,12
Dublin,285,143,142,7639.11,48,66,53,105,13
Dublin,251,112,139,2698.26,46,25,75,75,30
Dublin,318,141,177,10305.94,74,62,88,80,14
Dublin,359,173,186,10370.33,93,55,119,84,8
Dublin,202,96,106,11535.61,40,22,107,28,5
Dublin,237,113,124,9704.36,59,25,129,21,3
Dublin,356,160,196,6099.13,119,27,164,39,7
Dublin,379,191,188,5811.99,55,73,98,132,21
Dublin,282,149,133,6540.65,63,59,88,68,4
Dublin,246,122,124,6492.99,63,18,127,30,8
Dublin,365,180,185,12275.92,96,33,189,44,3
Dublin,354,172,182,1098.3,94,46,156,51,7
Dublin,285,127,158,3742.27,74,13,168,25,5
Dublin,274,140,134,4469.97,28,54,63,119,10
Dublin,319,143,176,8852.5,83,13,205,18,0
Dublin,436,211,225,9034.96,109,19,290,13,5
Dublin,368,173,195,6734.5,70,76,84,128,10
Dublin,274,134,140,11837.9,85,40,86,61,2
Dublin,403,195,208,599.81,84,79,130,89,21
Dublin,397,200,197,9567.88,40,71,103,174,9
Dublin,292,157,135,41.09,69,50,70,79,24
Dublin,277,145,132,7314.5,38,52,66,104,17
Dublin,185,91,94,4674.79,28,21,44,49,43
Dublin,269,145,124,5411.93,54,57,77,71,10
Dublin,444,235,209,8041.15,135,44,192,64,9
Dublin,244,125,119,5801.1,81,21,124,16,2
Dublin,378,189,189,7499.11,148,18,187,21,4
Dublin,431,223,208,7401.68,161,31,197,37,5
Dublin,377,177,200,5170.12,115,53,132,71,6
Dublin,405,216,189,10141.48,129,41,168,63,4
Dublin,254,135,119,7145.87,71,24,131,25,3
Dublin,231,103,128,10136.91,68,14,103,33,13
Dublin,235,120,115,13436.25,41,34,140,20,0
Dublin,269,139,130,12267.42,46,30,173,18,2
Dublin,297,145,152,12465.37,97,26,143,27,4
Dublin,189,95,94,7569.69,43,24,109,12,1
Dublin,367,163,204,7806.85,92,39,207,29,0
Dublin,151,75,76,21960.44,35,26,79,9,2
Dublin,272,133,139,10882.18,90,19,141,22,0
Dublin,204,96,108,12533.02,58,11,124,9,2
Dublin,212,96,116,7909.86,80,12,112,7,1
Dublin,273,139,134,8018.33,70,21,159,22,1
Dublin,318,149,169,6517.46,86,23,179,24,6
Dublin,208,101,107,9332.79,66,11,118,11,2
Dublin,293,138,155,8920.69,98,13,167,15,0
Dublin,296,152,144,1220.21,105,12,158,18,3
Dublin,428,209,219,2850.05,40,64,92,160,72
Dublin,211,99,112,6680.39,13,53,38,91,16
Dublin,239,128,111,7532.3,32,33,77,73,24
Dublin,188,95,93,3282.87,35,24,124,5,0
Dublin,462,263,199,47.41,74,69,112,149,58
Dublin,370,169,201,3389.33,103,70,136,56,5
Dublin,398,197,201,856.3,83,99,112,93,11
Dublin,325,157,168,5604.22,62,52,85,106,20
Dublin,328,176,152,954.01,40,39,100,109,40
Dublin,324,164,160,1886.89,64,57,106,85,12
Dublin,96,46,50,3449.64,11,10,67,8,0
Dublin,129,56,73,4461.97,22,15,82,10,0
Dublin,299,145,154,2817.72,38,39,131,53,38
Dublin,274,141,133,5979.92,43,42,75,97,17
Dublin,359,192,167,9020.55,79,65,107,102,6
Dublin,333,155,178,533.21,71,49,118,78,17
Dublin,290,150,140,11229.43,119,23,101,41,6
Dublin,291,153,138,8714.4,119,22,108,33,9
Dublin,367,182,185,11922.55,142,23,140,59,3
Dublin,273,132,141,10814.45,69,26,146,23,9
Dublin,276,133,143,16176.3,55,32,166,17,6
Dublin,188,93,95,13087.37,37,19,108,19,5
Dublin,142,73,69,3061.73,28,8,48,29,29
Dublin,281,134,147,8136.91,81,35,93,64,8
Dublin,365,177,188,11432.33,99,73,77,103,13
Dublin,334,168,166,8306.6,74,70,58,117,15
Dublin,341,176,165,8743.59,66,92,53,116,14
Dublin,320,152,168,1908.76,83,69,69,84,15
Dublin,297,164,133,1981.19,31,33,191,32,10
Dublin,420,217,203,4630.75,68,82,130,111,29
Dublin,83,40,43,2561.33,11,6,29,23,14
Dublin,194,84,110,2870.84,17,23,49,49,56
Dublin,348,170,178,2682.62,62,50,103,70,63
Dublin,141,76,65,2139.41,18,18,78,21,6
Dublin,226,113,113,7516.3,37,26,76,66,21
Dublin,276,126,150,5256.74,36,31,83,87,39
Dublin,291,136,155,4840.24,42,40,87,86,36
Dublin,98,39,59,2991,13,8,59,12,6
Dublin,207,94,113,1002.2,22,30,120,22,13
Dublin,305,154,151,7012.3,70,45,93,40,57
Dublin,197,97,100,3108.58,22,19,64,43,49
Dublin,318,133,185,6773.31,59,37,74,55,93
Dublin,216,104,112,4587.16,40,24,67,48,37
Dublin,196,92,104,1570.76,53,22,52,38,31
Dublin,207,92,115,7970.74,37,23,60,40,47
Dublin,174,85,89,6110.19,29,17,48,40,40
Dublin,368,193,175,147.83,55,56,124,99,34
Dublin,365,189,176,4727.37,47,60,96,114,48
Dublin,245,124,121,7804.04,42,41,64,78,20
Dublin,274,144,130,5397.21,25,42,74,84,49
Dublin,225,111,114,8919.02,40,37,71,61,16
Dublin,217,106,111,2966.39,41,21,74,52,29
Dublin,433,183,250,992.04,65,17,203,10,138
Dublin,222,102,120,156.12,44,15,149,11,3
Dublin,317,152,165,7439.57,107,55,114,39,2
Dublin,279,131,148,11552.8,131,36,85,25,2
Dublin,236,106,130,9805.14,83,42,71,34,6
Dublin,273,128,145,12720.16,79,68,72,51,3
Dublin,358,163,195,3991.44,111,56,100,84,7
Dublin,267,128,139,7094.08,94,47,72,48,6
Dublin,292,134,158,9065.79,83,58,81,65,5
Dublin,464,221,243,3783.09,135,83,134,97,15
Dublin,374,181,193,10657.09,93,51,105,92,33
Dublin,300,149,151,9030.43,80,49,98,64,9
Dublin,554,261,293,1547.94,227,74,171,76,6
Dublin,320,163,157,9245.35,127,32,133,26,2
Dublin,218,105,113,9781.05,82,22,99,15,0
Dublin,393,191,202,8429.86,132,79,103,65,14
Dublin,259,147,112,1419.85,55,20,144,26,14
Dublin,305,145,160,251.82,114,38,94,51,8
Dublin,440,210,230,6539.83,182,77,130,44,7
Dublin,352,161,191,3405.57,96,87,88,63,18
Dublin,267,126,141,10937.69,81,43,73,56,14
Dublin,406,193,213,6008.67,132,55,124,86,9
Dublin,278,141,137,7090.39,68,42,106,54,8
Dublin,180,87,93,3237.06,17,21,107,26,9
Dublin,363,173,190,5289.62,66,60,210,23,4
Dublin,197,94,103,9064.14,36,19,91,34,17
Dublin,205,104,101,5717.63,43,19,55,51,37
Dublin,265,133,132,5772.67,40,42,71,84,28
Dublin,249,115,134,6684.74,34,25,67,75,48
Dublin,264,144,120,1681.65,39,34,84,93,14
Dublin,197,96,101,10345.01,48,15,114,17,3
Dublin,433,225,208,7115.62,139,24,223,45,2
Dublin,347,172,175,10420.11,121,36,150,36,4
Dublin,316,158,158,7635.8,117,31,128,36,4
Dublin,346,157,189,12752.47,121,27,184,13,1
Dublin,236,109,127,10537.6,67,12,143,14,0
Dublin,277,134,143,5667.87,57,27,150,34,9
Dublin,210,111,99,4930.73,60,19,100,27,4
Dublin,218,114,104,4543.18,71,11,125,11,0
Dublin,218,114,104,8749.4,75,14,114,14,1
Dublin,207,96,111,7099.01,68,40,55,38,6
Dublin,344,171,173,4122.53,115,43,100,78,8
Dublin,372,170,202,4172.6,126,60,122,60,4
Dublin,263,126,137,10222.72,102,45,88,25,3
Dublin,182,93,89,7303.37,48,14,115,4,1
Dublin,176,85,91,10818.12,44,18,110,4,0
Dublin,291,131,160,11538.46,103,53,89,39,7
Dublin,217,94,123,2642.06,80,37,61,34,5
Dublin,202,103,99,9036.01,46,39,56,51,10
Dublin,345,167,178,9275.44,158,18,152,16,1
Dublin,396,193,203,6277.94,128,42,154,59,13
Dublin,352,182,170,4820,120,39,151,36,6
Dublin,285,135,150,593.68,127,31,103,24,0
Dublin,161,74,87,5704.16,35,8,111,7,0
Dublin,308,147,161,11286.6,44,43,210,11,0
Dublin,305,149,156,3931.22,109,16,156,22,2
Dublin,274,136,138,10648.63,83,27,132,25,7
Dublin,285,136,149,8864.15,62,53,67,86,17
Dublin,298,136,162,7707.23,63,69,87,61,18
Dublin,328,162,166,8302.12,85,70,75,89,9
Dublin,254,128,126,7614.59,53,56,69,68,8
Dublin,418,212,206,9061.54,123,75,135,77,8
Dublin,269,121,148,10580.55,107,27,100,33,2
Dublin,283,134,149,7854.35,100,20,125,34,4
Dublin,209,99,110,11166.92,67,27,106,7,2
Dublin,461,231,230,9555.39,196,54,164,46,1
Dublin,342,150,192,13050.45,111,57,109,57,8
Dublin,336,155,181,1675.38,123,53,91,53,16
Dublin,250,117,133,15153.35,107,18,103,20,2
Dublin,275,143,132,12234.73,106,28,119,22,0
Dublin,435,213,222,8889.52,187,44,172,32,0
Dublin,299,152,147,7360,115,39,126,17,2
Dublin,464,220,244,12230.8,173,65,137,73,16
Dublin,450,201,249,23381.48,233,54,131,29,3
Dublin,443,220,223,9784.22,175,53,182,28,5
Dublin,220,96,124,15125.47,111,17,79,12,1
Dublin,228,107,121,13648.61,84,27,100,14,3
Dublin,308,153,155,4135.39,66,57,92,71,22
Dublin,243,117,126,7226.55,55,40,63,72,13
Dublin,257,128,129,6319.15,81,54,67,47,8
Dublin,260,126,134,8764.24,54,57,74,66,9
Dublin,506,216,290,10237.32,258,43,171,32,2
Dublin,256,128,128,12990.97,85,13,148,10,0
Dublin,287,147,140,15609.7,55,36,177,16,3
Dublin,410,198,212,9888.57,112,63,121,98,16
Dublin,324,165,159,4956.93,74,45,88,94,23
Dublin,354,179,175,4606.92,94,49,99,96,16
Dublin,310,132,178,4117.63,69,52,83,80,26
Dublin,247,125,122,9445.15,59,47,67,62,12
Dublin,335,169,166,9418.05,67,63,103,83,19
Dublin,402,193,209,6025,111,81,104,93,13
Dublin,484,239,245,12653.59,155,106,115,102,6
Dublin,351,168,183,5940.8,73,51,90,102,35
Dublin,397,188,209,1982.27,153,67,139,33,5
Dublin,301,142,159,5063.76,48,47,84,98,24
Dublin,297,144,153,5838.18,43,45,79,100,30
Dublin,350,182,168,6467.23,73,50,115,102,10
Dublin,340,161,179,4526.94,57,54,76,125,28
Dublin,360,182,178,4502.53,49,78,74,133,26
Dublin,406,194,212,8525.11,95,79,84,139,9
Dublin,234,123,111,3692.31,25,45,67,87,10
Dublin,396,193,203,5594.88,68,47,117,137,27
Dublin,364,189,175,3941.74,42,64,85,135,38
Dublin,244,134,110,4402.19,42,29,69,78,26
Dublin,308,163,145,4126.81,31,45,85,128,19
Dublin,282,138,144,7761.75,46,40,79,102,15
Dublin,247,116,131,2531.13,43,36,59,85,24
Dublin,304,150,154,8423.39,44,55,63,122,20
Dublin,320,164,156,243.6,53,56,85,100,26
Dublin,296,141,155,440.48,77,34,150,25,10
Dublin,484,246,238,7013.37,142,85,135,109,13
Dublin,354,153,201,8206.6,117,54,101,72,10
Dublin,293,134,159,12081.98,81,57,75,67,13
Dublin,471,212,259,9376.87,183,67,141,74,6
Dublin,529,249,280,11184.88,187,91,139,103,9
Dublin,132,65,67,15512.99,28,18,81,5,0
Dublin,143,62,81,13498.21,31,16,84,9,3
Dublin,273,121,152,11150.59,116,26,109,19,3
Dublin,253,119,134,2413.36,46,35,96,63,13
Dublin,300,149,151,9297.71,51,48,85,109,7
Dublin,250,113,137,10423.62,88,31,115,15,1
Dublin,343,176,167,2723.26,114,35,182,12,0
Dublin,211,100,111,7437.17,61,13,90,27,20
Dublin,276,142,134,6789.5,66,53,83,62,12
Dublin,425,220,205,6417.9,105,62,137,112,9
Dublin,324,155,169,8276.92,76,53,96,86,13
Dublin,353,176,177,9883.53,125,19,196,13,0
Dublin,353,165,188,17980.85,150,34,137,30,2
Dublin,242,105,137,14308.52,105,19,96,20,2
Dublin,278,144,134,7166.24,56,51,69,80,22
Dublin,281,141,140,8891.56,32,49,75,104,21
Dublin,378,203,175,7819.45,79,73,114,101,11
Dublin,315,157,158,13408.82,94,18,190,12,1
Dublin,252,117,135,6490.83,67,37,95,49,4
Dublin,259,116,143,12118.09,80,14,151,10,4
Dublin,168,79,89,4638.45,35,21,89,20,3
Dublin,400,206,194,718.61,81,58,117,114,30
Dublin,232,134,98,519.2,23,56,103,33,17
Dublin,196,93,103,4627.66,30,26,69,48,23
Dublin,250,122,128,4276.5,36,42,57,101,14
Dublin,186,85,101,4119.88,34,15,62,52,23
Dublin,220,101,119,5065.04,34,42,69,60,15
Dublin,204,98,106,2009.28,38,16,79,48,23
Dublin,349,178,171,2696.38,53,56,85,121,34
Dublin,317,161,156,5596.55,47,62,91,102,15
Dublin,243,114,129,8919.72,37,37,61,98,10
Dublin,253,127,126,6328.96,40,38,76,90,9
Dublin,286,147,139,7136.98,41,42,82,109,12
Dublin,301,154,147,7403.03,38,54,75,108,26
Dublin,369,186,183,6865.12,70,63,107,112,17
Dublin,356,176,180,1878.52,44,41,97,90,84
Dublin,207,100,107,7516.61,25,11,56,48,67
Dublin,348,183,165,9235.42,62,45,105,82,54
Dublin,358,170,188,8842.34,50,50,99,107,52
Dublin,272,131,141,3433.22,48,34,74,71,45
Dublin,273,134,139,4056.7,54,25,83,48,63
Dublin,233,108,125,9138.69,43,24,65,66,35
Dublin,292,142,150,7938.67,50,26,87,76,53
Dublin,188,96,92,7899.82,27,20,54,39,48
Dublin,187,98,89,8258.26,29,15,49,35,59
Dublin,309,145,164,6848.1,60,49,72,88,40
Dublin,267,133,134,7816.39,34,29,55,66,83
Dublin,285,140,145,3965.88,43,37,83,80,42
Dublin,271,138,133,4931.94,38,37,75,89,32
Dublin,413,215,198,8660.1,81,69,113,117,33
Dublin,376,188,188,6319.86,61,67,104,127,17
Dublin,391,206,185,499.34,74,61,117,108,31
Dublin,301,152,149,4701.8,55,38,83,88,37
Dublin,335,169,166,8199.33,43,54,99,103,36
Dublin,402,195,207,5671.08,56,52,100,127,67
Dublin,257,124,133,7663.18,36,52,66,67,36
Dublin,228,104,124,4275.67,31,31,62,64,40
Dublin,212,108,104,6219.93,33,24,61,54,40
Dublin,308,143,165,5680.67,34,30,93,97,54
Dublin,302,155,147,6214.12,70,22,103,49,58
Dublin,446,238,208,11932.47,55,49,260,61,21
Dublin,202,89,113,4139.17,39,32,46,65,20
Dublin,281,144,137,5109.65,56,41,76,76,32
Dublin,177,83,94,38353.2,46,10,97,20,4
Dublin,156,77,79,45034.64,27,20,98,11,0
Dublin,471,228,243,57777.23,112,45,296,17,1
Dublin,451,234,217,46466.1,75,57,303,16,0
Dublin,261,127,134,32226.2,46,42,151,22,0
Dublin,222,113,109,5308.21,33,35,59,72,23
Dublin,233,114,119,12328.04,44,40,73,68,8
Dublin,210,106,104,7621.67,25,23,64,72,26
Dublin,346,182,164,10267.06,80,46,108,88,24
Dublin,344,172,172,8855.02,83,44,103,86,28
Dublin,316,163,153,9928.05,95,29,110,60,22
Dublin,377,183,194,7748.27,89,44,118,102,24
Dublin,400,212,188,5977.46,98,49,116,104,33
Dublin,224,114,110,9255.43,43,27,64,66,24
Dublin,293,136,157,12494.67,69,36,98,70,20
Dublin,238,120,118,12467.91,42,34,73,71,18
Dublin,224,114,110,9751.43,42,26,66,67,23
Dublin,378,196,182,6482.48,94,61,111,95,17
Dublin,213,101,112,7005.89,47,26,68,61,11
Dublin,242,111,131,5625.29,34,42,69,86,11
Dublin,332,161,171,17927.53,51,31,189,58,3
Dublin,318,174,144,5516.71,55,38,105,102,18
Dublin,243,122,121,8148.62,54,42,73,66,8
Dublin,241,125,116,7906.05,71,24,76,50,20
Dublin,232,113,119,8022.13,43,35,80,61,13
Dublin,218,116,102,10871.19,68,19,113,18,0
Dublin,725,367,358,814.35,89,60,170,163,243
Dublin,381,190,191,5571.56,55,52,90,91,93
Dublin,265,124,141,630.26,45,39,77,81,23
Dublin,316,156,160,6860.62,61,54,82,95,24
Dublin,274,119,155,3869.56,52,33,84,50,55
Dublin,186,93,93,1636.62,32,28,43,59,24
Dublin,269,141,128,4391.19,42,29,70,76,52
Dublin,325,155,170,4825.47,73,38,112,62,40
Dublin,232,126,106,4005.18,23,18,62,74,55
Dublin,279,146,133,8442.52,59,25,120,57,18
Dublin,235,102,133,9075.11,49,33,60,66,27
Dublin,216,103,113,2586.86,41,30,57,52,36
Dublin,257,134,123,375.02,50,44,76,82,5
Dublin,315,155,160,7240.38,50,62,76,99,28
Dublin,179,88,91,5551.94,24,23,56,52,24
Dublin,242,117,125,6024.55,53,21,78,50,40
Dublin,259,107,152,5509.93,72,44,71,55,17
Dublin,422,213,209,5783.36,68,56,117,157,24
Dublin,236,107,129,7973.51,43,42,60,79,12
Dublin,278,135,143,4027.88,38,43,56,91,50
Dublin,275,142,133,7847.5,42,51,58,93,31
Dublin,268,133,135,4684.66,32,36,69,94,37
Dublin,285,139,146,4475.43,70,32,80,82,21
Dublin,307,149,158,3538.5,42,28,69,70,98
Dublin,389,193,196,2072.4,48,47,132,122,40
Dublin,303,154,149,6763.39,53,41,77,87,45
Dublin,202,100,102,4679.93,23,34,48,72,25
Dublin,202,88,114,6763.77,28,16,88,43,27
Dublin,291,141,150,2783.33,35,24,50,77,105
Dublin,325,154,171,6397.51,74,35,139,67,10
Dublin,172,67,105,2968.69,18,16,62,30,46
Dublin,296,168,128,2372.8,42,44,66,94,50
Dublin,168,87,81,11601.41,32,15,95,21,5
Dublin,215,105,110,3785.34,33,18,48,69,47
Dublin,170,64,106,6241.05,13,14,79,49,15
Dublin,302,143,159,3954.79,50,33,75,93,51
Dublin,218,108,110,4688.37,33,23,43,48,71
Dublin,207,106,101,6973.22,52,22,73,44,16
Dublin,270,153,117,2871.09,73,13,105,36,43
Dublin,300,134,166,5269.35,63,40,91,81,25
Dublin,430,227,203,4838.2,97,31,165,73,64
Dublin,253,129,124,6222.18,33,35,61,62,62
Dublin,175,89,86,3243.56,21,20,32,59,43
Dublin,281,134,147,4169.33,64,46,47,86,38
Dublin,336,167,169,3277.06,67,52,58,96,63
Dublin,213,101,112,4286.23,44,14,47,58,50
Dublin,306,152,154,5254.3,62,45,57,86,56
Dublin,332,165,167,4311.07,58,31,79,79,85
Dublin,252,124,128,5496.54,27,39,55,81,50
Dublin,240,118,122,6753.52,36,36,56,82,30
Dublin,223,112,111,7041.59,34,23,56,33,77
Dublin,227,110,117,3802.92,48,25,65,63,26
Dublin,377,185,192,1084.02,56,31,106,116,68
Dublin,171,70,101,3902.68,22,15,29,48,57
Dublin,242,104,138,1265.15,61,46,52,74,9
Dublin,273,143,130,4153.48,43,35,71,93,31
Dublin,396,184,212,6626.28,80,54,101,101,60
Dublin,331,155,176,4646.59,49,34,48,89,111
Dublin,214,107,107,6889.23,19,20,44,61,70
Dublin,223,96,127,6063.24,42,22,50,77,32
Dublin,255,114,141,4074.26,31,34,46,70,74
Dublin,364,177,187,6214.68,41,52,65,114,92
Dublin,319,153,166,7951.34,48,49,73,101,48
Dublin,301,158,143,3493.58,51,46,68,105,31
Dublin,240,119,121,5826.8,29,31,50,71,59
Dublin,221,116,105,6259.2,25,34,43,75,44
Dublin,222,109,113,2037.16,29,30,37,81,45
Dublin,216,99,117,5970.31,20,42,38,97,19
Dublin,307,139,168,286.08,47,48,65,111,36
Dublin,269,128,141,4515.39,48,41,70,71,39
Dublin,323,157,166,6720.49,34,42,84,116,47
Dublin,302,138,164,5232.25,48,46,79,101,28
Dublin,334,162,172,7048.35,34,60,73,128,39
Dublin,335,176,159,7391.06,42,71,70,130,22
Dublin,249,122,127,8958.12,24,53,52,108,12
Dublin,215,101,114,4583.44,29,25,48,69,44
Dublin,340,157,183,2360.98,48,38,74,99,81
Dublin,203,98,105,3748.85,29,31,30,60,53
Dublin,245,124,121,4429.9,35,31,41,54,84
Dublin,284,126,158,4301.6,44,32,43,63,102
Dublin,263,112,151,4324.8,60,20,50,60,73
Dublin,196,92,104,34592.3,17,9,148,17,5
Dublin,197,83,114,12195.12,33,7,111,30,16
Dublin,266,133,133,2577.39,35,26,108,56,41
Dublin,166,84,82,7599.34,21,16,50,45,34
Dublin,223,109,114,5610.49,34,34,44,64,47
Dublin,268,128,140,3893.48,41,40,64,83,40
Dublin,210,100,110,6012.02,29,23,44,46,68
Dublin,199,102,97,5784.55,26,16,56,56,45
Dublin,111,51,60,3584.92,22,11,50,17,11
Dublin,189,92,97,3113.11,29,20,34,51,55
Dublin,173,86,87,5666.93,19,16,28,42,68
Dublin,210,108,102,6526.81,36,22,43,54,55
Dublin,425,187,238,4335.72,76,51,89,125,84
Dublin,212,99,113,4417.86,36,25,37,70,44
Dublin,261,124,137,4815.05,42,26,64,40,89
Dublin,217,107,110,4659.65,25,23,48,58,63
Dublin,251,121,130,3940.35,52,30,51,62,56
Dublin,294,149,145,4508.65,50,28,66,81,69
Dublin,315,154,161,2801.47,54,33,73,64,91
Dublin,268,123,145,4666.23,36,47,45,85,55
Dublin,290,132,158,4724.2,41,42,62,74,71
Dublin,204,98,106,4090.8,40,26,43,42,53
Dublin,193,101,92,5533.42,24,16,34,38,81
Dublin,286,135,151,4024.54,41,25,71,70,79
Dublin,345,154,191,6377.2,49,37,78,82,99
Dublin,228,114,114,7408.13,22,22,45,43,96
Dublin,321,155,166,7357.49,27,23,82,52,137
Dublin,325,161,164,4495.78,32,22,64,51,156
Dublin,327,155,172,7406.57,41,43,70,59,114
Dublin,295,149,146,6426.32,46,20,65,58,106
Dublin,189,90,99,5778.23,17,13,29,32,98
Dublin,223,103,120,7495.55,33,12,40,38,100
Dublin,195,93,102,5761.56,29,22,61,42,41
Dublin,175,86,89,737.45,18,11,43,31,72
Dublin,302,156,146,60.25,85,40,96,68,13
Dublin,288,141,147,9291.82,114,23,130,21,0
Dublin,254,123,131,7925.86,87,17,129,20,1
Dublin,441,212,229,10527.82,143,38,237,21,2
Dublin,320,155,165,11207.23,120,24,156,17,3
Dublin,383,192,191,10029.07,138,26,194,24,1
Dublin,350,184,166,11456.25,122,23,174,29,2
Dublin,326,165,161,9026.72,112,17,180,16,1
Dublin,468,241,227,39.4,97,44,208,80,39
Dublin,445,221,224,11069.38,143,31,240,27,4
Dublin,567,298,269,1754.11,175,46,317,25,4
Dublin,257,133,124,39.35,72,40,101,40,4
Dublin,358,179,179,8925.23,146,19,177,12,4
Dublin,381,188,193,13109.9,138,23,186,32,2
Dublin,243,126,117,10751.74,82,13,139,9,0
Dublin,396,215,181,9628.24,122,61,163,48,2
Dublin,254,127,127,13938.43,87,19,130,17,1
Dublin,205,95,110,10574.1,68,12,107,18,0
Dublin,317,147,170,12787.41,100,33,170,14,0
Dublin,293,149,144,9298.34,97,14,166,15,1
Dublin,273,139,134,7472.7,92,13,160,6,2
Dublin,288,145,143,1441.15,110,18,111,48,1
Dublin,302,150,152,8317.96,95,25,160,20,2
Dublin,217,113,104,3084.45,64,21,97,28,7
Dublin,313,160,153,3173.44,104,7,181,20,1
Dublin,568,238,330,42.81,114,62,106,113,173
Dublin,218,92,126,1996.89,38,13,143,17,7
Dublin,227,116,111,376.71,38,29,65,44,51
Dublin,367,185,182,4778.96,96,66,104,92,9
Dublin,297,142,155,6462.14,71,50,84,80,12
Dublin,266,125,141,3128.12,46,50,82,75,13
Dublin,299,146,153,4727.27,40,41,63,76,79
Dublin,227,122,105,3178.69,30,39,82,50,26
Dublin,189,85,104,7946.18,21,15,80,35,38
Dublin,284,143,141,16400.07,35,61,143,29,16
Dublin,199,97,102,10877.29,19,28,93,35,24
Dublin,215,112,103,10664.15,20,71,81,24,19
Dublin,200,96,104,8989.17,30,32,85,38,15
Dublin,196,121,75,7244.5,19,27,90,34,26
Dublin,272,135,137,11596.67,49,38,131,35,19
Dublin,211,118,93,49717.25,21,34,136,19,1
Dublin,146,63,83,14331.99,10,6,57,35,38
Dublin,253,144,109,9185.3,24,28,143,33,25
Dublin,163,77,86,3666.71,21,24,77,31,10
Dublin,298,155,143,9186.19,51,28,134,70,15
Dublin,279,142,137,65910.7,38,54,173,14,0
Dublin,222,113,109,26238.03,7,57,151,5,2
Dublin,228,120,108,707.99,21,18,73,76,40
Dublin,75,33,42,3088.33,0,8,22,25,20
Dublin,172,91,81,5092.37,18,63,74,10,7
Dublin,266,122,144,1725.19,49,38,81,80,18
Dublin,93,69,24,11862.24,4,4,48,27,10
Dublin,139,69,70,7809.43,11,23,63,33,9
Dublin,128,62,66,13664.99,20,12,90,6,0
Dublin,292,152,140,40331.49,38,45,191,16,2
Dublin,158,97,61,6866.28,20,34,89,15,0
Dublin,213,117,96,43091.24,28,42,119,22,2
Dublin,191,109,82,11702.71,30,28,124,9,0
Dublin,174,109,65,38351.33,18,32,115,9,0
Dublin,160,91,69,51249.2,15,16,113,16,0
Dublin,351,178,173,48227.54,18,70,246,17,0
Dublin,386,195,191,53000.14,17,48,231,76,14
Dublin,199,118,81,5551.37,16,37,124,9,13
Dublin,140,73,67,54474.71,11,30,91,6,2
Dublin,173,93,80,10538.5,13,40,107,11,2
Dublin,165,82,83,20124.41,18,16,111,17,3
Dublin,166,85,81,14241.59,5,26,117,16,2
Dublin,186,98,88,30402.09,13,29,140,3,1
Dublin,317,154,163,21187.01,50,59,169,29,10
Dublin,300,125,175,14513.79,76,60,95,51,18
Dublin,199,100,99,12497.64,20,29,96,30,24
Dublin,221,112,109,2002.12,24,35,145,17,0
Dublin,130,65,65,11991.51,9,29,84,7,1
Dublin,175,92,83,35547.43,15,14,143,3,0
Dublin,142,86,56,3602.32,17,24,75,21,5
Dublin,219,142,77,11354.8,10,34,141,27,7
Dublin,210,111,99,16267.72,9,68,114,15,4
Dublin,172,81,91,4849.44,5,104,50,11,2
Dublin,319,163,156,77408.4,25,55,215,20,4
Dublin,270,126,144,16325.05,41,17,155,55,2
Dublin,233,100,133,14019.25,16,15,122,45,35
Dublin,289,137,152,14460.12,44,60,78,76,31
Dublin,195,93,102,5192.8,20,12,102,31,30
Dublin,185,78,107,14198,14,11,82,44,34
Dublin,298,234,64,3188.91,10,22,127,85,54
Dublin,453,228,225,15577.18,14,45,215,134,45
Dublin,342,166,176,13361.46,64,43,143,56,36
Dublin,97,63,34,13222.46,5,18,52,21,1
Dublin,80,57,23,10843.05,7,8,45,12,8
Dublin,210,91,119,7222.45,70,41,64,29,6
Dublin,166,87,79,13969.54,14,14,71,33,34
Dublin,173,84,89,22302.44,18,16,85,32,22
Dublin,214,114,100,10871.77,13,32,126,34,9
Dublin,243,114,129,16321.87,33,13,126,34,37
Dublin,153,75,78,17268.62,6,11,77,30,29
Dublin,203,90,113,17701.43,16,16,119,30,22
Dublin,153,71,82,16321.74,19,15,67,34,18
Dublin,200,97,103,9144.53,16,24,74,40,46
Dublin,141,64,77,7949.04,10,11,64,31,25
Dublin,192,89,103,14737.49,24,15,96,35,22
Dublin,172,76,96,12847.33,27,12,97,19,17
Dublin,169,101,68,7445.59,11,33,83,28,14
Dublin,121,68,53,12243.25,7,11,73,21,9
Dublin,287,152,135,10029,48,49,104,65,21
Dublin,116,64,52,15245.1,14,19,63,17,3
Dublin,97,61,36,3969.88,9,6,37,16,29
Dublin,237,126,111,11649.05,40,49,60,63,25
Dublin,421,213,208,10563.29,118,71,83,140,9
Dublin,427,206,221,6715.84,103,84,70,153,17
Dublin,237,113,124,1646.91,24,31,51,48,83
Dublin,232,113,119,4807.99,26,20,54,39,93
Dublin,223,110,113,4070.75,25,25,49,49,75
Dublin,209,86,123,4263.39,19,23,53,58,56
Dublin,333,165,168,11108.52,51,64,83,109,26
Dublin,323,164,159,10783.2,73,55,85,97,13
Dublin,296,147,149,11798.94,41,73,51,115,16
Dublin,233,119,114,9858.68,53,42,53,78,7
Dublin,217,106,111,10738.32,60,19,77,55,6
Dublin,303,148,155,10273.97,37,74,58,110,24
Dublin,323,150,173,3190.12,83,54,83,92,11
Dublin,317,152,165,10482.46,104,28,114,66,5
Dublin,310,152,158,10502.07,110,30,109,59,2
Dublin,242,110,132,8624.07,75,26,75,57,9
Dublin,401,182,219,9122.14,118,50,125,96,12
Dublin,394,159,235,1030.87,35,53,71,91,144
Dublin,262,122,140,3295.72,25,32,50,61,94
Dublin,129,60,69,24731.6,8,10,106,5,0
Dublin,207,105,102,11523.05,27,26,145,9,0
Dublin,138,73,65,15161.5,26,14,93,5,0
Dublin,186,101,85,13737.08,37,17,124,8,0
Dublin,189,83,106,17594.49,34,13,136,6,0
Dublin,243,121,122,8871.85,35,26,168,14,0
Dublin,256,113,143,14022.02,44,32,170,9,1
Dublin,190,95,95,5772.27,28,18,137,6,1
Dublin,206,92,114,15479.41,38,24,132,11,1
Dublin,152,82,70,3236.8,23,7,113,9,0
Dublin,203,100,103,5827.31,26,9,69,53,46
Dublin,184,93,91,22439.02,7,10,144,21,2
Dublin,199,82,117,13283.49,34,8,145,11,1
Dublin,168,67,101,9546.54,52,17,84,13,2
Dublin,322,148,174,4712.01,71,42,196,12,1
Dublin,227,111,116,12032.23,34,33,153,7,0
Dublin,275,129,146,4986.22,34,17,46,54,124
Dublin,269,128,141,5500.91,44,33,57,68,67
Dublin,280,126,154,1523.15,43,20,198,16,3
Dublin,201,102,99,17478.26,49,9,114,20,9
Dublin,300,130,170,3498.01,41,20,215,21,3
Dublin,264,117,147,8327.55,41,29,141,37,16
Dublin,259,120,139,5993.71,34,45,68,84,28
Dublin,204,104,100,5184.24,23,16,38,46,81
Dublin,184,80,104,4009.85,18,18,68,47,33
Dublin,179,89,90,6075.42,20,21,38,55,45
Dublin,188,94,94,5287.58,37,20,47,58,26
Dublin,181,85,96,4895.46,40,16,44,39,42
Dublin,273,125,148,6771,51,32,56,66,68
Dublin,140,53,87,5908.17,16,7,70,20,27
Dublin,199,98,101,5826.72,22,30,71,48,28
Dublin,249,125,124,1909.13,36,26,68,54,65
Dublin,240,89,151,2254.01,21,19,86,82,32
Dublin,193,86,107,7664.2,38,30,45,54,26
Dublin,317,159,158,6763.97,50,55,65,102,45
Dublin,318,172,146,8884.92,42,59,72,124,21
Dublin,325,164,161,7862.02,46,70,64,119,26
Dublin,339,164,175,7438.45,63,63,75,123,15
Dublin,303,144,159,7155,76,35,76,78,38
Dublin,276,137,139,7562.89,47,37,78,86,28
Dublin,386,198,188,4164.15,69,44,100,123,50
Dublin,294,141,153,9954.97,67,58,70,66,33
Dublin,273,134,139,4131.36,37,44,65,101,26
Dublin,277,128,149,7098.92,40,51,59,108,19
Dublin,300,150,150,9206.69,42,41,78,120,19
Dublin,317,161,156,8984.5,118,20,141,33,5
Dublin,233,99,134,21299.94,41,30,131,27,4
Dublin,293,136,157,6064.75,47,27,54,66,99
Dublin,200,100,100,1974.26,25,24,43,43,65
Dublin,209,113,96,12322.39,27,28,88,42,24
Dublin,160,73,87,7348.55,31,27,72,22,8
Dublin,231,107,124,7318.46,33,37,90,31,40
Dublin,199,97,102,11998.79,34,21,66,44,34
Dublin,214,99,115,9992.53,27,19,77,47,44
Dublin,118,58,60,22459.08,39,12,36,22,9
Dublin,197,89,108,7827.4,34,18,109,26,10
Dublin,309,149,160,11526.41,91,49,85,66,18
Dublin,222,103,119,24994.37,72,38,63,41,8
Dublin,145,82,63,10478.39,11,26,36,34,38
Dublin,324,151,173,16582.22,63,63,99,78,21
Dublin,313,153,160,12377.41,59,57,98,66,33
Dublin,201,95,106,8711.1,29,35,78,43,16
Dublin,235,130,105,14785.45,25,26,101,57,26
Dublin,168,94,74,7078.15,15,31,70,39,13
Dublin,158,88,70,7372.5,7,31,68,36,16
Dublin,231,116,115,10544.09,14,51,91,50,25
Dublin,290,134,156,11155.99,29,70,103,56,32
Dublin,247,111,136,11170.91,31,55,89,50,22
Dublin,216,124,92,20012.97,28,33,123,26,6
Dublin,260,139,121,21832.23,32,50,97,59,22
Dublin,105,59,46,19860.03,5,20,46,26,8
Dublin,462,255,207,5070.29,19,52,216,151,24
Dublin,229,113,116,55087.8,34,38,148,9,0
Dublin,186,99,87,4631.59,17,22,96,17,34
Dublin,168,86,82,14419.36,18,39,74,31,6
Dublin,142,68,74,9131.25,18,19,57,38,10
Dublin,180,93,87,16868.15,18,34,86,31,11
Dublin,295,158,137,13590.09,51,46,123,48,27
Dublin,180,125,55,4464.29,6,18,88,51,17
Dublin,308,140,168,1741.64,38,20,65,75,110
Dublin,200,97,103,3579.42,27,31,45,59,38
Dublin,253,126,127,4342.23,39,29,39,67,79
Dublin,215,99,116,4082.95,24,33,63,44,51
Dublin,271,129,142,5646.42,45,35,72,65,54
Dublin,217,111,106,5091.39,30,27,53,54,53
Dublin,251,123,128,2717.83,59,33,68,66,25
Dublin,321,147,174,4528.01,32,35,61,67,126
Dublin,266,131,135,7082.19,43,23,58,58,84
Dublin,343,161,182,3688.09,34,25,44,71,169
Dublin,193,81,112,4771.91,21,36,49,46,41
Dublin,233,115,118,1473.44,32,36,72,65,28
Dublin,348,160,188,5067.86,68,55,82,80,63
Dublin,232,117,115,4606.01,69,25,86,41,11
Dublin,286,138,148,18450.42,66,38,167,14,1
Dublin,457,221,236,12246.43,104,106,97,138,12
Dublin,335,165,170,6568.37,42,63,73,131,26
Dublin,260,126,134,8583.41,53,45,68,69,25
Dublin,258,117,141,10644.44,66,33,83,53,23
Dublin,213,86,127,7245.64,53,35,60,43,22
Dublin,307,148,159,6956.4,61,53,70,86,37
Dublin,199,88,111,21555.46,31,28,124,15,1
Dublin,217,106,111,31313.13,37,18,149,12,1
Dublin,281,134,147,10400.47,35,41,58,105,42
Dublin,397,196,201,2396.95,76,65,101,108,47
Dublin,217,96,121,5066.19,35,21,52,43,66
Dublin,197,105,92,6747.5,34,27,49,54,33
Dublin,212,97,115,7084.85,42,21,62,58,29
Dublin,424,150,274,4119.26,42,31,55,62,234
Dublin,195,98,97,4995.39,36,25,53,39,42
Dublin,232,112,120,886,30,23,38,81,60
Dublin,149,68,81,9084.81,30,6,51,41,21
Dublin,179,80,99,5355.43,30,12,45,36,56
Dublin,243,131,112,6963.15,37,44,63,79,20
Dublin,208,112,96,4089.34,43,16,45,43,61
Dublin,258,127,131,4794.2,41,43,80,57,37
Dublin,276,127,149,5690.14,53,22,80,65,56
Dublin,307,147,160,5931.56,56,31,96,65,59
Dublin,274,127,147,4264.46,41,31,51,70,81
Dublin,290,139,151,7197.28,42,24,97,68,59
Dublin,203,102,101,7766.77,35,30,56,59,23
Dublin,203,95,108,9300.83,26,27,61,48,41
Dublin,232,105,127,5939.73,42,34,61,62,33
Dublin,381,199,182,9843.69,63,57,130,93,38
Dublin,458,215,243,7661.04,90,68,140,121,39
Dublin,277,136,141,7019.77,52,45,79,68,33
Dublin,305,154,151,9411.26,55,44,110,63,33
Dublin,225,110,115,13804.53,70,16,120,19,0
Dublin,263,134,129,15093.26,85,22,140,15,1
Dublin,161,75,86,6383.57,50,14,88,8,1
Dublin,181,81,100,15878.59,52,12,106,9,2
Dublin,213,102,111,9022.75,51,18,130,13,1
Dublin,130,58,72,451.46,35,11,72,10,2
Dublin,320,154,166,23875.25,59,40,199,21,1
Dublin,335,160,175,5630.06,74,41,95,71,54
Dublin,302,147,155,7229.2,71,53,99,55,24
Dublin,356,172,184,8784.92,104,74,98,62,18
Dublin,344,165,179,9496.99,83,61,100,61,39
Dublin,230,114,116,7078.23,45,30,65,63,27
Dublin,229,104,125,10538.43,62,36,56,30,45
Dublin,217,108,109,4076.34,41,33,60,40,43
Dublin,254,115,139,10254.75,85,42,78,45,4
Dublin,274,129,145,1746.85,105,60,78,26,5
Dublin,128,53,75,14354.6,37,36,33,19,3
Dublin,276,121,155,8530.37,43,38,70,63,62
Dublin,200,100,100,6464.54,26,27,50,45,52
Dublin,313,147,166,10970.14,78,80,72,68,15
Dublin,183,94,89,5927.7,18,23,45,44,53
Dublin,308,145,163,9573.84,77,49,91,56,35
Dublin,191,101,90,5027.37,10,27,49,40,65
Dublin,295,149,146,9095.67,38,51,93,77,36
Dublin,281,138,143,7195.9,38,42,93,78,30
Dublin,331,164,167,8642.3,69,66,99,78,19
Dublin,306,160,146,12944.71,75,66,93,60,12
Dublin,317,141,176,9480.52,77,59,105,64,12
Dublin,303,134,169,5378.06,62,55,75,42,69
Dublin,309,144,165,4880.28,100,57,89,53,10
Dublin,259,120,139,6803.97,77,35,110,34,3
Dublin,247,123,124,5691.64,56,36,128,24,3
Dublin,403,177,226,10644.48,127,76,113,66,21
Dublin,360,175,185,10647.42,77,66,102,79,36
Dublin,233,116,117,14783.33,30,32,143,26,2
Dublin,208,97,111,8475.61,51,41,61,45,10
Dublin,92,44,48,4837.27,34,22,24,12,0
Dublin,276,143,133,8486.82,50,27,39,50,110
Dublin,252,125,127,12997.73,67,44,77,38,26
Dublin,145,58,87,1431.87,42,24,53,21,5
Dublin,156,80,76,17095.89,49,25,47,26,9
Dublin,174,85,89,21513.35,63,31,57,17,6
Dublin,317,151,166,3959.18,83,59,112,49,14
Dublin,245,101,144,4083.67,50,37,47,60,51
Dublin,213,100,113,5009.64,47,19,44,44,59
Dublin,267,124,143,4029.15,36,30,61,53,87
Dublin,213,98,115,4004.36,32,20,39,50,72
Dublin,303,139,164,5169.15,35,52,76,70,70
Dublin,341,154,187,4626.3,44,43,80,80,94
Dublin,216,103,113,4903.52,29,27,37,55,68
Dublin,275,129,146,5393.11,53,31,65,69,57
Dublin,224,119,105,3931.62,34,22,70,59,39
Dublin,219,106,113,3726.64,24,22,45,62,66
Dublin,357,176,181,9499.99,43,79,71,137,27
Dublin,229,103,126,4444.36,24,21,40,58,86
Dublin,360,169,191,6600.42,54,58,78,106,64
Dublin,220,102,118,4667.94,22,14,39,49,96
Dublin,223,122,101,6205.99,30,30,50,67,46
Dublin,213,101,112,3628.31,27,24,57,53,52
Dublin,196,88,108,7151.46,28,29,53,32,54
Dublin,254,114,140,6819.89,44,33,57,55,65
Dublin,187,81,106,4997.73,24,21,51,41,50
Dublin,212,95,117,4625.49,32,22,61,51,46
Dublin,165,79,86,5064.46,18,15,40,42,50
Dublin,175,84,91,4491.09,20,25,45,36,49
Dublin,232,128,104,5513.05,39,19,54,37,83
Dublin,239,122,117,4753,21,29,48,40,101
Dublin,207,103,104,4864.98,34,14,49,38,72
Dublin,206,109,97,4507.56,28,18,48,30,82
Dublin,181,92,89,3158.59,20,8,49,11,93
Dublin,241,122,119,12010.37,39,45,55,87,15
Dublin,344,168,176,5946.93,67,52,101,102,22
Dublin,303,141,162,8309.79,40,31,71,95,66
Dublin,288,142,146,3348.92,30,24,61,111,62
Dublin,222,109,113,9779.74,36,25,61,63,37
Dublin,309,166,143,9614.79,54,35,87,72,61
Dublin,249,135,114,7215.3,23,33,63,70,60
Dublin,324,160,164,6299.58,41,30,80,99,74
Dublin,240,118,122,7992.54,27,21,56,74,62
Dublin,288,142,146,4480.82,60,25,90,65,48
Dublin,292,136,156,17059.06,63,31,171,24,3
Dublin,299,128,171,10369.7,74,30,160,27,8
Dublin,339,143,196,3582.3,94,20,130,50,45
Dublin,181,78,103,4677.61,28,14,66,28,45
Dublin,886,437,449,3745.07,89,69,221,185,322
Dublin,223,117,106,5446.73,35,15,45,39,89
Dublin,271,135,136,5472.32,28,23,54,60,106
Dublin,168,86,82,3733.91,25,8,41,29,65
Dublin,220,105,115,5426.34,31,26,47,49,67
Dublin,204,99,105,7058.34,24,29,37,52,62
Dublin,262,134,128,7028.65,48,24,58,58,74
Dublin,249,127,122,4443.81,32,17,64,55,81
Dublin,252,118,134,5266.13,36,20,59,46,91
Dublin,250,112,138,5489.32,31,26,59,58,76
Dublin,243,121,122,6042.52,31,24,62,59,67
Dublin,172,90,82,18822.5,36,16,108,10,2
Dublin,335,159,176,4580.44,67,54,134,66,14
Dublin,257,109,148,3216.12,39,20,102,37,59
Dublin,328,178,150,7419.81,64,54,89,95,26
Dublin,300,153,147,1384.3,52,47,69,111,21
Dublin,392,196,196,5857.22,43,67,78,140,64
Dublin,261,127,134,5616.04,47,35,55,95,29
Dublin,264,128,136,8762.61,51,38,69,85,21
Dublin,298,150,148,9015.55,40,61,59,120,18
Dublin,306,147,159,9713.98,38,51,76,105,36
Dublin,270,138,132,5091.17,55,48,85,45,37
Dublin,269,117,152,7313.76,58,43,76,48,44
Dublin,235,124,111,8036.66,23,19,49,79,65
Dublin,238,119,119,6097.09,32,21,59,47,79
Dublin,295,142,153,7115.64,31,40,66,97,61
Dublin,193,98,95,6472.6,20,25,39,33,76
Dublin,246,127,119,7132.71,21,34,45,52,94
Dublin,255,115,140,5025.62,39,39,86,54,37
Dublin,243,119,124,6115.52,43,39,59,69,33
Dublin,322,152,170,10350.37,65,71,96,84,6
Dublin,265,130,135,4364.22,28,35,58,64,80
Dublin,285,129,156,9548.06,62,48,115,51,9
Dublin,261,134,127,10246.14,67,21,102,57,14
Dublin,405,192,213,8841.83,105,55,147,86,12
Dublin,240,114,126,5403.34,37,28,42,55,78
Dublin,297,149,148,5506.93,37,26,61,70,103
Dublin,248,104,144,5741.14,43,27,78,50,50
Dublin,316,163,153,6851.54,35,20,90,106,65
Dublin,324,146,178,6203.45,50,19,75,107,73
Dublin,231,113,118,3161.78,29,32,57,62,51
Dublin,224,111,113,2928.72,40,31,69,50,34
Dublin,255,115,140,3446.09,27,44,43,78,63
Dublin,151,62,89,6918.99,19,9,104,15,4
Dublin,122,58,64,10886.05,15,6,84,13,4
Dublin,358,167,191,5668.86,39,50,76,116,77
Dublin,204,93,111,11822.66,57,10,104,21,12
Dublin,166,69,97,1420.58,23,27,51,40,25
Dublin,408,172,236,2639.96,60,26,121,78,123
Dublin,355,136,219,566.97,67,35,60,89,104
Dublin,184,95,89,5509.48,15,28,81,30,30
Dublin,237,109,128,6732.57,28,35,99,53,22
Dublin,299,133,166,3995.78,53,50,74,71,51
Dublin,121,51,70,8679.43,12,7,46,34,22
Dublin,182,94,88,7592.82,26,27,64,42,23
Dublin,195,82,113,10189.15,27,20,74,42,32
Dublin,282,153,129,10191.54,45,32,113,63,29
Dublin,199,91,108,4433.35,17,46,68,28,40
Dublin,273,133,140,6867.75,55,39,60,73,46
Dublin,290,142,148,5398.26,49,47,58,98,38
Dublin,245,120,125,3789.64,42,34,68,55,46
Dublin,285,141,144,8601.96,52,32,90,64,47
Dublin,291,133,158,8657.62,65,49,62,90,25
Dublin,209,86,123,6315.73,8,28,137,23,13
Dublin,115,60,55,9845.05,4,23,63,18,7
Dublin,179,89,90,12761.1,15,20,122,12,10
Dublin,276,125,151,8148.56,41,42,98,47,48
Dublin,243,106,137,4271.7,26,34,61,76,46
Dublin,218,111,107,6506.49,14,34,101,45,24
Dublin,277,141,136,8085.94,25,59,118,50,25
Dublin,253,129,124,8412.02,22,51,121,47,12
Dublin,264,120,144,7580.54,52,48,90,52,22
Dublin,291,144,147,6197.29,52,49,61,87,42
Dublin,257,127,130,6056.18,48,34,73,80,22
Dublin,226,104,122,5499.85,28,37,98,46,17
Dublin,181,85,96,4607,17,17,95,31,21
Dublin,190,95,95,11721.88,21,26,91,31,21
Dublin,215,109,106,7785.91,24,34,88,40,29
Dublin,314,150,164,8160.51,44,43,104,67,56
Dublin,225,111,114,4533.27,45,25,70,58,27
Dublin,274,137,137,5213.78,25,44,69,99,37
Dublin,103,63,40,30727.92,10,14,57,18,4
Dublin,265,127,138,9576.12,33,29,142,49,12
Dublin,248,133,115,9980.68,19,39,135,44,11
Dublin,122,59,63,8875.31,15,13,75,18,1
Dublin,191,92,99,2593.31,34,20,51,59,27
Dublin,141,60,81,8031.44,17,14,59,39,12
Dublin,209,97,112,5170.45,40,24,73,62,10
Dublin,148,73,75,288.06,11,28,62,32,15
Dublin,333,163,170,2778.84,56,48,100,83,46
Dublin,376,196,180,8480.69,50,59,102,114,51
Dublin,153,91,62,23629.34,15,21,82,29,6
Dublin,127,86,41,31631.38,12,26,64,22,3
Dublin,116,57,59,9180.12,7,27,47,21,14
Dublin,152,79,73,3287.41,9,31,84,19,9
Dublin,101,60,41,20281.12,3,16,57,22,3
Dublin,134,92,42,5844.64,7,23,62,33,9
Dublin,147,89,58,12510.64,6,24,67,31,19
Dublin,183,97,86,12727.78,18,43,79,32,11
Dublin,317,141,176,5518.99,44,38,154,64,17
Dublin,239,119,120,1459.45,21,23,63,50,82
Dublin,206,95,111,7049.72,38,18,67,39,44
Dublin,203,102,101,8521.53,21,24,52,56,50
Dublin,199,96,103,9314.74,23,20,71,37,48
Dublin,174,76,98,8292.43,23,23,59,38,31
Dublin,215,99,116,11523.82,29,29,62,51,44
Dublin,243,119,124,8637.85,50,32,70,50,41
Dublin,255,119,136,7406.55,47,33,80,51,44
Dublin,203,96,107,10556.42,34,28,57,57,27
Dublin,255,122,133,7481.96,47,28,81,46,53
Dublin,208,92,116,9461,38,20,71,49,30
Dublin,331,149,182,6255.67,54,44,84,65,84
Dublin,272,147,125,6079.43,33,16,120,46,57
Dublin,236,98,138,10972.15,46,29,73,48,40
Dublin,182,88,94,3770.38,15,23,44,49,51
Dublin,330,133,197,7476.55,88,35,111,49,47
Dublin,365,182,183,9377.73,52,75,124,81,33
Dublin,304,164,140,8876.95,34,47,153,39,31
Dublin,192,90,102,4820.85,26,33,37,57,39
Dublin,223,102,121,6860.91,32,28,51,68,44
Dublin,232,99,133,11431.95,32,28,58,70,44
Dublin,279,124,155,10838.32,47,27,88,56,61
Dublin,279,135,144,4760.36,36,35,115,57,36
Dublin,187,113,74,10542.34,12,15,115,35,10
Dublin,220,125,95,5496.98,33,31,86,45,25
Dublin,77,41,36,14438.4,1,14,39,19,4
Dublin,121,79,42,12743.55,4,20,64,30,3
Dublin,173,98,75,5569.86,13,18,77,46,19
Dublin,145,78,67,8386.84,12,27,71,27,8
Dublin,144,87,57,12861.74,17,18,76,26,7
Dublin,158,76,82,4748.17,22,24,50,37,25
Dublin,172,93,79,10309.28,12,24,83,50,3
Dublin,131,77,54,9981.71,16,29,60,19,7
Dublin,229,128,101,19238.85,16,26,153,33,1
Dublin,213,111,102,7119.46,26,32,54,76,25
Dublin,301,134,167,10073.63,59,42,82,72,46
Dublin,260,123,137,8472.37,46,35,70,68,41
Dublin,257,137,120,3837.54,35,45,47,98,32
Dublin,206,94,112,7710.74,40,29,45,56,36
Dublin,241,120,121,916.87,29,33,51,63,65
Dublin,288,134,154,4978.05,65,32,75,68,48
Dublin,259,126,133,4199.7,40,30,75,74,40
Dublin,256,123,133,2617.37,43,32,61,79,41
Dublin,220,111,109,9181.59,43,39,63,53,22
Dublin,266,122,144,6374.62,66,40,73,57,30
Dublin,243,114,129,4826.7,44,47,47,70,35
Dublin,196,87,109,10176.53,41,23,46,53,33
Dublin,235,112,123,8229.16,44,33,55,66,37
Dublin,110,56,54,5120.8,0,1,1,23,85
Dublin,233,109,124,8243.99,34,33,60,71,35
Dublin,207,92,115,9532.14,44,34,62,38,29
Dublin,214,100,114,8931.93,30,33,66,43,42
Dublin,220,106,114,8931.11,30,28,68,63,31
Dublin,201,87,114,2437.49,29,16,61,50,45
Dublin,254,119,135,4205.44,41,31,93,54,35
Dublin,225,97,128,9770.71,43,32,66,54,30
Dublin,234,116,118,10466.52,30,42,66,50,46
Dublin,209,88,121,9546.87,40,25,71,42,31
Dublin,270,125,145,9267.52,56,27,76,60,51
Dublin,249,119,130,6783.45,52,27,74,59,37
Dublin,203,97,106,6610.01,37,33,53,48,32
Dublin,217,112,105,1175.62,28,28,51,67,43
Dublin,203,117,86,6147.04,41,31,55,59,17
Dublin,96,47,49,4127.61,7,1,11,29,48
Dublin,240,119,121,6119.95,50,21,54,75,40
Dublin,249,131,118,7307.41,32,35,71,83,28
Dublin,221,115,106,9915.65,29,35,57,60,40
Dublin,192,89,103,5582.69,38,13,64,49,28
Dublin,258,135,123,6823.77,30,52,71,80,25
Dublin,410,198,212,1814.42,63,85,112,118,32
Dublin,266,138,128,21472.39,50,12,179,20,5
Dublin,242,109,133,44889.63,40,14,170,15,3
Dublin,167,84,83,4069.7,19,16,46,51,35
Dublin,199,94,105,2562.65,52,21,51,63,12
Dublin,185,85,100,3799.86,36,21,46,50,32
Dublin,279,120,159,5548.71,29,26,76,62,86
Dublin,244,107,137,1558.75,63,59,65,46,11
Dublin,149,65,84,861.1,19,10,72,34,14
Dublin,120,46,74,6260.11,20,8,72,19,1
Dublin,173,102,71,481.32,25,16,91,33,8
Dublin,294,133,161,19475.36,41,19,212,21,1
Dublin,223,98,125,2565.19,37,18,68,49,51
Dublin,172,75,97,3251.11,14,17,71,48,22
Dublin,225,124,101,5148.74,32,22,106,41,24
Dublin,173,86,87,2991.99,49,11,67,31,15
Dublin,216,81,135,4344.68,18,10,61,27,100
Dublin,277,129,148,3555.29,35,22,73,67,80
Dublin,211,107,104,34539.2,18,9,164,16,4
Dublin,161,85,76,10375.72,27,8,109,16,1
Dublin,130,64,66,22275.53,13,8,97,10,2
Dublin,"1,769","1,445",324,3645.99,136,355,882,235,161
Dublin,460,212,248,2796.86,221,64,138,35,2
Dublin,268,132,136,2034.53,70,21,158,19,0
Dublin,234,106,128,13850.25,73,20,120,20,1
Dublin,205,99,106,11653.69,46,17,120,22,0
Dublin,478,224,254,3000.04,155,84,141,93,5
Dublin,358,173,185,13492.63,69,78,86,90,35
Dublin,293,154,139,8670.18,52,46,84,85,26
Dublin,229,110,119,7227.17,34,23,56,74,42
Dublin,300,153,147,8867.34,68,35,76,73,48
Dublin,249,112,137,5276.43,46,40,60,70,33
Dublin,257,119,138,7764.35,42,29,48,67,71
Dublin,247,115,132,10660.34,61,34,67,51,34
Dublin,269,134,135,8450.08,51,36,67,75,40
Dublin,226,110,116,7403.52,46,35,49,67,29
Dublin,373,175,198,1326.01,73,47,97,100,56
Dublin,363,176,187,7262.03,81,85,96,87,14
Dublin,392,176,216,7049.22,120,73,118,74,7
Dublin,367,175,192,6565.06,64,31,251,21,0
Dublin,302,160,142,343.67,25,24,138,47,68
Dublin,414,204,210,3821.76,104,77,120,98,15
Dublin,371,171,200,8315.4,115,71,112,59,14
Dublin,415,204,211,9497.44,127,69,110,83,26
Dublin,304,145,159,12347.18,65,69,76,76,18
Dublin,343,169,174,11220.52,98,60,95,78,12
Dublin,364,179,185,5984.48,91,72,96,96,9
Dublin,454,232,222,9615.18,120,68,151,88,27
Dublin,255,118,137,4019.17,40,30,54,67,64
Dublin,313,143,170,5626.97,65,38,72,67,71
Dublin,281,121,160,5632.73,49,26,52,63,91
Dublin,243,111,132,7073.62,57,17,83,58,28
Dublin,252,117,135,5324.88,52,27,58,62,53
Dublin,285,142,143,6591.88,58,32,82,80,33
Dublin,258,133,125,178.81,51,41,42,78,46
Dublin,196,101,95,1079.59,29,14,51,42,60
Dublin,268,135,133,6270.03,60,31,85,60,32
Dublin,310,137,173,6442.23,41,32,81,83,73
Dublin,249,119,130,5144.73,51,18,63,60,57
Dublin,105,50,55,5706.21,12,8,17,23,45
Dublin,286,128,158,5842.46,47,30,72,76,61
Dublin,210,97,113,4492.27,43,20,58,47,42
Dublin,277,128,149,6570.83,64,31,86,55,41
Dublin,133,55,78,6382.88,6,8,51,42,26
Dublin,187,88,99,6839.29,30,11,49,64,33
Dublin,277,126,151,3330.57,44,28,104,59,42
Dublin,173,72,101,8188.96,22,18,47,60,26
Dublin,284,145,139,5030.2,53,34,85,86,26
Dublin,284,125,159,6765.61,42,38,92,71,41
Dublin,353,159,194,6775.3,56,43,91,109,54
Dublin,278,129,149,4723.31,69,28,55,79,47
Dublin,317,159,158,7330.33,72,32,64,102,47
Dublin,322,149,173,4827.66,64,40,71,70,77
Dublin,281,131,150,3345.16,54,36,55,86,50
Dublin,310,154,156,6593.08,74,42,51,87,56
Dublin,241,117,124,4460.65,45,49,38,71,38
Dublin,272,130,142,4550.93,33,36,62,75,66
Dublin,308,158,150,137.68,55,54,59,90,50
Dublin,238,105,133,2761.47,33,42,38,75,50
Dublin,119,58,61,9806.35,8,10,59,24,18
Dublin,306,141,165,4562.6,72,36,99,67,32
Dublin,161,77,84,10448.44,32,7,85,22,15
Dublin,141,71,70,4359.52,22,12,19,44,44
Dublin,212,101,111,4134.73,36,32,34,64,46
Dublin,162,77,85,18446.82,15,6,115,16,10
Dublin,143,72,71,4827.33,28,14,64,31,6
Dublin,226,104,122,3958.52,34,26,80,51,35
Dublin,315,156,159,4923.57,68,58,62,104,23
Dublin,229,102,127,15737.75,34,16,146,26,7
Dublin,260,116,144,2390.83,59,26,65,67,43
Dublin,284,149,135,2879.92,51,33,73,66,61
Dublin,289,133,156,3394.09,40,32,118,66,33
Dublin,195,89,106,2590.91,28,23,66,56,22
Dublin,208,94,114,3366.4,44,25,44,69,26
Dublin,239,118,121,4790.35,54,31,66,63,25
Dublin,255,123,132,4954.92,59,41,33,74,48
Dublin,289,139,150,5871.24,40,37,56,82,74
Dublin,226,111,115,3657.73,31,33,63,82,17
Dublin,331,138,193,4480.42,49,30,39,81,132
Dublin,262,116,146,3853.62,47,22,76,67,50
Dublin,275,133,142,6262.24,61,33,60,72,49
Dublin,282,136,146,3765.12,69,35,62,66,50
Dublin,180,82,98,1811.63,22,27,31,51,49
Dublin,359,175,184,4293.64,45,57,111,100,46
Dublin,350,171,179,4211.29,65,48,69,102,66
Dublin,222,102,120,4937.06,35,22,32,44,89
Dublin,306,132,174,5317.95,59,39,49,71,88
Dublin,330,166,164,5059.8,47,16,116,106,45
Dublin,264,130,134,4186.22,36,22,101,71,34
Dublin,380,170,210,7047.35,63,59,81,111,66
Dublin,239,118,121,2654.91,47,44,46,76,26
Dublin,174,78,96,5321.75,16,23,81,32,22
Dublin,410,172,238,3641.11,54,31,64,91,170
Dublin,186,82,104,6083.6,42,14,58,51,21
Dublin,237,108,129,5270.65,57,18,64,57,41
Dublin,232,96,136,5873.72,50,21,54,68,39
Dublin,197,95,102,3282.24,43,32,32,59,31
Dublin,189,79,110,5667.51,38,29,44,55,23
Dublin,201,88,113,5051.52,32,17,72,49,31
Dublin,369,189,180,9549.69,119,47,110,90,3
Dublin,217,100,117,7038.14,27,23,55,58,54
Dublin,271,134,137,4870.68,59,33,75,72,32
Dublin,281,138,143,2383.56,44,30,76,77,54
Dublin,292,146,146,3262.35,65,37,84,77,29
Dublin,227,110,117,6578.18,31,31,61,61,43
Dublin,225,109,116,5161.85,34,18,45,56,72
Dublin,241,114,127,5894.87,52,25,88,38,38
Dublin,295,149,146,4494.48,57,34,66,77,61
Dublin,238,114,124,5117.62,33,29,46,72,58
Dublin,120,56,64,8378.72,10,6,65,27,12
Dublin,270,127,143,5325.86,43,33,91,77,26
Dublin,276,134,142,7360.79,54,30,91,65,36
Dublin,221,100,121,11358.38,43,17,67,59,35
Dublin,219,107,112,9828.12,33,26,64,68,28
Dublin,191,86,105,3452.08,20,22,54,45,50
Dublin,285,142,143,8743.94,40,36,83,81,45
Dublin,272,133,139,10525.5,45,32,106,63,26
Dublin,189,87,102,7027.33,32,24,55,47,31
Dublin,131,67,64,1441.98,20,19,41,36,15
Dublin,101,49,52,7008.54,9,13,14,22,43
Dublin,276,138,138,8042.19,48,31,94,62,41
Dublin,155,77,78,4466.47,22,13,60,34,26
Dublin,187,83,104,10447.51,27,17,71,51,21
Dublin,227,112,115,5771.82,35,19,78,59,36
Dublin,212,92,120,3507.73,35,11,78,35,53
Dublin,142,70,72,19932.62,16,4,111,10,1
Dublin,137,68,69,21867.52,12,4,107,10,4
Dublin,278,129,149,3090.88,45,35,92,66,40
Dublin,119,59,60,9950.66,14,9,65,20,11
Dublin,152,83,69,4200.87,14,16,72,42,8
Dublin,87,46,41,3428.17,8,3,56,18,2
Dublin,254,127,127,4730.33,34,27,87,68,38
Dublin,124,57,67,8928.57,5,7,82,17,13
Dublin,334,169,165,5074.83,50,47,93,103,41
Dublin,232,116,116,5698.15,61,28,41,85,17
Dublin,272,116,156,5438.37,41,38,109,58,26
Dublin,269,127,142,550.11,46,28,58,82,55
Dublin,189,88,101,6767.64,8,14,120,35,12
Dublin,151,73,78,9327.9,24,17,84,23,3
Dublin,204,90,114,4446.87,26,20,70,54,34
Dublin,218,102,116,9728.67,17,32,126,24,19
Dublin,151,65,86,7868.27,21,10,88,23,9
Dublin,241,129,112,452.63,20,42,128,36,15
Dublin,269,145,124,6269.52,30,16,132,48,43
Dublin,173,73,100,9041.97,24,23,78,30,18
Dublin,211,91,120,6755.46,32,25,60,49,45
Dublin,272,137,135,6637.71,43,46,76,74,33
Dublin,193,88,105,5715.13,34,17,69,40,33
Dublin,134,62,72,3954.55,10,16,52,33,23
Dublin,229,110,119,7496.89,44,16,74,55,40
Dublin,189,83,106,7176.49,24,34,32,64,35
Dublin,230,111,119,5480.76,35,37,56,58,44
Dublin,266,129,137,10167.81,53,18,90,69,36
Dublin,268,114,154,6713.43,59,39,65,51,54
Dublin,195,84,111,10687.86,39,17,57,36,46
Dublin,187,86,101,6894.26,29,11,63,43,41
Dublin,154,72,82,5433.63,15,13,51,36,39
Dublin,338,148,190,6160.58,58,34,90,82,74
Dublin,268,131,137,8165.26,41,42,77,70,38
Dublin,282,138,144,4552.13,56,29,87,51,59
Dublin,303,149,154,8751.91,54,30,89,77,53
Dublin,301,142,159,10750,58,45,84,78,36
Dublin,285,137,148,6538.2,81,36,111,45,12
Dublin,324,149,175,12109.43,61,40,94,72,57
Dublin,236,94,142,2366.48,50,33,63,44,46
Dublin,316,155,161,7626.59,47,41,100,81,47
Dublin,258,128,130,9037.09,38,22,66,76,56
Dublin,141,66,75,4456.81,23,16,40,49,13
Dublin,321,154,167,6004.83,62,35,85,76,63
Dublin,185,86,99,9419.55,31,24,52,49,29
Dublin,244,121,123,12032.74,35,49,58,57,45
Dublin,248,117,131,8454.07,41,32,81,64,30
Dublin,173,81,92,9071.36,34,22,43,41,33
Dublin,311,149,162,6862.31,63,39,71,90,48
Dublin,254,130,124,1801.51,39,37,53,91,34
Dublin,201,98,103,8247.85,30,24,72,33,42
Dublin,264,133,131,4175.04,40,30,80,67,47
Dublin,187,85,102,10322.94,27,20,53,50,37
Dublin,240,128,112,3981.29,36,36,74,54,40
Dublin,259,125,134,4884.4,48,36,83,48,44
Dublin,253,126,127,2905.98,41,26,82,56,48
Dublin,315,162,153,9512.59,57,45,92,72,49
Dublin,283,146,137,7807.54,44,39,81,59,60
Dublin,386,182,204,2029.01,63,60,104,93,66
Dublin,247,131,116,6531.63,41,47,77,55,27
Dublin,334,158,176,2297.17,55,49,94,93,43
Dublin,167,81,86,4613.77,24,16,67,35,25
Dublin,333,146,187,7041.66,54,49,91,77,62
Dublin,234,100,134,8243.79,40,24,56,63,51
Dublin,160,78,82,6273.77,31,20,48,39,22
Dublin,266,122,144,7345.43,51,38,127,37,13
Dublin,171,85,86,3808.55,25,15,52,42,37
Dublin,162,72,90,2166.24,36,17,52,38,19
Dublin,190,93,97,9412.93,32,14,63,41,40
Dublin,261,129,132,7732.19,39,29,93,65,35
Dublin,218,99,119,8411.14,41,45,56,51,25
Dublin,332,162,170,7970.42,63,48,102,71,48
Dublin,257,111,146,6511.44,46,15,98,43,55
Dublin,193,92,101,1650.01,23,30,64,51,25
Dublin,202,106,96,10279.38,24,22,57,53,46
Dublin,307,143,164,10819,55,41,77,76,58
Dublin,176,94,82,11851.05,37,20,54,37,28
Dublin,241,105,136,11270.11,35,29,71,57,49
Dublin,231,110,121,10803.98,53,30,104,36,8
Dublin,309,139,170,11339.87,73,37,91,73,35
Dublin,299,150,149,5330.81,43,26,86,89,55
Dublin,220,112,108,6944.01,33,30,65,55,37
Dublin,196,95,101,5394.54,42,24,66,41,23
Dublin,187,88,99,4573.02,31,21,45,55,35
Dublin,185,77,108,12159.85,37,24,56,40,28
Dublin,178,88,90,11669.07,26,25,61,40,26
Dublin,234,116,118,6595.08,55,26,102,38,13
Dublin,263,127,136,9421.8,32,36,92,67,36
Dublin,385,184,201,7342.14,66,68,105,95,51
Dublin,247,118,129,5232.27,30,34,65,75,43
Dublin,271,131,140,9801.08,46,34,89,51,51
Dublin,260,128,132,12606.06,61,38,84,57,20
Dublin,219,96,123,8702.56,31,23,70,50,45
Dublin,307,149,158,9329.61,52,37,95,76,47
Dublin,231,113,118,3293.6,46,25,73,53,34
Dublin,313,149,164,8967.71,46,40,85,91,51
Dublin,202,94,108,8641.34,35,26,63,54,24
Dublin,288,133,155,12157.03,75,47,82,48,36
Dublin,244,117,127,7762.79,44,30,60,71,39
Dublin,226,102,124,10411.39,33,42,61,59,31
Dublin,261,125,136,10135.14,43,28,85,58,47
Dublin,285,133,152,10891.16,48,40,76,80,41
Dublin,233,100,133,9194.22,48,25,79,47,34
Dublin,184,90,94,4438.44,27,18,58,54,27
Dublin,183,90,93,8736.75,31,27,47,45,33
Dublin,611,296,315,5189.84,244,65,150,108,44
Dublin,308,143,165,7382.9,58,29,126,59,36
Dublin,288,127,161,10358.59,52,30,82,73,51
Dublin,196,95,101,9774.59,38,29,53,50,26
Dublin,254,125,129,13386.74,50,36,70,66,32
Dublin,263,132,131,13990.85,48,38,92,56,29
Dublin,270,124,146,12259.35,64,32,72,63,39
Dublin,240,109,131,10574.08,32,28,57,84,39
Dublin,301,142,159,3354.69,48,57,74,91,31
Dublin,296,146,150,11275.33,60,28,94,81,33
Dublin,195,102,93,8820.34,34,33,50,57,21
Dublin,224,109,115,10841.68,40,28,55,68,33
Dublin,189,91,98,7578.8,37,27,47,55,23
Dublin,258,125,133,6252.73,30,27,71,78,52
Dublin,232,109,123,6355.29,27,21,78,67,39
Dublin,166,75,91,6730.73,27,17,51,45,26
Dublin,252,127,125,11726.38,51,24,97,66,14
Dublin,245,123,122,14611.16,48,29,86,71,11
Dublin,248,129,119,12496.22,41,31,102,52,22
Dublin,240,105,135,4026.1,26,68,76,38,32
Dublin,327,142,185,1096.79,48,64,51,100,64
Dublin,210,98,112,10229.43,28,15,135,22,10
Dublin,272,134,138,8479.6,28,33,169,35,7
Dublin,269,140,129,8796.89,18,21,194,24,12
Dublin,137,51,86,4062.51,5,42,43,27,20
Dublin,154,86,68,7667.8,16,25,81,23,9
Dublin,211,87,124,2817.8,36,38,67,44,26
Dublin,224,112,112,15562.04,13,28,174,8,1
Dublin,379,179,200,2130.19,38,34,191,64,52
Dublin,426,200,226,6587.8,60,82,112,125,47
Dublin,321,143,178,6493.9,69,54,87,71,40
Dublin,149,64,85,7740.66,12,24,49,41,23
Dublin,247,128,119,10103.9,22,28,108,50,39
Dublin,286,140,146,7473.61,38,48,76,58,66
Dublin,210,93,117,27940.39,11,20,175,3,1
Dublin,137,81,56,1792.11,14,22,56,29,16
Dublin,185,82,103,10096.6,20,23,73,22,47
Dublin,170,85,85,1378.75,13,27,93,27,10
Dublin,142,71,71,3866.05,10,5,118,8,1
Dublin,208,90,118,9800.23,17,66,61,42,22
Dublin,374,131,243,2580.15,26,233,65,31,19
Dublin,255,123,132,6923.7,49,45,56,66,39
Dublin,310,139,171,7679.54,41,45,94,83,47
Dublin,229,95,134,4285.58,23,29,61,58,58
Dublin,267,113,154,2754.99,56,38,40,77,56
Dublin,184,82,102,8143.39,29,18,55,45,37
Dublin,180,78,102,7516.29,28,24,62,26,40
Dublin,182,85,97,9194.71,26,24,63,36,33
Dublin,168,65,103,8913.41,17,15,67,24,45
Dublin,213,91,122,4318.91,27,35,65,38,48
Dublin,209,105,104,1505.33,49,37,47,52,24
Dublin,205,96,109,5119.11,45,22,50,47,41
Dublin,207,100,107,5384.04,30,31,53,60,33
Dublin,263,132,131,9588.74,55,44,60,69,35
Dublin,345,154,191,7377.31,72,52,90,99,32
Dublin,226,106,120,6422.28,33,25,60,69,39
Dublin,292,144,148,8184.77,60,57,63,88,24
Dublin,327,167,160,6800.32,62,48,85,71,61
Dublin,286,151,135,5190.19,61,43,78,62,42
Dublin,233,117,116,5101.37,30,22,56,64,61
Dublin,257,113,144,6194.56,44,27,63,71,52
Dublin,282,145,137,2724.27,52,38,78,59,55
Dublin,270,137,133,7580.86,52,34,83,73,28
Dublin,358,172,186,1489.39,65,49,109,89,46
Dublin,221,109,112,3499.33,34,37,55,59,36
Dublin,148,71,77,3540.59,23,18,25,46,36
Dublin,250,123,127,4756.2,26,23,42,52,107
Dublin,195,80,115,5554.29,26,19,31,44,75
Dublin,338,141,197,5773.63,42,31,69,75,121
Dublin,327,170,157,4158.72,60,34,87,58,88
Dublin,306,141,165,5557.27,64,38,106,60,38
Dublin,248,109,139,9481.57,54,43,67,52,32
Dublin,260,119,141,2831.35,37,40,60,71,52
Dublin,285,137,148,9018.7,48,40,67,70,60
Dublin,233,111,122,6853.34,36,29,60,55,53
Dublin,283,117,166,2415.17,38,30,53,64,98
Dublin,243,116,127,2498.84,43,34,68,87,11
Dublin,270,137,133,8424.34,60,48,61,82,19
Dublin,256,120,136,6501.09,40,39,66,61,50
Dublin,311,158,153,6953.14,86,60,79,52,34
Dublin,303,153,150,10265.62,76,45,109,56,17
Dublin,192,87,105,7828.11,42,25,49,40,36
Dublin,212,87,125,6625,46,43,55,47,21
Dublin,264,134,130,8251.81,41,45,77,69,32
Dublin,317,152,165,8107.21,88,29,97,64,39
Dublin,248,117,131,1777.47,38,42,61,78,29
Dublin,409,207,202,2183.78,113,65,124,78,29
Dublin,202,95,107,6443.38,39,37,38,43,45
Dublin,241,104,137,3543.28,59,35,53,50,44
Dublin,265,128,137,7398.72,57,42,63,46,57
Dublin,235,92,143,5426.25,47,52,51,48,37
Dublin,287,139,148,9245.54,67,48,71,65,36
Dublin,311,142,169,8410.41,60,61,64,76,50
Dublin,254,123,131,8377.59,47,26,86,55,40
Dublin,184,77,107,4735.43,31,32,48,50,23
Dublin,217,95,122,9282.63,59,35,59,48,16
Dublin,252,120,132,2356.18,38,30,54,67,63
Dublin,222,88,134,2938.33,34,32,53,66,37
Dublin,81,53,28,3291.08,4,3,10,35,29
Dublin,260,130,130,1957.42,48,41,74,66,31
Dublin,172,87,85,4945.8,28,18,50,45,31
Dublin,155,71,84,4300.66,24,20,42,45,24
Dublin,268,134,134,8510.64,42,53,59,90,24
Dublin,184,86,98,4643.77,23,14,42,46,59
Dublin,223,100,123,5313.32,45,19,73,50,36
Dublin,190,99,91,3848.34,37,25,46,60,22
Dublin,200,103,97,5843.17,29,25,57,59,30
Dublin,292,145,147,6607.83,41,35,88,72,56
Dublin,217,95,122,5679.14,39,19,50,54,55
Dublin,228,119,109,5181.11,44,23,75,55,31
Dublin,206,108,98,4882.21,35,25,58,60,28
Dublin,176,87,89,5894.37,22,16,43,56,39
Dublin,300,136,164,511.39,56,35,79,50,80
Dublin,230,117,113,4702.61,44,19,82,49,36
Dublin,206,95,111,22881.26,49,27,118,12,0
Dublin,236,118,118,6227.08,40,28,61,58,49
Dublin,366,159,207,1963.46,87,52,86,92,49
Dublin,278,139,139,7878.03,47,52,55,89,35
Dublin,274,127,147,8158.65,75,32,71,49,47
Dublin,276,129,147,6297.63,70,47,72,64,23
Dublin,274,136,138,7270.6,67,28,71,64,44
Dublin,192,96,96,3344.66,48,5,94,17,28
Dublin,254,129,125,7914.75,65,34,65,45,45
Dublin,170,85,85,7773.92,33,22,38,35,42
Dublin,221,100,121,4569.8,46,27,49,56,43
Dublin,242,125,117,4536.76,47,36,63,53,43
Dublin,365,180,185,10398.27,118,47,128,52,20
Dublin,246,126,120,4932.73,52,28,74,50,42
Dublin,324,161,163,6875.04,72,35,95,93,29
Dublin,213,110,103,1295.19,38,31,57,65,22
Dublin,228,120,108,2390.49,45,27,61,49,46
Dublin,175,85,90,2145.9,21,23,115,13,3
Dublin,323,156,167,10405.26,75,47,93,74,34
Dublin,219,106,113,2786.08,55,39,62,31,32
Dublin,252,117,135,19386.11,44,25,161,22,0
Dublin,231,110,121,8976.45,45,15,152,18,1
Dublin,354,170,184,10160.44,76,52,112,73,41
Dublin,116,58,58,11977.28,12,10,84,10,0
Dublin,344,160,184,4741.75,60,72,139,52,21
Dublin,252,118,134,5716.1,51,33,72,57,39
Dublin,226,108,118,1061.8,71,30,79,43,3
Dublin,322,155,167,6280.72,83,47,87,62,43
Dublin,269,124,145,8523.72,64,33,79,51,42
Dublin,321,153,168,5755.58,73,41,86,71,50
Dublin,312,143,169,4263.52,98,52,86,47,29
Dublin,233,118,115,8917.29,58,30,62,46,37
Dublin,307,145,162,7668.29,67,46,71,81,42
Dublin,218,116,102,7129.77,48,25,61,54,30
Dublin,248,112,136,6389.12,57,24,63,53,51
Dublin,277,121,156,14578.95,58,45,88,61,25
Dublin,331,160,171,9249.94,83,52,88,48,60
Dublin,317,162,155,10004.42,81,45,96,52,43
Dublin,182,88,94,4752.08,48,14,86,21,13
Dublin,186,85,101,1312.87,60,9,86,23,8
Dublin,236,111,125,8596.2,65,24,85,37,25
Dublin,192,100,92,6744.18,49,16,56,30,41
Dublin,308,157,151,6945.7,83,41,77,72,35
Dublin,245,111,134,4497.31,54,31,88,37,35
Dublin,314,156,158,8160.08,86,43,95,43,47
Dublin,288,147,141,4856.25,53,59,53,90,33
Dublin,245,124,121,2430.34,43,33,65,64,40
Dublin,286,131,155,6775,57,37,63,73,56
Dublin,218,101,117,5747.13,17,35,59,57,50
Dublin,233,103,130,8125.83,21,33,54,66,59
Dublin,227,105,122,8923.66,23,28,67,60,49
Dublin,260,130,130,7849.53,20,41,58,87,54
Dublin,181,88,93,4401.64,25,24,42,53,37
Dublin,259,121,138,7804.03,40,29,63,84,43
Dublin,228,113,115,7760.38,47,28,65,59,29
Dublin,257,112,145,10333.74,46,24,88,58,41
Dublin,172,82,90,10113.48,22,19,57,37,37
Dublin,320,165,155,12730.24,60,73,60,111,16
Dublin,299,143,156,8816.16,61,52,90,90,6
Dublin,267,120,147,4180.56,42,57,55,63,50
Dublin,356,176,180,10238.42,67,87,60,129,13
Dublin,171,75,96,9707.64,22,10,114,15,10
Dublin,252,112,140,5888.26,45,27,104,46,30
Dublin,268,128,140,7863.16,44,31,80,59,54
Dublin,223,111,112,7020.75,26,26,81,52,38
Dublin,303,154,149,8223.19,31,41,82,117,32
Dublin,357,136,221,814.17,40,86,52,72,107
Dublin,421,204,217,9876.83,157,45,158,56,5
Dublin,406,186,220,1186.94,96,25,242,33,10
Dublin,279,138,141,4127.65,59,46,85,75,14
Dublin,375,179,196,8497.81,58,57,102,113,45
Dublin,317,153,164,7142.37,81,38,97,72,29
Dublin,285,136,149,8259.67,50,45,80,92,18
Dublin,320,167,153,4348.54,56,33,85,116,30
Dublin,252,132,120,6659.27,25,31,75,80,41
Dublin,277,144,133,6332.15,34,44,66,97,36
Dublin,307,155,152,8254.24,54,50,76,95,32
Dublin,390,190,200,10289.42,83,61,111,114,21
Dublin,262,128,134,9018.93,112,18,109,18,5
Dublin,276,147,129,3685.45,38,47,75,89,27
Dublin,344,179,165,9805.32,107,50,126,53,8
Dublin,369,175,194,11264.77,129,52,126,57,5
Dublin,300,151,149,9814.51,102,27,133,34,4
Dublin,362,171,191,10366.55,125,41,127,67,2
Dublin,293,146,147,8513.48,92,49,98,50,4
Dublin,388,191,197,9423.88,138,52,139,55,4
Dublin,450,243,207,7885.61,154,43,152,86,15
Dublin,283,137,146,8104.93,75,45,96,64,3
Dublin,240,109,131,5211.5,55,11,157,14,3
Dublin,344,161,183,1527.08,85,26,217,15,1
Dublin,230,114,116,3565.39,58,48,75,45,4
Dublin,147,64,83,24936.39,39,23,78,6,1
Dublin,144,71,73,14229.25,46,15,75,8,0
Dublin,174,82,92,13066.99,40,12,98,17,7
Dublin,145,66,79,10543.15,35,14,82,9,5
Dublin,432,206,226,5109.1,70,60,119,153,30
Dublin,328,163,165,7176.46,75,46,79,106,22
Dublin,321,155,166,8160.05,62,38,102,90,29
Dublin,338,173,165,9766.81,98,24,193,18,5
Dublin,281,142,139,12407.82,82,16,172,10,1
Dublin,345,161,184,2035.51,76,42,114,92,21
Dublin,178,92,86,15778.74,36,6,129,7,0
Dublin,390,202,188,16528.23,114,32,231,10,3
Dublin,281,132,149,10055.47,85,16,150,27,3
Dublin,274,137,137,22289.11,41,26,193,14,0
Dublin,210,97,113,26421.74,28,18,158,6,0
Dublin,200,90,110,7842.21,36,16,135,13,0
Dublin,238,116,122,11235.96,55,35,65,64,19
Dublin,228,110,118,2708.48,31,41,63,86,7
Dublin,235,121,114,5525.38,39,39,75,45,37
Dublin,245,119,126,6345.51,35,33,52,51,74
Dublin,260,128,132,5473.57,42,32,78,64,44
Dublin,293,139,154,8335.47,52,29,67,64,81
Dublin,315,152,163,9134.14,51,41,79,76,68
Dublin,245,122,123,9801.96,38,39,66,51,51
Dublin,258,127,131,3152.03,39,34,76,68,41
Dublin,385,204,181,9166.45,64,45,112,65,99
Dublin,362,175,187,8242.63,58,41,90,84,89
Dublin,218,112,106,5760.03,45,28,71,35,39
Dublin,232,116,116,5386.45,37,36,83,37,39
Dublin,274,124,150,10676.02,57,54,68,80,15
Dublin,259,111,148,6569.94,35,52,59,92,21
Dublin,262,130,132,5796.08,46,30,59,74,53
Dublin,216,108,108,2873.68,23,20,41,54,78
Dublin,241,119,122,7151.55,31,17,72,51,70
Dublin,232,112,120,6583.61,33,35,53,60,51
Dublin,273,131,142,5823.5,39,23,71,51,89
Dublin,244,113,131,3491.2,43,27,76,35,63
Dublin,252,120,132,7869.59,51,38,73,60,30
Dublin,295,142,153,6323.42,30,36,76,99,54
Dublin,333,172,161,6944.73,79,46,93,77,38
Dublin,428,207,221,12286.85,150,73,132,51,22
Dublin,371,176,195,8658.51,77,58,135,87,14
Dublin,425,206,219,5079.96,55,80,126,135,29
Dublin,215,104,111,5069.2,43,19,60,47,46
Dublin,209,106,103,3066.63,29,33,56,49,42
Dublin,203,95,108,7815.81,18,27,40,57,61
Dublin,251,127,124,7403.91,37,28,61,43,82
Dublin,263,132,131,5949.69,29,27,52,71,84
Dublin,229,115,114,6747.2,40,26,62,44,57
Dublin,223,110,113,7067.7,60,20,77,34,32
Dublin,281,131,150,5453.98,38,35,85,71,52
Dublin,210,98,112,6645.99,27,21,45,59,58
Dublin,241,126,115,6519.86,42,30,55,78,36
Dublin,255,126,129,1660.17,63,53,78,43,18
Dublin,208,96,112,2246.1,38,25,57,66,22
Dublin,368,179,189,9389.67,57,55,100,126,30
Dublin,230,105,125,3157.48,35,29,48,63,55
Dublin,226,97,129,6511.28,31,17,38,43,97
Dublin,252,124,128,5092.14,24,21,64,39,104
Dublin,201,96,105,5392.21,26,21,50,28,76
Dublin,220,103,117,5431.43,27,20,39,32,102
Dublin,269,130,139,7034.15,46,30,77,69,47
Dublin,258,110,148,2588.07,45,20,51,66,76
Dublin,210,101,109,5366.86,22,39,66,55,28
Dublin,280,128,152,4151.65,56,44,82,66,32
Dublin,231,107,124,5821.57,35,25,69,52,50
Dublin,283,135,148,5179.55,44,42,68,61,68
Dublin,261,133,128,5372.03,54,17,75,60,55
Dublin,195,78,117,2965.24,39,31,50,46,29
Dublin,259,130,129,3306.27,43,31,72,65,48
Dublin,277,146,131,4564.71,50,42,80,70,35
Dublin,312,150,162,8009.45,59,46,88,90,29
Dublin,316,149,167,4965.27,71,32,89,81,43
Dublin,300,144,156,7499.81,52,42,84,80,42
Dublin,250,119,131,2824,44,33,79,51,43
Dublin,220,114,106,381.56,36,27,75,58,24
Dublin,261,129,132,1254.12,41,19,94,62,45
Dublin,193,101,92,9736.66,27,18,66,42,40
Dublin,130,73,57,5472.76,16,19,57,24,14
Dublin,191,97,94,7402.24,39,16,68,36,32
Dublin,255,128,127,10795.02,45,32,127,42,9
Dublin,191,88,103,9519.06,25,26,58,59,23
Dublin,153,67,86,9763.88,19,14,50,37,33
Dublin,116,56,60,10259.13,14,9,40,23,30
Dublin,178,77,101,14807.42,27,18,62,44,27
Dublin,151,78,73,8769.38,26,9,87,20,9
Dublin,157,90,67,3165.71,14,9,43,41,50
Dublin,201,99,102,1250.05,38,27,72,46,18
Dublin,332,151,181,2881.39,63,40,92,90,47
Dublin,256,126,130,5863.22,49,34,83,56,34
Dublin,258,115,143,7929.68,64,47,81,47,19
Dublin,219,108,111,9104.14,51,26,58,59,25
Dublin,253,132,121,4109.68,49,35,57,74,38
Dublin,280,139,141,808.88,50,28,88,64,50
Dublin,193,91,102,5855.58,36,23,47,53,34
Dublin,261,124,137,52525.66,48,22,166,19,6
Dublin,93,45,48,6461.92,6,14,42,13,18
Dublin,110,49,61,11219.91,7,28,49,18,8
Dublin,109,55,54,14387.54,5,19,52,15,18
Dublin,102,52,50,10621.68,6,17,45,19,15
Dublin,133,78,55,14411.1,6,32,66,20,9
Dublin,116,54,62,20751.34,8,28,50,20,10
Dublin,109,49,60,17804.64,3,27,54,14,11
Dublin,145,73,72,20442.69,25,20,68,19,13
Dublin,"1,941","1,438",503,11347.69,17,453,779,274,418
Dublin,184,96,88,7765.35,30,13,128,13,0
Dublin,93,46,47,22928.99,15,20,43,13,2
Dublin,83,41,42,15195.9,6,13,41,13,10
Dublin,104,59,45,9063.18,8,11,59,22,4
Dublin,125,77,48,15131.34,12,28,54,24,7
Dublin,81,31,50,20574.04,9,15,38,12,7
Dublin,162,87,75,11377.2,16,28,46,46,26
Dublin,125,69,56,8961.86,9,40,52,19,5
Dublin,174,94,80,14039.05,12,41,82,20,19
Dublin,287,147,140,9688.74,31,38,153,51,14
Dublin,206,96,110,10134.8,15,31,98,39,23
Dublin,220,113,107,23364.49,14,31,145,27,3
Dublin,141,81,60,8172.02,6,30,72,20,13
Dublin,230,139,91,9327.98,10,30,117,49,24
Dublin,224,121,103,9942.74,9,43,147,22,3
Dublin,213,103,110,11920.75,21,13,108,35,36
Dublin,180,95,85,9278.35,25,26,77,34,18
Dublin,193,101,92,17439.23,26,41,80,31,15
Dublin,225,111,114,11618.3,28,32,117,36,12
Dublin,104,62,42,7625.75,11,28,27,29,9
Dublin,152,70,82,17819.46,36,19,32,35,30
Dublin,140,80,60,8541.79,4,59,63,13,1
Dublin,148,65,83,35852.71,20,21,60,40,7
Dublin,144,72,72,27210.88,18,18,83,21,4
Dublin,262,152,110,15537.9,6,66,89,65,36
Dublin,223,115,108,3587,31,23,71,57,41
Dublin,196,90,106,13888.89,14,31,97,34,20
Dublin,211,119,92,10901.01,26,47,118,19,1
Dublin,171,96,75,105101.41,21,27,113,10,0
Dublin,133,73,60,3178.02,0,34,65,13,21
Dublin,276,145,131,15617.04,30,36,122,51,37
Dublin,182,91,91,13626.83,31,28,64,45,14
Dublin,164,86,78,18968.31,16,27,72,27,22
Dublin,155,69,86,14640.6,17,19,46,47,26
Dublin,308,138,170,7584.34,72,60,97,56,23
Dublin,201,96,105,7135.5,26,38,75,47,15
Dublin,228,135,93,41394.34,11,78,123,15,1
Dublin,261,136,125,12100.7,36,52,134,33,6
Dublin,197,105,92,5592.78,22,17,59,50,49
Dublin,218,106,112,6859.66,24,28,55,66,45
Dublin,285,142,143,11635.98,58,38,80,80,29
Dublin,193,93,100,10356.3,41,29,57,44,22
Dublin,190,87,103,12139.8,43,25,50,54,18
Dublin,124,59,65,4754.78,7,12,51,33,21
Dublin,229,121,108,12535.58,28,26,72,64,39
Dublin,234,120,114,13408.97,36,39,51,77,31
Dublin,223,96,127,11324.97,46,32,54,53,38
Dublin,237,119,118,9859.39,37,35,59,72,34
Dublin,187,85,102,22166.9,39,4,127,17,0
Dublin,194,79,115,16428.15,26,10,135,20,3
Dublin,170,79,91,2211.84,27,10,63,41,29
Dublin,209,94,115,7544.04,42,17,66,64,20
Dublin,179,79,100,4759.63,17,25,67,36,34
Dublin,259,126,133,530.31,49,22,68,68,52
Dublin,231,123,108,6093.86,19,23,155,19,15
Dublin,137,71,66,3861.44,17,21,67,22,10
Dublin,337,181,156,70472.61,19,20,273,24,1
Dublin,328,165,163,5103.07,30,33,170,82,13
Dublin,182,92,90,6719.34,11,8,149,13,1
Dublin,201,97,104,14839.42,12,10,164,14,1
Dublin,287,129,158,3235.44,53,22,147,25,40
Dublin,189,86,103,21387.35,40,23,91,25,10
Dublin,185,89,96,19023.14,36,13,105,26,5
Dublin,176,79,97,26031.65,30,15,122,9,0
Dublin,167,85,82,4231.81,22,20,67,37,21
Dublin,165,79,86,7550.8,20,22,47,45,31
Dublin,219,103,116,8960.35,36,24,63,45,51
Dublin,184,93,91,1559.07,24,14,36,50,60
Dublin,252,127,125,7177.24,24,23,162,32,11
Dublin,289,138,151,20724.27,72,49,77,64,27
Dublin,213,116,97,5597.46,51,42,80,35,5
Dublin,202,94,108,29510.59,36,22,125,16,3
Dublin,266,122,144,11343.77,50,33,90,52,41
Dublin,182,98,84,9983.54,18,25,59,49,31
Dublin,295,138,157,8648.24,37,35,99,71,53
Dublin,244,119,125,11181.38,40,38,93,52,21
Dublin,310,136,174,9529.96,45,39,102,74,50
Dublin,205,102,103,1921.58,33,39,43,35,55
Dublin,301,143,158,6317.29,75,39,78,53,56
Dublin,222,97,125,2766.46,47,39,58,36,42
Dublin,336,150,186,5729.78,117,53,86,51,29
Dublin,351,185,166,1474.94,52,50,81,67,101
Dublin,311,146,165,4819.84,43,41,68,66,93
Dublin,290,135,155,5912.94,32,36,53,65,104
Dublin,285,143,142,5252.49,37,40,57,58,93
Dublin,254,129,125,3473.79,27,21,56,49,101
Dublin,205,106,99,1597,27,39,54,62,23
Dublin,239,113,126,3747.79,34,27,59,67,52
Dublin,273,136,137,6704.98,52,31,57,78,55
Dublin,225,111,114,5102.62,25,35,53,85,27
Dublin,316,150,166,1471.8,59,55,99,53,50
Dublin,258,125,133,7130.81,40,27,78,47,66
Dublin,205,100,105,8089.98,30,35,56,30,54
Dublin,335,168,167,5494.15,63,39,91,70,72
Dublin,275,132,143,6415.19,86,33,84,60,12
Dublin,334,169,165,7249.52,101,47,89,92,5
Dublin,302,142,160,8238.76,104,45,93,58,2
Dublin,306,151,155,8941.36,106,38,93,62,7
Dublin,310,154,156,9399.35,90,44,101,70,5
Dublin,357,156,201,3510.15,101,57,132,53,14
Dublin,247,112,135,3532.46,52,26,143,24,2
Dublin,260,121,139,3864.5,67,31,140,18,4
Dublin,264,122,142,8029.69,37,32,72,57,66
Dublin,218,107,111,8352.49,40,32,47,47,52
Dublin,234,109,125,8845.88,42,40,51,40,61
Dublin,204,97,107,7512.15,37,22,61,35,49
Dublin,281,138,143,6358.33,53,33,83,49,63
Dublin,216,103,113,8482.56,46,25,67,38,40
Dublin,223,105,118,8959.42,43,26,66,44,44
Dublin,140,63,77,5529.01,24,32,43,35,6
Dublin,230,106,124,8884.77,56,22,69,44,39
Dublin,191,83,108,3578.99,25,31,32,41,62
Dublin,399,188,211,2298.31,83,56,110,65,85
Dublin,340,164,176,9745.75,63,58,88,91,40
Dublin,296,150,146,5445.68,55,38,84,80,39
Dublin,204,94,110,10668.34,34,24,56,61,29
Dublin,286,133,153,7094.66,47,34,84,87,34
Dublin,298,135,163,3504.89,40,40,85,88,45
Dublin,191,95,96,8472.7,26,20,57,53,35
Dublin,219,112,107,11514.2,40,47,65,48,19
Dublin,212,99,113,9679.48,29,37,56,46,44
Dublin,260,115,145,7387.83,44,36,77,73,30
Dublin,279,126,153,10484.78,57,33,89,63,37
Dublin,329,155,174,10738.3,59,39,98,81,52
Dublin,211,101,110,6974.05,31,24,58,54,44
Dublin,218,113,105,6722.79,29,27,64,53,45
Dublin,251,112,139,7836.4,40,33,57,82,39
Dublin,206,105,101,9369.17,33,26,51,49,47
Dublin,318,155,163,6889.98,52,31,103,85,47
Dublin,344,172,172,7705.23,70,43,107,75,49
Dublin,267,117,150,8023.08,37,31,85,76,38
Dublin,195,94,101,7399.54,24,32,56,48,35
Dublin,230,108,122,8330.62,43,28,75,50,34
Dublin,165,79,86,7518.8,32,27,52,28,26
Dublin,187,84,103,4614.32,15,29,86,31,26
Dublin,219,113,106,6350.03,39,15,91,45,29
Dublin,316,155,161,6853.92,42,38,82,102,52
Dublin,184,89,95,9231.85,27,22,114,20,1
Dublin,214,92,122,9384.73,10,41,147,15,1
Dublin,196,98,98,857.75,27,18,86,32,33
Dublin,254,139,115,7243.9,29,45,66,70,44
Dublin,314,165,149,3568.55,35,42,189,22,26
Dublin,154,77,77,7281.32,17,32,65,24,16
Dublin,289,114,175,920.57,17,35,63,46,128
Dublin,129,54,75,4961.54,3,3,74,37,12
Dublin,248,105,143,8920.54,36,24,86,41,61
Dublin,240,112,128,6760.37,8,44,154,22,12
Dublin,133,70,63,1592.85,20,18,51,26,18
Dublin,172,78,94,4902.52,29,23,51,54,15
Dublin,176,80,96,5358.5,25,30,47,64,10
Dublin,405,194,211,10662.66,92,71,122,74,46
Dublin,235,96,139,4497.44,24,17,88,49,57
Dublin,266,127,139,8358.47,42,31,94,57,42
Dublin,335,168,167,10895.73,61,42,86,86,60
Dublin,167,72,95,4046.33,26,11,58,35,37
Dublin,300,130,170,6631.45,32,34,86,85,63
Dublin,185,86,99,5384.32,25,24,51,43,42
Dublin,246,117,129,2288.18,37,26,87,70,26
Dublin,173,86,87,4607.56,26,27,39,54,27
Dublin,234,111,123,9522.65,33,33,80,61,27
Dublin,263,142,121,9148.78,48,28,75,80,32
Dublin,239,117,122,9631.27,40,23,67,64,45
Dublin,275,126,149,7107.78,44,24,130,62,15
Dublin,191,103,88,8906.92,35,34,40,57,25
Dublin,203,99,104,7822.43,43,25,61,45,29
Dublin,181,84,97,8799.65,31,26,55,53,16
Dublin,290,140,150,2433.27,38,34,71,81,66
Dublin,212,101,111,6770.35,28,26,95,44,19
Dublin,187,78,109,4961.13,30,24,74,41,18
Dublin,333,155,178,6154.02,55,45,86,90,57
Dublin,209,97,112,2515.44,31,23,54,52,49
Dublin,341,167,174,1079.63,73,49,117,68,34
Dublin,204,92,112,9979.45,42,15,54,53,40
Dublin,222,104,118,8604.98,40,37,47,67,31
Dublin,252,122,130,10282.78,46,36,74,56,40
Dublin,334,147,187,9636.47,80,48,73,83,50
Dublin,329,150,179,9011.72,64,38,100,85,42
Dublin,284,136,148,7048.37,56,33,81,67,47
Dublin,320,154,166,10387.59,61,46,74,90,49
Dublin,280,124,156,5654.74,53,31,77,65,54
Dublin,632,298,334,2776.47,4,321,193,79,35
Dublin,206,104,102,13354.08,6,55,133,9,3
Dublin,124,64,60,2698.59,3,30,80,3,8
Dublin,408,210,198,11391.56,8,69,223,87,21
Dublin,123,67,56,17551.37,1,24,92,5,1
Dublin,346,177,169,7929.41,50,49,150,68,29
Dublin,166,84,82,4174.32,8,30,52,44,32
Dublin,133,61,72,29340.39,44,11,37,26,15
Dublin,207,116,91,10081.33,8,39,113,33,14
Dublin,156,78,78,23266.22,3,52,89,9,3
Dublin,155,80,75,16204.91,26,22,53,41,13
Dublin,181,84,97,30196.86,56,21,54,37,13
Dublin,185,106,79,3199.36,19,21,62,43,40
Dublin,180,96,84,8810.57,50,28,54,37,11
Dublin,184,101,83,23831.11,50,29,52,44,9
Dublin,159,83,76,21665.08,49,18,46,39,7
Dublin,179,94,85,4697.55,17,19,49,56,38
Dublin,166,86,80,11213.19,8,44,101,11,2
Dublin,162,79,83,12385.32,8,24,117,9,4
Dublin,295,138,157,6751.5,18,112,61,64,40
Dublin,440,252,188,1155.39,17,46,170,167,40
Dublin,217,117,100,2806.77,9,48,113,35,12
Dublin,185,98,87,2555.53,7,69,78,21,10
Dublin,227,143,84,1798.36,5,24,103,75,20
Dublin,203,122,81,6523.14,17,35,131,12,8
Dublin,276,134,142,28203.56,69,40,89,60,18
Dublin,241,117,124,23228.92,64,45,71,48,13
Dublin,128,71,57,29997.66,5,15,98,10,0
Dublin,138,68,70,14524.79,7,38,87,6,0
Dublin,438,235,203,7069.53,21,156,160,74,27
Dublin,194,82,112,26869.81,48,23,55,48,20
Dublin,216,119,97,31097.03,4,72,127,12,1
Dublin,146,70,76,13849.36,9,19,105,11,2
Dublin,295,140,155,11097.74,40,94,121,34,6
Dublin,196,99,97,12442.86,11,43,100,19,23
Dublin,122,63,59,16694.03,15,11,72,16,8
Dublin,139,75,64,19525.21,20,22,65,25,7
Dublin,135,71,64,9275.16,15,31,80,7,2
Dublin,133,64,69,18645.73,18,16,73,18,8
Dublin,178,89,89,14887.92,12,17,91,28,30
Dublin,268,130,138,9401.86,23,67,110,49,19
Dublin,181,96,85,17035.29,17,22,82,35,25
Dublin,263,132,131,25440.12,21,60,151,21,10
Dublin,262,160,102,42511.76,38,51,162,10,1
Dublin,207,95,112,19469.53,14,42,125,25,1
Dublin,152,81,71,51630.43,9,32,94,16,1
Dublin,155,71,84,26142.69,2,24,110,17,2
Dublin,231,120,111,21313.9,11,36,158,24,2
Dublin,261,143,118,15777.07,23,63,126,37,12
Dublin,150,81,69,24275.77,20,23,79,21,7
Dublin,152,105,47,8590.48,2,15,79,48,8
Dublin,115,56,59,17327.11,6,23,65,7,14
Dublin,173,98,75,8375.29,21,39,92,14,7
Dublin,199,96,103,12117.15,24,64,82,14,15
Dublin,150,63,87,15370.43,3,39,100,5,3
Dublin,159,58,101,21588.59,44,17,41,25,32
Dublin,158,73,85,19931.88,33,18,50,26,31
Dublin,234,123,111,30813.8,20,47,135,19,13
Dublin,223,127,96,3095.33,23,59,83,41,17
Dublin,267,128,139,6100.35,33,28,121,37,48
Dublin,222,112,110,9559.9,14,35,97,45,31
Dublin,212,116,96,23433.18,13,27,131,15,26
Dublin,120,63,57,4540.81,13,18,52,22,15
Dublin,344,186,158,19267.39,52,53,137,60,42
Dublin,123,66,57,21163.11,3,16,57,29,18
Dublin,191,85,106,29913.86,43,29,74,38,7
Dublin,190,99,91,6361.75,12,43,127,7,1
Dublin,204,102,102,12064.58,9,42,142,11,0
Dublin,229,115,114,60026.21,22,23,174,10,0
Dublin,196,109,87,16150.3,10,50,118,18,0
Dublin,225,111,114,9572.43,11,58,128,18,10
Dublin,183,93,90,13283.97,30,27,59,55,12
Dublin,236,122,114,11970.58,49,18,101,40,28
Dublin,299,145,154,11737,39,42,131,42,45
Dublin,186,85,101,12191.92,31,30,61,36,28
Dublin,171,82,89,6167.5,13,29,60,35,34
Dublin,238,109,129,13142.64,30,38,103,45,22
Dublin,251,133,118,12921.49,37,42,95,53,24
Dublin,195,107,88,14458.37,22,25,105,30,13
Dublin,228,107,121,9936.81,17,17,94,57,43
Dublin,220,101,119,3781.95,23,20,75,46,56
Dublin,172,101,71,10648.18,18,55,49,23,27
Dublin,293,168,125,6528.96,26,63,148,47,9
Dublin,297,86,211,6617.35,1,251,12,0,33
Dublin,147,83,64,17839.81,20,24,93,4,6
Dublin,122,56,66,8038.48,9,10,58,29,16
Dublin,200,95,105,10832.48,35,29,81,40,15
Dublin,242,137,105,42771.3,0,221,19,2,0
Dublin,252,123,129,9548.71,24,37,131,39,21
Dublin,272,131,141,8392.73,48,26,113,55,30
Dublin,148,74,74,20939.45,21,9,90,25,3
Dublin,208,103,105,31156.38,17,39,135,14,3
Dublin,429,181,248,5632.14,111,45,200,50,23
Dublin,282,152,130,5025.75,32,40,113,71,26
Dublin,172,67,105,7711.62,61,26,49,25,11
Dublin,202,98,104,16331.15,15,28,109,31,19
Dublin,144,61,83,9828.01,49,25,40,20,10
Dublin,196,85,111,17028.67,77,28,59,29,3
Dublin,195,95,100,42678.92,17,27,143,8,0
Dublin,189,93,96,17589.58,25,31,90,33,10
Dublin,332,173,159,3988.42,37,70,141,48,36
Dublin,264,127,137,34183.61,47,34,146,30,7
Dublin,771,375,396,22259.43,23,292,293,109,54
Dublin,301,157,144,13894.66,35,61,134,55,16
Dublin,527,258,269,16868.86,34,102,229,134,28
Dublin,189,99,90,20067.95,8,26,139,6,10
Dublin,151,70,81,19012.84,38,30,40,31,12
Dublin,198,109,89,27611.21,30,63,67,25,13
Dublin,113,67,46,20139.01,20,12,57,24,0
Dublin,269,129,140,13753.96,59,48,103,47,12
Dublin,238,124,114,8025.09,49,25,59,71,34
Dublin,354,209,145,19148.59,25,124,176,24,5
Dublin,166,83,83,59476.89,17,24,97,12,16
Dublin,333,170,163,21999.08,24,69,232,8,0
Dublin,271,118,153,7836.9,66,48,70,59,28
Dublin,319,160,159,8858.9,44,81,107,69,18
Dublin,745,380,365,78075.88,40,181,383,106,35
Dublin,181,100,81,10872.83,14,39,75,34,19
Dublin,154,73,81,13660.96,14,24,55,36,25
Dublin,137,86,51,12952.63,9,39,70,16,3
Dublin,150,71,79,5353.89,7,35,96,12,0
Dublin,153,84,69,8747.86,24,34,73,19,3
Dublin,149,88,61,10448.08,10,18,87,25,9
Dublin,189,103,86,15592.77,22,44,79,34,10
Dublin,82,47,35,11138.28,6,4,51,19,2
Dublin,178,87,91,36371.07,23,28,118,9,0
Dublin,300,150,150,35435.86,27,68,182,22,1
Dublin,201,116,85,10880.16,14,35,130,15,7
Dublin,133,74,59,37234.04,11,8,92,19,3
Dublin,294,142,152,11803.44,77,56,78,59,24
Dublin,192,87,105,6775.83,6,34,66,8,78
Dublin,105,69,36,9946.95,3,22,48,31,1
Dublin,134,74,60,21491.58,1,48,69,14,2
Dublin,243,129,114,3103.69,7,37,192,7,0
Dublin,108,64,44,2934.54,5,13,67,20,3
Dublin,274,145,129,21883.24,22,58,172,20,2
Dublin,253,127,126,59895.83,23,45,173,12,0
Dublin,299,157,142,27803.61,18,41,153,48,39
Dublin,271,141,130,43318.41,9,54,187,20,1
Dublin,168,99,69,5922.79,6,25,120,17,0
Dublin,179,84,95,8803.42,4,26,108,39,2
Dublin,350,192,158,9758,25,66,239,17,3
Dublin,773,305,468,13887.64,51,175,352,158,37
Dublin,224,128,96,13330.95,13,29,160,20,2
Dublin,133,67,66,28565.29,5,24,93,10,1
Dublin,128,69,59,23494.86,8,21,85,10,4
Dublin,248,138,110,45722.71,13,42,168,21,4
Dublin,457,199,258,17588.42,7,113,215,92,30
Dublin,494,230,264,3414.15,11,77,219,132,55
Dublin,136,73,63,4854.54,3,31,66,25,11
Dublin,214,98,116,33722.03,16,39,138,16,5
Dublin,393,198,195,10137.75,39,74,188,65,27
Dublin,235,112,123,6098.35,28,18,86,64,39
Dublin,232,133,99,14708.68,24,31,102,44,31
Dublin,179,87,92,13035.25,19,14,70,42,34
Dublin,180,109,71,8945.43,15,16,83,36,30
Dublin,317,151,166,9216.99,47,37,168,42,23
Dublin,160,83,77,7211.43,15,28,81,28,8
Dublin,232,125,107,11991.52,34,44,71,54,29
Dublin,221,118,103,11897.71,45,26,58,57,35
Dublin,221,107,114,9746.85,38,36,82,48,17
Dublin,175,87,88,14243.85,24,25,65,37,24
Dublin,187,99,88,10353.23,33,20,66,39,29
Dublin,207,98,109,5624.24,30,33,81,38,25
Dublin,163,79,84,3958.04,12,24,54,43,30
Dublin,253,118,135,9900.6,35,35,107,48,28
Dublin,132,65,67,17223.38,20,32,75,4,1
Dublin,141,63,78,28804.9,9,14,109,8,1
Dublin,257,128,129,6110.03,39,40,88,42,48
Dublin,264,124,140,8729,48,34,145,24,13
Dublin,88,51,37,42968.75,5,17,60,5,1
Dublin,167,92,75,76958.53,7,19,132,8,1
Dublin,153,82,71,9928.62,9,24,112,8,0
Dublin,368,197,171,21431.48,13,34,308,9,4
Dublin,279,148,131,17329.19,30,32,208,9,0
Dublin,166,88,78,9787.74,31,15,54,40,26
Dublin,271,127,144,10467.77,54,47,85,56,29
Dublin,173,79,94,7499.89,22,27,49,49,26
Dublin,200,99,101,10876.66,30,29,64,41,36
Dublin,233,114,119,4774.3,35,26,145,20,7
Dublin,676,383,293,249.32,25,128,395,100,28
Dublin,201,106,95,5307.91,25,29,110,24,13
Dublin,234,117,117,2737.9,25,37,141,23,8
Dublin,358,196,162,11860.2,55,51,113,108,31
Dublin,277,127,150,14460.98,49,72,57,91,8
Dublin,159,81,78,15415.94,20,23,50,41,25
Dublin,217,114,103,9284.22,22,45,55,72,23
Dublin,312,148,164,9637.07,83,82,67,75,5
Dublin,166,83,83,71000.86,10,29,119,6,2
Dublin,188,93,95,29256.15,10,32,136,7,3
Dublin,184,92,92,11738.44,12,31,130,11,0
Dublin,335,169,166,34121,20,62,241,11,1
Dublin,208,110,98,29445.07,10,26,162,9,1
Dublin,733,268,465,3663.22,85,247,261,117,23
Dublin,196,103,93,31885.47,13,25,148,10,0
Dublin,126,70,56,42769.86,7,12,101,5,1
Dublin,183,85,98,5952.19,36,34,40,62,11
Dublin,147,78,69,11400.65,17,18,81,25,6
Dublin,194,94,100,1452.05,23,40,51,59,21
Dublin,167,85,82,6932.91,17,20,50,54,26
Dublin,179,99,80,18949.82,19,14,140,5,1
Dublin,345,170,175,17249.14,30,27,258,20,10
Dublin,280,138,142,13442.15,39,39,89,65,48
Dublin,173,78,95,18896.78,11,5,149,5,3
Dublin,335,157,178,12069.9,53,43,99,101,39
Dublin,275,124,151,11461.68,41,37,85,64,48
Dublin,285,128,157,2276.54,67,36,80,78,24
Dublin,208,87,121,15312.13,43,36,52,54,23
Dublin,182,78,104,12298.96,36,27,89,25,5
Dublin,155,78,77,4573.35,19,19,64,42,11
Dublin,252,123,129,6715.34,42,36,120,40,14
Dublin,181,88,93,14520.66,25,35,102,18,1
Dublin,196,102,94,15698.84,20,26,94,32,24
Dublin,278,140,138,176.61,60,47,109,46,16
Dublin,305,147,158,6954.58,33,33,74,100,65
Dublin,497,237,260,6390.39,89,51,159,134,64
Dublin,223,105,118,14685.54,44,27,77,57,18
Dublin,212,106,106,8023.92,25,34,86,47,20
Dublin,201,96,105,6378.32,23,14,93,46,25
Dublin,393,183,210,4478.63,66,48,148,80,51
Dublin,311,144,167,6963.41,72,36,114,65,24
Dublin,213,99,114,5631.49,33,25,70,60,25
Dublin,204,95,109,6073.96,19,20,113,36,16
Dublin,229,116,113,3642.9,29,27,98,48,27
Dublin,300,152,148,6365.64,53,30,121,68,28
Dublin,334,142,192,4829.59,40,24,103,77,90
Dublin,161,77,84,4830.48,25,18,51,36,31
Dublin,248,111,137,5622.44,32,31,64,78,43
Dublin,196,84,112,5468.6,28,16,49,55,48
Dublin,303,147,156,4438.19,59,42,71,82,49
Dublin,247,116,131,7128.84,62,26,70,61,28
Dublin,167,74,93,4004.32,17,7,63,31,49
Dublin,302,134,168,7478.39,50,44,94,81,33
Dublin,231,101,130,8316.23,36,34,107,40,14
Dublin,193,89,104,4573.57,29,35,66,45,18
Dublin,237,112,125,2197.5,26,39,63,75,34
Dublin,368,178,190,7299.56,81,40,95,109,43
Dublin,261,106,155,6501.59,37,32,122,47,23
Dublin,223,83,140,6989.94,21,14,63,48,77
Dublin,288,121,167,6428.86,30,38,154,49,17
Dublin,153,52,101,1432.64,8,12,18,39,76
Dublin,184,90,94,3750.97,25,26,55,41,37
Dublin,202,95,107,3303.14,43,27,57,54,21
Dublin,100,37,63,5230.13,5,3,53,23,16
Dublin,238,105,133,3353.77,46,21,86,46,39
Dublin,242,118,124,4254.27,33,18,67,69,55
Dublin,214,105,109,7361.79,31,27,81,55,20
Dublin,215,98,117,7178.87,18,30,98,47,22
Dublin,158,66,92,6020.65,27,24,30,48,29
Dublin,334,147,187,5206.87,54,45,98,96,41
Dublin,163,48,115,7384.25,17,5,21,17,103
Dublin,264,137,127,3088.01,36,51,76,60,41
Dublin,108,46,62,7312.12,9,16,52,13,18
Dublin,171,80,91,2631.78,21,41,53,26,30
Dublin,179,83,96,2693.59,5,28,80,33,33
Dublin,269,130,139,12006.78,54,48,71,73,23
Dublin,376,187,189,4090.2,38,81,79,123,55
Dublin,216,100,116,3739.94,22,31,108,36,19
Dublin,234,107,127,996.32,24,18,83,70,39
Dublin,325,166,159,2609,45,58,48,97,77
Dublin,198,97,101,1491.42,57,20,42,54,25
Dublin,256,131,125,3144.81,38,64,27,81,46
Dublin,181,89,92,4126.01,26,31,53,46,25
Dublin,138,59,79,12129.74,18,3,76,23,18
Dublin,175,71,104,3678.17,15,3,59,29,69
Dublin,166,73,93,5935.57,36,17,80,25,8
Dublin,718,339,379,1380.98,16,32,126,185,359
Dublin,195,92,103,1252.19,39,24,40,61,31
Dublin,194,96,98,2802.74,18,19,79,42,36
Dublin,258,132,126,1784.74,39,44,45,69,61
Dublin,333,178,155,1585.85,38,30,132,82,51
Dublin,469,232,237,3272.92,57,44,211,110,47
Dublin,196,96,100,5148.01,17,25,85,42,27
Dublin,159,71,88,7167.33,20,14,82,23,20
Dublin,244,110,134,7815.5,20,40,122,45,17
Dublin,138,68,70,4055.36,12,6,68,34,18
Dublin,119,53,66,1679.65,9,7,77,20,6
Dublin,169,82,87,3639.81,15,9,81,35,29
Dublin,150,65,85,17203.81,4,9,108,23,6
Dublin,151,71,80,6985.57,9,21,81,30,10
Dublin,273,133,140,2517.78,44,30,38,80,81
Dublin,227,111,116,5071.49,29,29,85,52,32
Dublin,183,77,106,5667.21,23,19,105,21,15
Dublin,145,70,75,10486.73,21,25,70,23,6
Dublin,192,90,102,21024.97,23,24,79,35,31
Dublin,162,76,86,15199.85,13,18,67,43,21
Dublin,165,75,90,18181.82,10,20,60,44,31
Dublin,250,110,140,6523.84,44,22,76,61,47
Dublin,254,119,135,4469.16,31,26,110,59,28
Dublin,238,118,120,16418.32,21,37,148,20,12
Dublin,241,131,110,12768.89,33,21,93,52,42
Dublin,214,102,112,20425.69,11,16,171,13,3
Dublin,356,209,147,61719.83,18,54,268,13,3
Dublin,150,82,68,22838,7,14,127,2,0
Dublin,146,70,76,40839.16,12,7,121,5,1
Dublin,110,61,49,24713.55,7,5,96,2,0
Dublin,201,92,109,5992.13,17,22,93,44,25
Dublin,238,115,123,9419.03,38,27,87,53,33
Dublin,137,65,72,1579.8,3,18,90,10,16
Dublin,272,133,139,10593.96,32,50,155,32,3
Dublin,205,100,105,7154.82,22,22,97,50,14
Dublin,209,100,109,7735.3,28,29,85,45,22
Dublin,141,65,76,5042.56,7,4,88,26,16
Dublin,106,53,53,6863.51,2,8,59,11,26
Dublin,276,136,140,8120.04,56,26,83,65,46
Dublin,145,70,75,6369.43,31,12,60,28,14
Dublin,265,140,125,2174.86,38,20,120,60,27
Dublin,221,107,114,4609.06,29,25,82,57,28
Dublin,223,104,119,11855.4,36,14,83,50,40
Dublin,241,90,151,2748.29,36,26,64,57,58
Dublin,206,92,114,8656.55,14,25,96,50,21
Dublin,189,85,104,2644.39,32,24,74,33,26
Dublin,367,188,179,2528.33,57,54,100,109,47
Dublin,155,79,76,3144.97,7,8,109,28,3
Dublin,492,251,241,4768.46,28,42,242,120,60
Dublin,156,81,75,3074.26,38,21,54,30,13
Dublin,162,65,97,7850.36,6,16,117,16,7
Dublin,267,139,128,4274.53,31,33,141,43,19
Dublin,144,72,72,11134.31,11,15,98,18,2
Dublin,181,95,86,4073.73,20,6,112,33,10
Dublin,170,76,94,17432.32,7,10,122,22,9
Dublin,195,89,106,8573.31,13,22,126,24,10
Dublin,216,98,118,5463.93,23,35,107,40,11
Dublin,197,108,89,4399.58,15,27,85,50,20
Dublin,201,106,95,6094.6,15,11,118,39,18
Dublin,258,118,140,6623.37,36,34,104,66,18
Dublin,89,45,44,7190.76,6,11,50,15,7
Dublin,204,103,101,8250.09,8,29,116,42,9
Dublin,221,98,123,4091.38,9,15,90,62,45
Dublin,185,86,99,7666.17,13,12,79,48,33
Dublin,143,69,74,6754.84,16,8,83,29,7
Dublin,230,115,115,7744.11,37,32,91,53,17
Dublin,135,65,70,3752.81,12,18,36,48,21
Dublin,129,67,62,5555.08,13,9,48,36,23
Dublin,193,94,99,4945.93,29,19,61,48,36
Dublin,142,63,79,7426,22,11,70,22,17
Dublin,145,70,75,7464.99,17,8,65,33,22
Dublin,151,73,78,7075.58,18,17,56,40,20
Dublin,155,75,80,3989.4,9,14,99,17,16
Dublin,157,91,66,6804.2,9,41,85,19,3
Dublin,165,82,83,16912.67,6,27,107,16,9
Dublin,634,390,244,17192.29,3,84,252,189,106
Dublin,90,40,50,6958.4,1,10,53,17,9
Dublin,120,50,70,2496,9,4,64,24,19
Dublin,574,232,342,82.48,25,29,118,77,325
Dublin,178,97,81,561.16,16,16,72,48,26
Dublin,175,83,92,15158.08,5,18,132,17,3
Dublin,160,86,74,4287.71,9,10,124,14,3
Dublin,149,80,69,5053.93,6,13,105,22,3
Dublin,130,73,57,34473.61,7,20,95,7,1
Dublin,172,80,92,9225.49,20,22,120,8,2
Dublin,286,128,158,7870.77,54,75,81,48,28
Dublin,367,179,188,12726.26,106,82,94,64,21
Dublin,301,147,154,16377.39,91,61,76,55,18
Dublin,297,136,161,8068.02,49,77,79,74,18
Dublin,239,109,130,7179.33,80,39,74,31,15
Dublin,343,151,192,9785.18,118,78,91,47,9
Dublin,330,148,182,12548.48,103,65,100,51,11
Dublin,382,181,201,10746.34,106,83,107,70,16
Dublin,267,123,144,4817.93,65,54,80,55,13
Dublin,267,120,147,572.95,80,48,83,39,17
Dublin,169,77,92,13367.08,52,16,80,18,3
Dublin,212,90,122,15350.08,65,16,115,16,0
Dublin,264,124,140,11907.98,41,37,171,13,2
Dublin,260,125,135,19953.95,36,36,148,28,12
Dublin,289,136,153,7088.2,44,38,69,85,53
Dublin,330,155,175,8643.27,80,52,92,46,60
Dublin,320,151,169,5245.82,52,53,86,69,60
Dublin,281,138,143,3806.61,57,30,84,42,68
Dublin,387,193,194,8414.32,97,51,118,93,28
Dublin,344,162,182,6690.39,81,57,83,75,48
Dublin,323,163,160,7451.67,74,48,86,66,49
Dublin,223,103,120,7322.04,67,30,73,32,21
Dublin,232,123,109,573.06,46,30,109,31,16
Dublin,361,176,185,9734.92,79,74,92,102,14
Dublin,179,90,89,118.22,48,27,80,23,1
Dublin,336,179,157,3491.96,59,41,112,90,34
Dublin,355,178,177,7566.23,77,61,109,96,12
Dublin,331,164,167,9786.53,69,44,89,110,19
Dublin,265,123,142,7952.47,73,47,86,47,12
Dublin,414,189,225,11893.48,110,75,121,82,26
Dublin,526,266,260,3878.74,151,106,136,112,21
Dublin,370,178,192,6662.23,99,61,96,95,19
Dublin,334,163,171,8548.98,72,56,110,63,33
Dublin,391,188,203,7809.38,104,69,117,73,28
Dublin,373,184,189,3356.7,91,80,102,77,23
Dublin,345,175,170,8342,79,52,95,103,16
Dublin,258,129,129,8313.73,55,42,106,43,12
Dublin,283,138,145,8802.76,52,41,97,69,24
Dublin,390,192,198,5763.09,105,52,124,94,15
Dublin,245,112,133,6812.75,46,41,56,62,40
Dublin,291,147,144,6305.53,45,44,71,81,50
Dublin,337,151,186,6377.62,47,64,69,86,71
Dublin,332,162,170,9013.66,79,51,96,58,48
Dublin,340,164,176,5356.02,59,46,103,76,56
Dublin,307,131,176,2203.73,55,35,72,68,77
Dublin,330,164,166,5835.54,64,42,55,86,83
Dublin,318,158,160,4569.03,51,41,63,90,73
Dublin,330,159,171,5659.89,55,50,50,101,74
Dublin,286,132,154,5352,51,37,53,85,60
Dublin,387,191,196,8986.42,92,62,118,51,64
Dublin,266,126,140,7479.05,50,36,90,49,41
Dublin,293,148,145,2270.9,48,36,96,59,54
Dublin,239,114,125,2354.73,38,29,55,63,54
Dublin,189,90,99,2968.9,24,24,26,59,56
Dublin,206,93,113,3499.53,14,21,37,59,75
Dublin,280,122,158,7680.49,44,65,79,62,30
Dublin,311,148,163,8535.28,58,52,85,59,57
Dublin,267,117,150,8086.74,47,49,74,38,59
Dublin,325,166,159,5859.87,78,35,82,62,68
Dublin,344,170,174,5960.01,62,42,97,63,80
Dublin,281,123,158,3853.01,48,40,36,82,75
Dublin,212,102,110,4659.14,26,23,43,56,64
Dublin,268,129,139,4115.73,41,30,49,65,83
Dublin,349,166,183,5566.28,63,46,60,94,86
Dublin,154,61,93,4550.96,21,8,63,39,23
Dublin,147,66,81,89.84,16,21,49,44,17
Dublin,186,86,100,34851.04,23,8,130,19,6
Dublin,197,103,94,5829.95,27,9,99,41,21
Dublin,268,135,133,6553.37,34,26,51,64,93
Dublin,239,119,120,2835.68,40,27,88,36,48
Dublin,297,140,157,4239.16,59,33,63,74,68
Dublin,252,120,132,4152.86,39,33,36,62,82
Dublin,250,123,127,4175.3,41,25,58,56,70
Dublin,175,89,86,2914.58,30,22,24,51,48
Dublin,226,109,117,4272.13,44,34,47,51,50
Dublin,300,138,162,2592.2,38,38,83,96,45
Dublin,181,97,84,1829.96,13,18,48,44,58
Dublin,385,167,218,2738.15,61,47,62,94,121
Dublin,285,138,147,3738.93,54,53,82,72,24
Dublin,337,151,186,3341,49,38,75,112,63
Dublin,118,46,72,5531.08,4,5,66,28,15
Dublin,172,77,95,4350.91,27,27,42,56,20
Dublin,173,77,96,6369.43,14,12,83,41,23
Dublin,112,42,70,5131.49,3,8,43,48,10
Dublin,180,85,95,1722.74,7,24,58,46,45
Dublin,320,157,163,2546.11,62,48,58,92,60
Dublin,192,90,102,3963.34,25,20,74,45,28
Dublin,223,115,108,4369.46,48,34,69,52,20
Dublin,226,112,114,4557.19,37,37,53,62,37
Dublin,204,102,102,5310.7,17,34,100,37,16
Dublin,255,133,122,3956.31,27,49,78,76,25
Dublin,166,73,93,8466.8,41,20,65,30,10
Dublin,717,317,400,7724.71,24,540,99,38,16
Dublin,229,98,131,5683.93,17,36,97,42,37
Dublin,170,88,82,3554.03,21,16,73,40,20
Dublin,205,91,114,9692.67,8,30,125,26,16
Dublin,147,62,85,16387.96,9,10,114,13,1
Dublin,148,57,91,27036.9,6,10,107,19,6
Dublin,191,71,120,10062.16,16,13,67,24,71
Dublin,140,61,79,6530.76,12,19,68,16,25
Dublin,106,41,65,11710.12,8,7,66,14,11
Dublin,152,71,81,5763.69,31,12,47,33,29
Dublin,78,31,47,11492.56,3,6,51,9,9
Dublin,309,149,160,7155.76,46,38,110,73,42
Dublin,168,75,93,7484.96,17,26,55,41,29
Dublin,123,63,60,8469.32,15,20,41,22,25
Dublin,165,81,84,11542.5,14,30,92,25,4
Dublin,217,105,112,6991.66,32,39,91,40,15
Dublin,241,117,124,8199.23,25,30,150,27,9
Dublin,157,84,73,4827.2,17,15,73,36,16
Dublin,145,80,65,8676.92,8,20,96,15,6
Dublin,160,90,70,7648.18,28,26,65,31,10
Dublin,203,99,104,8178.23,20,27,96,46,14
Dublin,245,108,137,3685.32,23,37,65,62,58
Dublin,121,63,58,11629.02,17,17,62,18,7
Dublin,169,76,93,5068.68,7,37,69,30,26
Dublin,205,96,109,4892.48,27,33,73,37,35
Dublin,233,97,136,5967.01,46,25,72,52,38
Dublin,294,129,165,7290.4,45,47,97,60,45
Dublin,256,134,122,9068.37,55,22,138,32,9
Dublin,198,89,109,7781.49,23,27,116,16,16
Dublin,272,155,117,1467.55,14,28,154,24,52
Dublin,156,77,79,16306.05,9,25,115,5,2
Dublin,116,54,62,14873.7,6,8,92,7,3
Dublin,174,75,99,11822.26,12,20,111,19,12
Dublin,120,61,59,5551.7,8,11,52,22,27
Dublin,262,95,167,4227.03,28,85,127,17,5
Dublin,306,130,176,9241.08,57,52,119,61,17
Dublin,188,97,91,4751.43,6,14,145,17,6
Dublin,278,133,145,11240.5,22,42,145,44,25
Dublin,289,128,161,3385.42,67,31,68,68,55
Dublin,180,84,96,6679.04,18,16,78,37,31
Dublin,361,165,196,3679.13,42,51,109,51,108
Dublin,185,86,99,4703.79,48,21,59,40,17
Dublin,246,104,142,3208.56,40,36,82,59,29
Dublin,145,68,77,9496.37,17,24,76,23,5
Dublin,252,120,132,3559.12,46,46,55,61,44
Dublin,156,60,96,4342.5,17,20,70,27,22
Dublin,238,83,155,2704.3,15,29,75,56,63
Dublin,168,73,95,2859.77,23,31,81,21,12
Dublin,132,63,69,5665.48,25,19,51,24,13
Dublin,299,150,149,7692.9,59,25,99,84,32
Dublin,284,149,135,8431.55,57,39,83,76,29
Dublin,179,83,96,7256.36,29,27,69,41,13
Dublin,248,125,123,8616.5,61,43,89,46,9
Dublin,261,131,130,8318.99,46,37,107,54,17
Dublin,230,87,143,4517.87,22,23,46,47,92
Dublin,204,99,105,7269.62,26,26,74,56,22
Dublin,166,85,81,8130.88,30,26,67,33,10
Dublin,255,106,149,5006.28,41,36,56,76,46
Dublin,363,179,184,2727.42,62,64,70,113,54
Dublin,223,110,113,3014.41,44,24,82,51,22
Dublin,196,96,100,3043.19,4,21,113,38,20
Dublin,226,114,112,3534.84,55,31,52,53,35
Dublin,213,90,123,2396.73,26,35,33,58,61
Dublin,344,153,191,6609.03,70,40,89,94,51
Dublin,311,156,155,8373.5,38,48,155,52,18
Dublin,230,109,121,8210.18,32,29,111,45,13
Dublin,275,125,150,6130.59,41,35,141,47,11
Dublin,225,102,123,10368.19,6,44,133,25,17
Dublin,190,97,93,10059.3,23,22,70,56,19
Dublin,378,180,198,12976.76,57,68,160,76,17
Dublin,266,126,140,6795.77,34,40,98,68,26
Dublin,284,133,151,8827.55,42,46,124,53,19
Dublin,220,107,113,3938.98,30,33,100,34,23
Dublin,188,86,102,7646.63,19,43,93,24,9
Dublin,284,147,137,8876.94,20,34,82,73,75
Dublin,217,91,126,4453.02,32,31,98,32,24
Dublin,161,73,88,10407.91,16,21,78,26,20
Dublin,192,86,106,14510.28,17,14,115,33,13
Dublin,134,74,60,8748.45,9,16,85,22,2
Dublin,169,89,80,13193.85,26,34,68,30,11
Dublin,257,102,155,4647.04,34,27,157,31,8
Dublin,162,92,70,11578.87,8,27,97,28,2
Dublin,375,203,172,18118.57,30,59,251,31,4
Dublin,276,149,127,1253.12,19,63,166,18,10
Dublin,153,73,80,14312.44,3,35,110,4,1
Dublin,164,86,78,18228.3,7,35,107,14,1
Dublin,182,95,87,20068.36,7,41,115,17,2
Dublin,176,95,81,36812.38,5,24,121,23,3
Dublin,170,98,72,22017.87,14,44,94,17,1
Dublin,136,67,69,24597.58,8,24,79,22,3
Dublin,112,56,56,22768.86,0,17,83,12,0
Dublin,177,96,81,7736.01,14,33,99,22,9
Dublin,206,96,110,16634.37,12,19,129,27,19
Dublin,154,72,82,10231.88,9,6,70,26,43
Dublin,181,90,91,14621.54,4,65,84,22,6
Dublin,225,101,124,13657.06,23,65,113,18,6
Dublin,168,76,92,7823.41,5,28,109,24,2
Dublin,128,75,53,11594.2,19,6,81,21,1
Dublin,220,107,113,36065.57,7,24,157,29,3
Dublin,192,96,96,4036.75,28,16,99,29,20
Dublin,240,119,121,21337.13,13,47,162,17,1
Dublin,180,100,80,6805.55,13,17,99,38,13
Dublin,217,98,119,5141.08,33,21,120,34,9
Dublin,208,118,90,11160.59,18,38,99,37,16
Dublin,128,66,62,12397.09,2,15,89,12,10
Dublin,179,79,100,29873.16,7,30,125,13,4
Dublin,177,92,85,24413.79,12,40,108,17,0
Dublin,189,104,85,11537.05,13,41,97,27,11
Dublin,160,77,83,12356.17,8,23,108,19,2
Dublin,248,126,122,4944.38,27,33,138,31,19
Dublin,114,58,56,8128.92,16,14,50,30,4
Dublin,211,93,118,12341.35,17,28,108,39,19
Dublin,177,92,85,11871.23,25,34,83,28,7
Dublin,280,134,146,17959.08,27,57,109,47,40
Dublin,126,59,67,19486.55,9,19,74,23,1
Dublin,134,59,75,8666.41,11,14,74,20,15
Dublin,206,111,95,8177.2,9,24,102,55,16
Dublin,205,100,105,7054.61,37,23,77,51,17
Dublin,223,92,131,8285.96,25,23,122,42,11
Dublin,334,157,177,2935.36,60,81,100,70,23
Dublin,222,104,118,4124.4,43,47,40,54,38
Dublin,107,57,50,13445.59,2,22,67,14,2
Dublin,149,69,80,11064.9,18,20,69,30,12
Dublin,116,58,58,16964.02,12,9,75,12,8
Dublin,174,83,91,5453.35,39,26,57,44,8
Dublin,219,109,110,8375.08,57,31,68,54,9
Dublin,199,87,112,9252.37,21,31,81,40,26
Dublin,163,83,80,8257.35,26,33,52,42,10
Dublin,266,115,151,6070.01,63,34,104,44,21
Dublin,217,93,124,8747.18,42,36,76,42,21
Dublin,157,74,83,5263.69,19,24,79,29,6
Dublin,133,72,61,10211.13,18,15,52,36,12
Dublin,203,97,106,7376.72,21,15,116,42,9
Dublin,238,104,134,5994.66,41,30,80,59,28
Dublin,227,120,107,6211.01,50,37,42,78,20
Dublin,149,70,79,6728.38,16,12,75,30,16
Dublin,205,96,109,8179.06,42,24,68,55,16
Dublin,120,63,57,6921.61,15,12,62,26,5
Dublin,285,148,137,9561.51,48,35,107,66,29
Dublin,163,89,74,8063.32,16,14,61,38,34
Dublin,191,93,98,11611.65,27,28,96,32,8
Dublin,101,44,57,7925.92,8,5,58,21,9
Dublin,191,89,102,9681.67,32,28,82,36,13
Dublin,129,61,68,12399.08,22,25,42,26,14
Dublin,154,72,82,6495.97,19,14,84,25,12
Dublin,90,48,42,15937.67,8,14,58,7,3
Dublin,226,119,107,10964.49,30,18,102,52,24
Dublin,283,143,140,7510.42,41,43,104,85,10
Dublin,174,84,90,9396.77,23,18,72,46,15
Dublin,167,79,88,6068.75,30,18,76,31,12
Dublin,126,62,64,7308.58,6,21,64,22,13
Dublin,276,123,153,6465.21,42,41,99,63,31
Dublin,167,86,81,5814.97,26,18,76,29,18
Dublin,257,127,130,9196.97,36,28,126,56,11
Dublin,152,81,71,8177.76,9,28,54,47,14
Dublin,159,64,95,6518.53,18,21,55,42,23
Dublin,260,116,144,8571.81,28,29,118,55,30
Dublin,176,88,88,4664.23,19,31,66,45,15
Dublin,243,125,118,6249.2,31,25,119,54,14
Dublin,203,104,99,10585.6,12,29,116,39,7
Dublin,183,85,98,9785.05,28,28,85,38,4
Dublin,173,51,122,8428.75,8,24,59,18,64
Dublin,117,57,60,5274.78,14,24,51,22,6
Dublin,268,141,127,8865.37,37,35,123,61,12
Dublin,198,106,92,7118.46,19,25,93,45,16
Dublin,161,71,90,6231.37,13,24,74,39,11
Dublin,162,80,82,9322.67,24,19,82,32,5
Dublin,164,79,85,14642.86,6,26,112,15,5
Dublin,225,120,105,3440.89,25,36,112,42,10
Dublin,240,116,124,4618.94,32,29,100,58,21
Dublin,167,78,89,4382.4,18,36,52,50,11
Dublin,196,89,107,7242.9,12,33,113,27,11
Dublin,221,93,128,3995.44,25,29,84,37,46
Dublin,151,76,75,8698.16,13,23,79,26,10
Dublin,161,81,80,7302.25,23,15,80,34,9
Dublin,125,60,65,7099.85,4,8,81,19,13
Dublin,122,71,51,16323.25,6,21,78,13,4
Dublin,191,95,96,8240.57,27,50,73,21,20
Dublin,221,112,109,20353.66,28,43,142,8,0
Dublin,173,77,96,16458.95,19,25,90,18,21
Dublin,229,120,109,81119.38,26,37,141,24,1
Dublin,158,62,96,30763.24,39,36,41,36,6
Dublin,313,172,141,36741.4,30,73,183,27,0
Dublin,245,132,113,48495.65,24,50,152,19,0
Dublin,268,110,158,17164.08,44,46,111,56,11
Dublin,264,137,127,8950.37,108,28,53,39,36
Dublin,319,177,142,27960.38,50,43,176,40,10
Dublin,136,82,54,18740.53,13,21,88,12,2
Dublin,469,248,221,14937.26,63,70,167,144,25
Dublin,205,102,103,12014.3,23,25,147,9,1
Dublin,330,159,171,28846.15,8,60,159,80,23
Dublin,236,110,126,35997.56,13,58,138,18,9
Dublin,333,172,161,12288.73,8,48,151,96,30
Dublin,269,123,146,10251.92,13,55,114,78,9
Dublin,208,94,114,27641.2,39,18,107,28,16
Dublin,159,87,72,17434.21,17,38,83,20,1
Dublin,163,93,70,27135.01,35,28,52,43,5
Dublin,115,67,48,13651.47,8,14,84,8,1
Dublin,278,142,136,19185.65,30,56,125,51,16
Dublin,166,85,81,12302.68,6,27,116,16,1
Dublin,160,85,75,20235.23,10,26,115,8,1
Dublin,153,85,68,30147.78,5,40,97,10,1
Dublin,473,174,299,8464.87,79,59,229,86,20
Dublin,133,62,71,28614.46,19,17,42,35,20
Dublin,189,103,86,8071.4,7,45,110,24,3
Dublin,375,210,165,55489.79,29,65,272,8,1
Dublin,144,72,72,46451.61,1,60,69,12,2
Dublin,244,139,105,12672.03,2,74,85,58,25
Dublin,171,82,89,11593.22,35,34,50,38,14
Dublin,139,72,67,9405.87,2,54,61,8,14
Dublin,157,87,70,4581.53,2,46,93,12,4
Dublin,350,166,184,7893.19,17,141,120,47,25
Dublin,272,134,138,2662.33,3,28,166,68,7
Dublin,255,123,132,24740.47,26,49,65,91,24
Dublin,219,95,124,19667.71,7,121,77,7,7
Dublin,146,85,61,20348.43,2,23,91,22,8
Dublin,365,191,174,50624.13,6,84,201,54,20
Dublin,274,120,154,22994.29,1,135,113,25,0
Dublin,156,78,78,7918.78,2,35,109,8,2
Dublin,209,121,88,6633.45,7,35,97,61,9
Dublin,841,415,426,9787.15,31,216,390,149,55
Dublin,203,100,103,12935.7,3,36,97,31,36
Dublin,336,178,158,36101.86,6,58,171,72,29
Dublin,241,147,94,10052.98,11,47,83,82,18
Dublin,375,197,178,6918.56,58,58,107,113,39
Dublin,472,233,239,4812.4,5,74,209,129,55
Dublin,166,81,85,20231.57,39,32,48,33,14
Dublin,218,111,107,21896.34,32,61,82,31,12
Dublin,173,78,95,15101.26,16,20,96,21,20
Dublin,96,39,57,4645.54,15,13,18,26,24
Dublin,141,61,80,23641.85,38,30,35,31,7
Dublin,220,117,103,6835.91,20,33,105,49,13
Dublin,157,93,64,7627.28,15,32,85,21,4
Dublin,251,116,135,6899.02,21,42,150,31,7
Dublin,302,125,177,10779.55,2,127,138,28,7
Dublin,450,231,219,10561.15,14,84,187,109,56
Dublin,493,224,269,3406.11,28,83,187,122,73
Dublin,189,99,90,13561.02,7,26,123,19,14
Dublin,290,168,122,4114.82,27,57,167,29,10
Dublin,111,71,40,23591.92,6,22,68,12,3
Dublin,156,89,67,20583.19,9,25,89,28,5
Dublin,203,102,101,16627.08,14,28,123,27,11
Dublin,152,78,74,10588.65,12,42,63,25,10
Dublin,117,63,54,14566.73,12,15,72,14,4
Dublin,301,158,143,8863.11,15,92,165,19,10
Dublin,97,59,38,28312.9,6,18,63,10,0
Dublin,137,67,70,16021.52,6,24,94,13,0
Dublin,188,88,100,6859.06,17,36,87,28,20
Dublin,216,97,119,4297.65,15,29,113,41,18
Dublin,147,87,60,21668.63,4,40,90,9,4
Dublin,323,164,159,22990.96,6,61,173,58,25
Dublin,125,57,68,1276.96,7,20,68,21,9
Dublin,181,91,90,5006.78,9,25,93,36,18
Dublin,173,92,81,2120.8,12,70,65,20,6
Dublin,164,95,69,4910.33,5,12,46,49,52
Dublin,169,96,73,3870.55,9,25,99,20,16
Dublin,400,163,237,12324,106,58,173,42,21
Dublin,255,124,131,10787.26,29,46,101,48,31
Dublin,295,134,161,9485.53,40,50,93,73,39
Dublin,219,100,119,4971.28,14,35,129,27,14
Dublin,219,125,94,22177.22,2,54,149,13,1
Dublin,244,122,122,12647.07,28,55,90,50,21
Dublin,496,263,233,7481.03,20,48,215,170,43
Dublin,364,175,189,17168.19,19,43,286,11,5
Dublin,151,75,76,5756.11,10,11,124,5,1
Dublin,186,93,93,14147.71,10,26,100,34,16
Dublin,142,73,69,1501.14,13,24,52,40,13
Dublin,279,137,142,32528.86,9,79,148,19,24
Dublin,194,109,85,4569.44,13,18,150,10,3
Dublin,356,186,170,42436.52,49,47,212,41,7
Dublin,228,139,89,8788.84,5,25,191,6,1
Dublin,104,57,47,32019.7,2,14,77,7,4
Dublin,276,138,138,24265.87,24,31,210,9,2
Dublin,247,113,134,42287.28,25,30,178,14,0
Dublin,333,163,170,1555.6,18,53,239,20,3
Dublin,383,216,167,24764,43,51,239,42,8
Dublin,94,48,46,23476.52,6,12,64,11,1
Dublin,177,88,89,73291.93,6,19,130,17,5
Dublin,187,106,81,7457.63,27,26,105,24,5
Dublin,206,99,107,48757.4,7,24,170,5,0
Dublin,164,80,84,60249.82,10,30,108,16,0
Dublin,118,60,58,29820.57,5,15,91,7,0
Dublin,232,115,117,4367.55,23,27,107,67,8
Dublin,206,94,112,7532.82,35,25,79,47,20
Dublin,189,78,111,6452.27,21,18,56,61,33
Dublin,270,105,165,8695.93,31,14,117,59,49
Dublin,266,127,139,4689.37,37,30,124,51,24
Dublin,287,126,161,7024.33,39,27,130,54,37
Dublin,201,85,116,5239.83,14,24,77,44,42
Dublin,293,137,156,5658.34,49,34,70,85,55
Dublin,237,119,118,7661.97,31,36,115,40,15
Dublin,277,147,130,8333.58,55,41,76,81,24
Dublin,338,187,151,10527.96,53,45,109,99,32
Dublin,216,110,106,6127.31,41,26,69,48,32
Dublin,247,134,113,7090.98,39,39,85,57,27
Dublin,169,83,86,9989.95,40,15,72,28,14
Dublin,121,57,64,4650.98,14,15,48,30,14
Dublin,162,80,82,6915.69,24,15,48,51,24
Dublin,197,91,106,7185.32,22,13,78,46,38
Dublin,271,118,153,7518.59,41,16,87,71,56
Dublin,276,129,147,5945.84,47,25,79,80,45
Dublin,128,54,74,5615.27,13,12,49,29,25
Dublin,247,132,115,5332.24,44,31,82,66,24
Dublin,301,154,147,7321.82,53,57,64,101,26
Dublin,221,107,114,5192.67,45,30,69,62,15
Dublin,192,92,100,5860.81,23,39,57,55,18
Dublin,122,68,54,12975.96,6,22,55,33,6
Dublin,161,76,85,8337.65,35,25,49,44,8
Dublin,240,106,134,5317.38,33,16,93,60,38
Dublin,251,97,154,7218.24,15,16,150,37,33
Dublin,276,140,136,5089.53,46,27,76,84,43
Dublin,366,180,186,6532.8,68,56,87,93,62
Dublin,356,156,200,4603.88,65,51,61,117,62
Dublin,290,149,141,4662.9,77,36,64,76,37
Dublin,342,161,181,4995.84,58,40,67,80,97
Dublin,303,154,149,5724.11,60,47,81,86,29
Dublin,203,98,105,3782.02,27,17,84,43,32
Dublin,230,111,119,1718.66,49,31,39,74,37
Dublin,156,76,80,602.27,25,20,32,51,28
Dublin,282,136,146,893.28,60,33,46,84,59
Dublin,260,123,137,2994.05,50,41,44,83,42
Dublin,237,115,122,3840.86,23,29,79,56,50
Dublin,212,121,91,7419.07,10,22,116,43,21
Dublin,208,116,92,12156.63,14,23,116,12,43
Dublin,214,105,109,9845.87,20,22,132,28,12
Dublin,242,123,119,533.81,27,63,125,23,4
Dublin,289,159,130,22956.55,18,30,221,20,0
Dublin,334,181,153,10408.23,10,76,238,7,3
Dublin,241,114,127,15925.46,43,48,129,18,3
Dublin,339,153,186,37355.37,39,58,184,54,4
Dublin,202,94,108,29943.67,18,20,157,6,1
Dublin,356,156,200,3381.49,26,43,169,87,31
Dublin,237,122,115,27449.62,52,20,149,14,2
Dublin,215,132,83,21022.78,19,35,109,48,4
Dublin,150,70,80,828.1,32,10,100,7,1
Dublin,106,55,51,8373.49,3,18,68,15,2
Dublin,197,117,80,18502.86,12,33,116,34,2
Dublin,115,67,48,34134.76,2,18,77,16,2
Dublin,178,100,78,51925.32,14,25,128,10,1
Dublin,200,106,94,32846.12,17,14,151,17,1
Dublin,194,87,107,16115.63,57,33,52,42,10
Dublin,152,71,81,3550.41,25,20,38,54,15
Dublin,279,153,126,16550.99,36,35,152,38,18
Dublin,274,133,141,9183.54,45,34,90,68,37
Dublin,283,134,149,9419.83,33,35,93,80,42
Dublin,193,93,100,9424.75,41,31,81,31,9
Dublin,220,115,105,7036.62,30,36,135,16,3
Dublin,317,147,170,8815.84,115,49,105,40,8
Dublin,182,82,100,19849.49,35,16,71,46,14
Dublin,124,59,65,13589.04,19,11,45,30,19
Dublin,151,71,80,18269.81,22,9,116,3,1
Dublin,219,110,109,32907.59,19,32,155,11,2
Dublin,297,126,171,14614.7,36,50,138,50,23
Dublin,290,145,145,12586.81,44,33,165,29,19
Dublin,312,152,160,19793.19,55,68,116,63,10
Dublin,215,102,113,4169.17,48,44,53,58,12
Dublin,128,76,52,2526,8,20,81,16,3
Dublin,149,55,94,17997.34,52,32,39,20,6
Dublin,97,43,54,3307.08,5,14,55,16,7
Dublin,174,80,94,9078.1,14,17,69,45,29
Dublin,158,75,83,11362,12,25,73,39,9
Dublin,221,118,103,12776.04,31,23,119,36,12
Dublin,287,149,138,69073.41,83,33,145,24,2
Dublin,223,120,103,14932.37,25,41,114,25,18
Dublin,115,54,61,7904.87,13,8,50,34,10
Dublin,92,56,36,14041.51,10,7,49,20,6
Dublin,233,119,114,16968.9,39,46,93,40,15
Dublin,123,59,64,23473.28,6,9,53,35,20
Dublin,104,56,48,11160,16,14,53,20,1
Dublin,210,98,112,11593.88,47,30,75,44,14
Dublin,135,61,74,13816.4,5,59,63,8,0
Dublin,130,62,68,12072.81,22,17,72,19,0
Dublin,235,111,124,7541.24,31,26,96,52,30
Dublin,186,86,100,8844.93,22,24,68,43,29
Dublin,195,98,97,5251.68,14,25,68,58,30
Dublin,261,112,149,15532.94,90,33,70,52,16
Dublin,178,94,84,7535.67,55,18,54,41,10
Dublin,190,98,92,14367.82,67,21,54,38,10
Dublin,178,80,98,11133.35,51,26,49,44,8
Dublin,186,93,93,6856.38,11,33,74,52,16
Dublin,91,52,39,3297.1,13,10,26,18,24
Dublin,147,73,74,17156.86,15,12,98,20,2
Dublin,216,112,104,11202.74,34,19,130,29,4
Dublin,144,58,86,15984.02,17,8,104,14,1
Dublin,309,147,162,8258.5,42,38,135,61,33
Dublin,169,80,89,29442.51,35,19,106,9,0
Dublin,233,118,115,9056.99,33,29,114,42,15
Dublin,142,70,72,6235.18,15,13,59,24,31
Dublin,282,131,151,5889.97,43,48,82,85,24
Dublin,"1,033",482,551,4645.95,13,51,167,238,564
Dublin,261,115,146,8304.17,39,16,121,64,21
Dublin,202,92,110,14352.71,24,31,77,50,20
Dublin,243,115,128,28066.53,53,32,70,52,36
Dublin,202,92,110,5948.7,29,25,51,61,36
Dublin,137,60,77,6912.21,20,20,50,25,22
Dublin,215,99,116,4967.08,38,24,62,52,39
Dublin,222,107,115,6350.66,39,27,65,61,30
Dublin,318,155,163,3276.02,57,61,78,85,37
Dublin,278,137,141,1660.51,40,33,80,90,35
Dublin,230,114,116,1849.65,49,26,49,54,52
Dublin,331,173,158,747.22,41,41,75,96,78
Dublin,304,136,168,39424.2,74,28,180,20,2
Dublin,382,193,189,32899.84,73,29,252,27,1
Dublin,231,113,118,4860.19,25,29,68,65,44
Dublin,268,132,136,5888.43,49,26,72,84,37
Dublin,247,130,117,4888.96,23,29,68,75,52
Dublin,311,160,151,3793.65,59,30,77,78,67
Dublin,315,163,152,6422.02,56,37,87,79,56
Dublin,240,114,126,6787.52,52,21,66,43,58
Dublin,218,101,117,5718.18,34,33,67,47,37
Dublin,224,106,118,4033.57,30,25,56,58,55
Dublin,193,102,91,4807.33,24,31,55,57,26
Dublin,160,78,82,4995.16,23,19,49,35,34
Dublin,207,111,96,5919.7,24,24,55,47,57
Dublin,235,117,118,6384.66,40,23,58,49,65
Dublin,164,67,97,5774.04,26,13,41,46,38
Dublin,143,67,76,2033.04,15,14,32,47,35
Dublin,268,129,139,7541.86,60,32,90,49,37
Dublin,149,70,79,3674.93,20,16,34,51,28
Dublin,207,87,120,5598.68,24,25,46,61,51
Dublin,163,72,91,3922.23,13,17,34,28,71
Dublin,223,102,121,6247.72,33,29,40,43,78
Dublin,404,207,197,1306.46,44,35,76,87,162
Dublin,355,183,172,1492.19,87,32,78,105,53
Dublin,295,146,149,1938.12,39,44,58,84,70
Dublin,165,77,88,1551.09,27,28,49,35,26
Dublin,229,119,110,7452.97,53,37,53,66,20
Dublin,261,120,141,8896.92,49,33,78,58,43
Dublin,283,137,146,5594.32,22,53,75,67,66
Dublin,245,121,124,5361.87,19,41,66,61,58
Dublin,82,44,38,3117.75,0,0,0,18,64
Dublin,187,83,104,4825.56,28,26,42,53,38
Dublin,201,97,104,3890.15,22,29,37,42,71
Dublin,210,98,112,5208.72,19,18,45,54,74
Dublin,282,135,147,6235.49,35,46,75,54,72
Dublin,243,106,137,5377.06,43,37,59,42,62
Dublin,264,129,135,5520.7,30,46,78,63,47
Dublin,186,86,100,5789.52,26,27,52,33,48
Dublin,226,108,118,5555.15,50,26,56,52,42
Dublin,286,144,142,7747.95,29,43,67,82,65
Dublin,205,97,108,6847.71,23,20,49,71,42
Dublin,215,94,121,8147.64,20,44,52,56,43
Dublin,182,84,98,3174.05,33,29,44,51,25
Dublin,238,110,128,8399.21,30,49,62,53,44
Dublin,202,93,109,7814.31,15,24,64,58,41
Dublin,191,78,113,3867.49,27,30,57,43,34
Dublin,220,109,111,4650.38,38,27,71,57,27
Dublin,351,191,160,2520.81,39,156,104,28,24
Dublin,190,87,103,17034.25,0,174,15,1,0
Dublin,189,90,99,5349.11,30,22,54,36,47
Dublin,233,114,119,4192,32,35,64,65,37
Dublin,202,101,101,3953.19,34,26,62,43,37
Dublin,270,125,145,4405.72,32,43,54,68,73
Dublin,312,142,170,3859.81,63,49,95,94,11
Dublin,290,142,148,6047.97,46,29,78,77,60
Dublin,326,164,162,5009.76,48,57,119,56,46
Dublin,205,96,109,5465.35,40,18,49,43,55
Dublin,168,71,97,554.7,24,21,47,45,31
Dublin,346,135,211,2587.5,32,91,118,42,63
Dublin,597,249,348,4481.14,22,56,139,166,214
Dublin,205,97,108,10367.67,11,16,168,10,0
Dublin,294,122,172,20106.69,17,43,198,31,5
Dublin,194,94,100,3599.73,39,31,36,51,37
Dublin,219,100,119,4915.49,15,45,63,54,42
Dublin,230,111,119,9352.64,32,35,62,54,47
Dublin,174,87,87,8238.64,17,19,43,46,49
Dublin,226,106,120,5012.2,27,14,52,42,91
Dublin,200,93,107,1166.68,30,24,55,57,34
Dublin,200,91,109,6372.27,27,29,77,33,34
Dublin,344,253,91,30188.68,13,13,77,155,86
Dublin,108,54,54,15345.27,16,14,32,37,9
Dublin,104,63,41,14268.08,9,10,32,40,13
Dublin,220,105,115,3804.71,13,42,95,43,27
Dublin,319,157,162,14089.48,35,58,109,78,39
Dublin,412,198,214,10858.39,9,52,194,123,34
Dublin,166,81,85,31403.71,2,41,103,19,1
Dublin,121,65,56,32283.88,12,7,31,45,26
Dublin,150,77,73,28211.4,22,25,46,42,15
Dublin,233,103,130,48360.32,38,22,68,79,26
Dublin,223,110,113,37656.2,35,22,40,83,43
Dublin,269,129,140,55774.41,52,44,57,87,29
Dublin,210,102,108,11688.75,25,18,106,38,23
Dublin,196,109,87,13122.66,17,40,79,45,15
Dublin,210,110,100,11628.55,23,25,87,51,24
Dublin,141,66,75,12341.36,28,21,58,30,4
Dublin,240,142,98,11377.1,32,27,122,44,15
Dublin,204,101,103,12228.02,6,20,115,38,25
Dublin,304,143,161,8439.52,17,27,99,62,99
Dublin,145,83,62,8564.17,18,23,73,21,10
Dublin,185,106,79,11186.36,17,40,97,24,7
Dublin,200,104,96,10504.75,21,29,95,45,10
Dublin,129,69,60,7757.53,7,17,60,40,5
Dublin,199,95,104,11292.7,30,22,91,34,22
Dublin,200,127,73,23584.91,16,47,110,24,3
Dublin,127,73,54,14287.32,8,15,60,28,16
Dublin,149,85,64,12887.04,11,18,84,28,8
Dublin,250,118,132,10738.83,27,59,93,53,18
Dublin,169,78,91,18443.74,13,26,113,13,4
Dublin,224,134,90,13959.87,18,41,123,32,10
Carlow,240,121,119,31.29,47,20,73,57,43
Carlow,432,211,221,21.65,100,43,124,95,70
Carlow,346,169,177,697.77,92,42,110,75,27
Carlow,253,140,113,2673.8,36,57,104,49,7
Cavan,152,86,66,3.15,31,16,32,37,36
Cavan,248,135,113,18.41,68,22,80,61,17
Cavan,154,76,78,4.57,35,18,34,38,29
Cavan,203,101,102,6.72,35,23,45,64,36
Clare,183,86,97,17.88,38,13,46,52,34
Clare,203,98,105,5.32,44,31,55,58,15
Clare,204,106,98,32.81,27,28,59,60,30
Clare,248,119,129,29.21,67,27,55,60,39
Clare,182,92,90,4.63,29,18,41,61,33
Clare,185,89,96,818.88,45,19,101,19,1
Clare,167,79,88,599.99,35,20,75,17,20
Clare,128,71,57,3179.89,10,25,50,20,23
Clare,141,80,61,787.89,13,24,53,31,20
Clare,206,103,103,68.13,34,16,67,43,46
Clare,162,91,71,5.65,28,19,43,50,22
Clare,314,154,160,11.25,72,28,79,96,39
Clare,141,73,68,9.61,38,9,33,32,29
Clare,117,63,54,12.52,24,9,17,47,20
Clare,100,47,53,110.75,16,18,19,30,17
Clare,117,58,59,222.59,21,9,29,25,33
Clare,124,61,63,416.65,21,7,33,35,28
Clare,101,53,48,111.36,8,7,28,31,27
Clare,121,59,62,348.7,14,12,51,25,19
Clare,145,79,66,12.94,29,15,31,42,28
Clare,171,79,92,67.53,24,19,45,62,21
Clare,99,53,46,35.65,16,14,16,35,18
Clare,117,67,50,160.21,8,6,36,48,19
Clare,154,70,84,123.22,18,18,27,51,40
Clare,94,50,44,9.57,22,7,21,22,22
Clare,132,65,67,153.92,26,15,42,29,20
Clare,271,134,137,43.14,59,26,85,73,28
Clare,195,99,96,15.64,41,23,37,68,26
Cork,154,86,68,3.94,26,18,41,48,21
Cork,93,47,46,15.71,15,6,18,39,15
Cork,162,85,77,18.04,33,14,32,52,31
Cork,209,104,105,22.74,40,25,35,89,20
Cork,"1,092",547,545,29.71,231,130,254,299,178
Cork,132,78,54,10.97,27,11,39,28,27
Cork,217,111,106,157.36,41,19,90,49,18
Cork,265,134,131,20.57,54,25,74,68,44
Cork,183,87,96,18.03,37,22,48,46,30
Cork,381,185,196,204.98,89,40,170,55,27
Cork,118,54,64,26.56,29,7,20,37,25
Cork,169,82,87,77.09,35,20,38,48,28
Cork,94,49,45,16.45,20,5,20,15,34
Cork,246,123,123,21.78,53,18,53,69,53
Cork,220,102,118,47.05,24,27,63,71,35
Cork,348,158,190,51.06,59,33,91,78,87
Cork,435,276,159,84.05,60,74,171,97,33
Cork,177,106,71,6383.21,14,21,76,42,24
Cork,123,69,54,10.62,20,10,27,48,18
Cork,88,49,39,6.71,17,11,16,25,19
Cork,142,75,67,12.48,29,11,37,32,33
Cork,145,79,66,8.54,27,11,32,39,36
Cork,318,175,143,30,63,35,73,98,49
Cork,238,109,129,9.89,54,21,56,71,36
Cork,175,89,86,25.25,43,18,30,47,37
Cork,287,138,149,887.02,37,30,107,66,47
Cork,180,87,93,11.72,30,11,38,48,53
Cork,231,116,115,12.82,64,20,50,53,44
Cork,83,45,38,6.09,15,10,15,27,16
Cork,149,75,74,12.29,17,15,22,53,42
Cork,148,74,74,118.46,13,10,54,50,21
Cork,106,57,49,10.49,15,12,20,43,16
Cork,227,114,113,20.14,48,15,46,72,46
Cork,281,142,139,76.97,57,23,67,78,56
Cork,96,47,49,24.59,20,7,23,20,26
Cork,242,113,129,423.69,51,16,65,57,53
Cork,242,121,121,39.44,51,33,50,79,29
Cork,183,99,84,9.32,40,16,45,46,36
Cork,180,88,92,48.45,36,25,41,52,26
Cork,306,156,150,29.5,71,33,80,90,32
Cork,127,70,57,17.96,26,18,25,41,17
Cork,261,119,142,989.75,41,32,69,61,58
Cork,88,43,45,24.81,15,6,19,23,25
Cork,256,132,124,28.29,62,31,74,63,26
Cork,135,65,70,22.13,21,8,40,43,23
Cork,349,171,178,102.89,72,46,80,101,50
Cork,170,87,83,16.74,34,11,36,54,35
Cork,156,85,71,20.77,27,16,36,39,38
Cork,187,84,103,72.91,21,25,35,52,54
Cork,286,141,145,39.58,76,22,89,58,41
Cork,109,54,55,10.33,14,9,17,41,28
Cork,74,41,33,14.5,8,7,13,25,21
Cork,185,91,94,37.74,52,20,41,59,13
Cork,159,83,76,73.93,23,24,39,44,29
Cork,150,74,76,3305.57,12,22,29,49,38
Cork,220,112,108,2792.45,28,23,68,57,44
Cork,118,63,55,1477.2,14,17,62,25,0
Cork,154,109,45,14177.87,1,5,14,102,32
Cork,283,130,153,18220.45,51,29,188,14,1
Cork,294,131,163,3566.06,33,36,53,91,81
Cork,186,112,74,3269.01,24,28,86,41,7
Donegal,162,79,83,36.55,28,24,30,50,30
Donegal,149,76,73,37.07,25,8,37,36,43
Donegal,128,60,68,21.22,32,12,32,37,15
Donegal,159,78,81,28.1,32,20,39,38,30
Donegal,171,85,86,95.09,21,10,30,40,70
Donegal,152,76,76,18.97,32,20,42,41,17
Donegal,260,130,130,19.05,73,28,71,57,31
Donegal,174,85,89,29.34,54,12,43,41,24
Donegal,164,94,70,189.83,17,24,46,51,26
Donegal,139,60,79,239.83,10,15,36,36,42
Donegal,137,70,67,613.93,21,15,64,24,13
Donegal,86,37,49,251.8,6,14,21,18,27
Donegal,234,116,118,31.43,55,31,53,57,38
Donegal,227,123,104,15.44,39,24,64,64,36
Donegal,222,108,114,106.24,46,22,55,64,35
Donegal,113,56,57,8.09,16,10,26,29,32
Donegal,161,89,72,13.35,33,23,27,50,28
Donegal,234,117,117,15.91,62,24,64,48,36
Donegal,122,57,65,61.77,24,18,23,45,12
Donegal,165,78,87,33.36,25,24,36,54,26
Donegal,162,76,86,151.93,29,24,39,42,28
Donegal,183,94,89,63.16,37,20,44,47,35
Donegal,193,97,96,34.31,51,17,60,43,22
Donegal,142,76,66,17.06,29,15,35,43,20
Donegal,152,85,67,20.44,31,24,33,42,22
Donegal,103,54,49,34.7,19,9,19,34,22
Donegal,115,59,56,9.15,24,5,29,36,21
Donegal,227,123,104,48.01,43,33,58,66,27
Donegal,333,161,172,60.52,97,37,99,69,31
Donegal,154,68,86,9.35,32,23,28,46,25
Donegal,235,125,110,40.74,47,21,57,58,52
Donegal,210,99,111,11.15,42,23,54,62,29
Donegal,183,89,94,31.53,43,11,45,42,42
Donegal,94,47,47,2.09,14,6,22,36,16
Donegal,147,78,69,4.44,22,18,31,48,28
Donegal,232,125,107,11.34,41,25,52,79,35
Donegal,155,79,76,32.98,40,13,51,28,23
Donegal,252,116,136,48.78,33,29,51,55,84
Donegal,224,120,104,36.7,35,43,43,79,24
Donegal,94,54,40,1576.12,11,26,37,14,6
Donegal,129,65,64,3013.67,22,15,48,22,22
Donegal,174,93,81,37.97,38,15,52,42,27
Donegal,134,69,65,7.72,32,12,32,34,24
Donegal,307,153,154,55.46,115,28,91,48,25
Donegal,96,40,56,28.39,30,4,33,25,4
Donegal,163,89,74,31.53,54,10,46,21,32
Donegal,182,88,94,23.68,31,23,41,53,34
Donegal,183,92,91,7.03,39,20,46,49,29
Donegal,178,88,90,16.36,37,22,42,54,23
Donegal,244,114,130,716.58,46,37,65,58,38
Donegal,249,124,125,31.5,74,17,76,58,24
Donegal,295,138,157,364.73,68,37,79,62,49
Donegal,238,110,128,24.35,29,28,39,54,88
Donegal,261,138,123,23.42,68,25,70,59,39
Donegal,207,105,102,34.46,67,19,50,43,28
Galway,338,180,158,48.5,71,56,70,103,38
Galway,183,96,87,19.55,37,18,37,58,33
Galway,122,62,60,42.45,28,8,37,31,18
Galway,156,79,77,16.87,25,17,26,52,36
Galway,345,174,171,98.63,87,45,89,103,21
Galway,258,128,130,32.58,57,24,64,71,42
Galway,226,110,116,35.02,39,33,56,67,31
Galway,215,103,112,31.66,47,31,52,55,30
Galway,249,146,103,3.89,24,66,58,75,26
Galway,309,152,157,3.97,60,35,95,88,31
Galway,94,52,42,6.62,14,8,23,30,19
Galway,136,67,69,38.65,36,12,40,35,13
Galway,228,112,116,58.86,78,17,72,43,18
Galway,276,142,134,48.71,57,31,68,80,40
Galway,301,154,147,42.09,61,47,71,86,36
Galway,160,83,77,12.1,26,13,47,41,33
Galway,227,131,96,14.83,36,25,40,76,50
Galway,208,104,104,55.19,33,21,70,59,25
Galway,224,120,104,25.58,57,24,65,50,28
Galway,397,218,179,5.35,76,36,100,110,75
Galway,158,81,77,909.57,13,17,33,50,45
Galway,113,47,66,4.12,12,7,23,47,24
Galway,161,91,70,5.45,24,26,31,51,29
Galway,181,81,100,29.41,40,16,50,48,27
Galway,272,133,139,58.66,49,24,77,79,43
Galway,126,73,53,6.97,17,9,33,33,34
Galway,106,56,50,13.1,17,9,20,40,20
Galway,268,145,123,9.7,53,44,61,78,32
Galway,130,67,63,26.99,21,18,35,43,13
Galway,360,169,191,249.87,83,36,130,84,27
Galway,160,85,75,25.4,29,14,34,60,23
Galway,127,75,52,26.06,10,16,31,44,26
Galway,153,71,82,869.55,16,20,38,44,35
Galway,220,110,110,99.89,35,23,54,64,44
Galway,163,98,65,687.08,22,80,50,6,5
Galway,216,115,101,1047.5,44,23,57,34,58
Kerry,90,46,44,29.01,13,2,23,26,26
Kerry,173,84,89,22.05,31,22,33,57,30
Kerry,204,106,98,25.66,27,30,53,61,33
Kerry,176,93,83,59.75,29,14,51,61,21
Kerry,221,111,110,39.73,53,25,57,50,36
Kerry,179,95,84,35.89,31,23,34,62,29
Kerry,286,138,148,41.51,37,26,50,85,88
Kerry,125,65,60,12.83,18,14,17,57,19
Kerry,96,50,46,15.76,19,10,31,18,18
Kerry,233,118,115,3.67,48,16,48,84,37
Kerry,143,76,67,7.89,20,6,30,57,30
Kerry,139,71,68,70.89,29,13,33,39,25
Kerry,142,69,73,8.85,30,18,35,38,21
Kerry,122,68,54,29.83,22,12,21,46,21
Kerry,96,46,50,7.73,23,3,23,26,21
Kerry,100,50,50,9.33,14,10,18,30,28
Kerry,107,56,51,8.05,14,18,15,42,18
Kerry,133,62,71,8.23,20,15,28,53,17
Kerry,171,86,85,33.4,31,6,38,44,52
Kerry,88,44,44,6.14,14,9,23,34,8
Kerry,137,61,76,18.69,20,8,22,52,35
Kerry,224,110,114,9.77,44,23,74,51,32
Kerry,110,56,54,3.07,10,13,18,46,23
Kerry,200,102,98,89.54,34,14,53,62,37
Kerry,194,99,95,73.86,29,20,65,43,37
Kerry,164,83,81,903.31,16,19,37,44,48
Kerry,137,62,75,378.45,22,9,44,33,29
Kerry,292,147,145,35.7,72,34,76,72,38
Kerry,80,41,39,51.03,14,10,18,32,6
Kerry,127,70,57,19.76,18,6,30,47,26
Kerry,253,131,122,82.67,49,25,90,61,28
Kerry,122,56,66,61.97,20,8,29,36,29
Kerry,220,115,105,15.3,51,21,58,59,31
Kerry,135,81,54,6.41,13,19,25,43,35
Kerry,101,50,51,16.49,12,2,35,31,21
Kerry,161,87,74,10.91,34,12,49,43,23
Kerry,210,118,92,4.99,30,20,36,83,41
Kerry,148,81,67,1543.53,6,21,62,42,17
Kerry,140,70,70,243.8,19,14,27,38,42
Kildare,446,228,218,65.84,126,62,121,118,19
Kildare,452,245,207,21.65,115,42,156,104,35
Kildare,186,102,84,15.85,55,12,68,42,9
Kildare,433,224,209,82.33,80,52,115,133,53
Kildare,141,66,75,2051.03,45,7,83,6,0
Kilkenny,442,216,226,2323.69,59,58,183,93,49
Kilkenny,191,100,91,929.39,23,28,81,44,15
Kilkenny,392,196,196,54.49,101,42,134,84,31
Kilkenny,217,103,114,21.09,48,28,54,70,17
Kilkenny,304,163,141,24.95,76,21,84,76,47
Laois,200,96,104,19.78,53,25,44,51,27
Laois,311,152,159,9.82,84,28,85,78,36
Laois,87,41,46,19.66,25,15,21,22,4
Laois,555,269,286,27.87,155,68,175,111,46
Laois,327,175,152,58.48,55,64,55,118,35
Laois,189,90,99,645.4,38,21,82,40,8
Laois,258,135,123,1370.32,39,36,94,59,30
Laois,114,53,61,1290.13,39,15,51,6,3
Laois,445,227,218,90.82,95,35,193,68,54
Leitrim,240,118,122,6.4,51,24,65,61,39
Leitrim,217,106,111,5.36,40,18,46,55,58
Leitrim,166,93,73,4.64,33,13,41,44,35
Leitrim,173,88,85,777.89,15,27,68,35,28
Leitrim,225,106,119,1338.62,33,29,73,44,46
Leitrim,186,108,78,3.96,28,14,43,67,34
Leitrim,358,181,177,9.47,76,41,84,106,51
Leitrim,163,80,83,45.53,49,11,55,36,12
Leitrim,187,94,93,611.61,52,25,85,20,5
Leitrim,293,161,132,15.74,54,46,74,83,36
Leitrim,162,77,85,50.1,21,12,63,54,12
Limerick,75,43,32,1679.54,0,71,3,0,1
Limerick,162,102,60,5613.11,9,20,72,35,26
Limerick,146,98,48,1966.46,11,25,68,31,11
Limerick,201,119,82,3669.56,21,25,77,55,23
Longford,217,111,106,9.6,45,31,42,64,35
Longford,167,83,84,248.07,21,20,70,34,22
Louth,185,95,90,1154.99,38,16,82,27,22
Louth,372,182,190,28.1,94,43,106,95,34
Louth,234,117,117,89.86,38,38,56,70,32
Louth,310,152,158,71.4,58,50,56,79,67
Louth,418,212,206,1858.03,84,84,79,134,37
Louth,385,188,197,1276.08,66,39,105,101,74
Mayo,192,96,96,33.74,39,12,39,49,53
Mayo,171,88,83,12.92,40,13,37,46,35
Mayo,114,66,48,7.05,9,16,27,36,26
Mayo,169,90,79,895.08,10,20,65,42,32
Mayo,180,94,86,1001.74,29,21,74,29,27
Mayo,163,87,76,1.61,37,20,36,40,30
Mayo,180,97,83,6.97,35,28,39,48,30
Mayo,175,91,84,2.19,24,18,39,73,21
Mayo,269,147,122,12.38,40,28,47,81,73
Mayo,160,80,80,2.25,27,16,52,41,24
Mayo,218,109,109,16.04,49,17,53,50,49
Mayo,261,128,133,11.47,62,30,66,66,37
Mayo,163,76,87,23.08,35,16,36,49,27
Mayo,89,42,47,7.48,11,8,18,28,24
Mayo,148,73,75,13.72,26,10,29,34,49
Mayo,125,63,62,1.51,27,20,31,25,22
Mayo,97,48,49,0.59,11,13,16,36,21
Mayo,166,77,89,20.52,45,17,37,45,22
Mayo,192,104,88,26.4,38,27,45,55,27
Mayo,221,109,112,37.3,41,27,40,61,52
Mayo,161,57,104,98.34,3,5,18,33,102
Mayo,202,108,94,14.84,41,22,47,58,34
Mayo,252,142,110,7.6,45,37,53,74,43
Mayo,350,181,169,12.41,79,44,78,97,52
Mayo,159,76,83,3.81,34,14,40,36,35
Mayo,209,105,104,21.29,37,13,68,50,41
Mayo,276,148,128,16.25,59,35,55,78,49
Mayo,232,114,118,69.96,36,26,45,68,57
Mayo,95,47,48,10.36,10,8,13,40,24
Mayo,242,116,126,1361.52,32,29,71,60,50
Mayo,152,74,78,131.16,36,10,33,52,21
Meath,244,124,120,44.76,50,37,55,69,33
Meath,456,231,225,39.4,87,55,110,139,65
Meath,534,282,252,42.67,102,77,112,190,53
Meath,472,232,240,67.7,89,48,196,91,48
Meath,487,249,238,754.78,67,37,277,46,60
Meath,242,126,116,117.86,47,18,92,51,34
Meath,221,106,115,41.9,44,23,54,67,33
Meath,264,125,139,174.52,58,34,66,77,29
Meath,169,86,83,10.12,40,19,35,47,28
Meath,320,160,160,25.91,86,35,88,66,45
Monaghan,203,103,100,11.89,54,18,57,40,34
Monaghan,185,86,99,1389.41,19,22,76,36,32
Offaly,441,224,217,10.45,102,40,125,113,61
Roscommon,312,163,149,15.2,51,40,71,102,48
Roscommon,175,100,75,983.6,23,20,46,49,37
Roscommon,212,111,101,622.35,23,26,52,55,56
Roscommon,232,106,126,271.59,40,24,56,68,44
Roscommon,143,73,70,1572.09,15,16,67,23,22
Roscommon,138,74,64,1178.28,13,15,76,24,10
Roscommon,345,158,187,23.39,60,46,89,101,49
Roscommon,184,100,84,9.6,32,24,38,60,30
Roscommon,237,127,110,7.35,56,23,60,57,41
Sligo,202,96,106,14.87,44,20,51,56,31
Sligo,244,113,131,166.52,48,15,110,50,21
Sligo,160,79,81,4.31,26,19,40,49,26
Sligo,128,65,63,81.53,18,13,18,44,35
Sligo,201,109,92,39.72,45,23,45,51,37
Sligo,148,70,78,355.89,40,17,81,7,3
Sligo,169,71,98,256.22,19,20,41,42,47
Sligo,185,93,92,709.17,30,31,48,47,29
Sligo,209,112,97,87.93,54,15,42,76,22
Sligo,223,115,108,65.22,48,18,67,60,30
Sligo,148,76,72,22.76,22,16,42,46,22
Sligo,225,116,109,2.71,37,31,45,80,32
Sligo,154,72,82,1422.05,3,20,57,27,47
Sligo,231,109,122,2239.83,10,176,25,16,4
Sligo,150,86,64,2274.52,2,42,79,17,10
Tipperary,368,180,188,10.21,83,28,138,75,44
Tipperary,"1,460",731,729,43.4,326,175,446,346,167
Tipperary,206,89,117,1633.96,67,19,104,15,1
Waterford,159,78,81,30.17,35,19,44,44,17
Waterford,111,50,61,17.64,23,11,20,42,15
Waterford,185,101,84,16.91,41,17,51,51,25
Waterford,187,97,90,48.83,44,14,54,44,31
Waterford,294,126,168,44.97,37,40,57,111,49
Waterford,197,99,98,133.28,40,26,51,65,15
Waterford,206,102,104,14.08,47,21,62,49,27
Waterford,413,208,205,31.19,123,46,111,82,51
Waterford,206,99,107,464.99,24,27,41,74,40
Waterford,201,107,94,37.96,34,25,38,68,36
Waterford,176,93,83,15.54,35,30,38,54,19
Waterford,279,140,139,38.16,56,41,62,88,32
Waterford,181,85,96,100.3,38,18,54,47,24
Waterford,192,96,96,922.82,42,34,53,54,9
Waterford,364,181,183,921.27,72,43,90,98,61
Waterford,193,97,96,1686.53,31,31,57,43,31
Waterford,297,151,146,76.05,63,32,70,61,71
Waterford,191,112,79,4843.66,15,49,110,13,4
Waterford,233,118,115,4934.87,44,28,74,48,39
Waterford,172,90,82,1263.79,36,61,66,5,4
Waterford,134,72,62,2759.7,12,36,35,23,28
Waterford,178,94,84,2565.84,29,17,53,35,44
Waterford,134,69,65,1451.33,0,103,30,1,0
Wexford,222,106,116,18.94,59,22,58,54,29
Wexford,187,91,96,196.79,57,13,70,23,24
Wexford,111,48,63,48.17,21,7,22,36,25
Wexford,139,64,75,252.73,29,19,37,28,26
Wexford,284,143,141,29.21,58,45,75,67,39
Wexford,266,133,133,51.48,73,27,63,62,41
Wexford,330,170,160,54.83,60,57,86,94,33
Wexford,126,55,71,227.62,20,12,48,31,15
Wexford,154,84,70,59.15,40,15,46,33,20
Wexford,212,102,110,35.63,50,21,66,42,33
Wexford,146,71,75,31.22,25,18,29,51,23
Wexford,211,106,105,92.9,45,28,60,41,37
Wexford,122,55,67,19.59,22,14,36,28,22
Wexford,129,66,63,354.7,26,1,48,20,34
Wexford,354,160,194,1177.1,123,37,93,67,34
Wexford,160,69,91,108.78,29,12,40,44,35
Wexford,103,51,52,177.42,17,10,28,40,8
Wexford,109,51,58,24.42,17,11,21,49,11
Wexford,229,108,121,145.41,55,21,81,53,19
Wexford,223,120,103,19.12,47,24,65,52,35
Wexford,179,98,81,31.49,24,28,37,57,33
Wexford,145,83,62,1727.59,12,20,73,30,10
Wexford,367,183,184,4481.18,16,35,107,112,97
Wicklow,364,193,171,23.92,89,45,93,103,34
Wicklow,275,137,138,80.67,54,47,61,79,34
Wicklow,190,79,111,207.91,27,2,53,30,78
Dublin,264,126,138,19080.66,33,34,181,14,2
Dublin,575,304,271,566.38,59,73,318,108,17
Dublin,376,187,189,18593.61,40,34,280,22,0
Dublin,170,75,95,5121.87,19,11,87,24,29
Dublin,367,184,183,15244.66,28,28,288,19,4
Dublin,309,138,171,3714.88,81,8,201,18,1
Dublin,473,160,313,271,100,28,140,108,97
Dublin,379,187,192,8038.01,63,82,111,112,11
Dublin,324,172,152,8227.94,103,60,151,10,0
Dublin,546,203,343,3133.99,2,497,45,0,2
Dublin,248,114,134,15957.79,0,244,4,0,0
Dublin,213,86,127,1099.91,23,19,28,48,95
Dublin,371,180,191,125.91,72,39,111,86,63
Dublin,179,91,88,2909.81,19,6,88,32,34
Dublin,276,151,125,30510.72,25,33,211,7,0
Dublin,185,100,85,17548.85,19,15,143,8,0
Dublin,144,77,67,8525.75,13,16,109,4,2
Dublin,70,34,36,357.51,2,10,51,6,1
Dublin,371,202,169,4445.35,25,54,279,13,0
Dublin,240,129,111,25887.18,24,28,181,6,1
Dublin,207,100,107,4182.16,19,19,145,18,6
Dublin,220,91,129,2290.07,45,13,137,23,2
Dublin,371,181,190,2309.68,149,19,168,30,5
Dublin,248,104,144,1424.67,89,20,122,17,0
Dublin,355,166,189,8525.05,112,25,196,21,1
Dublin,179,82,97,10998.46,48,13,101,13,4
Dublin,230,110,120,323.21,35,25,66,53,51
Dublin,126,53,73,7004.67,20,9,92,3,2
Dublin,503,207,296,306,81,44,97,87,194
Dublin,363,215,148,2167.25,30,63,195,64,11
Dublin,420,214,206,41.65,93,90,98,109,30
Dublin,236,118,118,352.02,27,26,61,74,48
Dublin,278,136,142,11795.15,88,24,152,13,1
Dublin,305,148,157,6537.07,92,19,176,14,4
Dublin,151,83,68,3075.73,10,11,64,39,27
Dublin,320,161,159,4970.02,76,30,149,42,23
Dublin,130,54,76,7679.13,12,3,95,18,2
Dublin,164,78,86,95.09,47,19,42,46,10
Dublin,440,221,219,1294.29,116,61,138,108,17
Dublin,79,35,44,1397.91,7,9,53,10,0
Dublin,409,191,218,16912.71,81,48,257,20,3
Dublin,146,74,72,3975.6,20,6,111,8,1
Dublin,409,214,195,1384.09,72,62,247,25,3
Dublin,299,137,162,9954.72,52,35,141,46,25
Dublin,146,99,47,14787.81,16,16,81,29,4
Dublin,121,57,64,13872.96,18,16,56,26,5
Dublin,483,227,256,3411.09,148,51,216,61,7
Dublin,268,134,134,11571.68,41,17,180,23,7
Dublin,237,131,106,4475.58,32,34,95,52,24
Dublin,434,207,227,5654.5,144,94,120,67,9
Dublin,227,106,121,2093.75,64,25,118,18,2
Dublin,103,48,55,527.13,21,7,70,4,1
Dublin,496,225,271,6953.01,118,93,138,80,67
Dublin,110,46,64,17619.73,48,20,34,6,2
Dublin,333,160,173,4593.99,62,61,86,76,48
Dublin,247,118,129,11499.6,46,52,129,20,0
Dublin,157,87,70,9638.41,28,37,79,13,0
Dublin,220,115,105,4013.28,37,41,56,46,40
Dublin,250,126,124,3463.56,22,181,35,8,4
Dublin,286,138,148,7698.52,96,64,71,45,10
Dublin,314,155,159,5568.56,72,48,83,63,48
Dublin,334,180,154,7583.5,72,53,185,23,1
Dublin,407,189,218,9847.57,121,91,112,66,17
Dublin,140,82,58,30701.75,7,16,71,42,4
Dublin,462,236,226,14204.02,69,74,302,15,2
Dublin,255,91,164,26234.57,99,27,112,15,2
Dublin,313,142,171,3972.13,87,32,174,20,0
Dublin,333,144,189,663.94,113,40,139,39,2
Dublin,188,108,80,3896.05,20,34,130,4,0
Dublin,124,64,60,9375.47,18,21,56,23,6
Dublin,409,200,209,12609.84,50,84,195,62,18
Dublin,381,201,180,22762.58,67,71,198,30,15
Dublin,119,52,67,3563.73,34,18,48,16,3
Dublin,425,217,208,9105.32,95,108,200,20,2
Dublin,508,287,221,42678.32,26,63,386,30,3
Dublin,101,57,44,1387.25,7,16,75,3,0
Dublin,80,47,33,6715.35,5,8,62,3,2
Dublin,362,172,190,6204.69,9,79,207,52,15
Dublin,415,153,262,2261.93,28,24,208,28,127
Dublin,291,138,153,6147.54,12,25,50,91,113
Dublin,404,197,207,20763.74,77,44,257,24,2
Dublin,103,45,58,3079.68,14,9,69,11,0
Dublin,472,226,246,4655.06,40,25,204,86,117
Dublin,173,98,75,6172.18,18,26,71,39,19
Dublin,123,59,64,1749.97,5,8,73,20,17
Dublin,266,136,130,13100.87,11,27,138,22,68
Dublin,211,158,53,7007.64,4,12,117,62,16
Dublin,186,95,91,4943.26,12,28,127,18,1
Dublin,442,264,178,16753.21,23,148,163,73,35
Dublin,410,158,252,34787.04,1,399,8,0,2
Dublin,406,182,224,1724.42,4,320,71,7,4
